Winamax Poker - Tournament "Kill The Fish" buyIn: 0.45€ + 0.05€ level: 1 - HandId: #3040732885884600333-1-1699723803 - Holdem no limit (25/100/200) - 2023/11/11 17:30:03 UTC
Table: 'Kill The Fish(707975795)#012' 6-max (real money) Seat #1 is the button
Seat 1: HELLoROBY (20000, 0.22€ bounty)
Seat 2: Petit.King53 (20000, 0.22€ bounty)
Seat 3: P1xel7 (20000, 0.22€ bounty)
Seat 4: marquestaut7 (20000, 0.22€ bounty)
Seat 6: christof38 (20000, 0.22€ bounty)
*** ANTE/BLINDS ***
Petit.King53 posts ante 25
P1xel7 posts ante 25
HELLoROBY posts ante 25
marquestaut7 posts ante 25
christof38 posts ante 25
Petit.King53 posts small blind 100
P1xel7 posts big blind 200
Dealt to P1xel7 [9d Jh]
*** PRE-FLOP *** 
marquestaut7 raises 19775 to 19975 and is all-in
christof38 folds
HELLoROBY calls 19975 and is all-in
Petit.King53 folds
P1xel7 folds
*** FLOP *** [3h 8s Qd]
*** TURN *** [3h 8s Qd][Qc]
*** RIVER *** [3h 8s Qd Qc][Kh]
*** SHOW DOWN ***
HELLoROBY shows [Kd Ks] (Full of Kings and Queens)
marquestaut7 shows [Qs Qh] (Quads of Queens)
marquestaut7 collected 40375 from pot
*** SUMMARY ***
Total pot 40375 | No rake
Board: [3h 8s Qd Qc Kh]
Seat 1: HELLoROBY (button) showed [Kd Ks] and lost with Full of Kings and Queens
Seat 4: marquestaut7 showed [Qs Qh] and won 40375 with Quads of Queens


Winamax Poker - Tournament "Kill The Fish" buyIn: 0.45€ + 0.05€ level: 1 - HandId: #3040732885884600333-2-1699723927 - Holdem no limit (25/100/200) - 2023/11/11 17:32:07 UTC
Table: 'Kill The Fish(707975795)#012' 6-max (real money) Seat #2 is the button
Seat 2: Petit.King53 (19875, 0.22€ bounty)
Seat 3: P1xel7 (19775, 0.22€ bounty)
Seat 4: marquestaut7 (40375, 0.33€ bounty)
Seat 5: Bayonnedax (20000, 0.22€ bounty)
Seat 6: christof38 (19975, 0.22€ bounty)
*** ANTE/BLINDS ***
P1xel7 posts ante 25
marquestaut7 posts ante 25
Petit.King53 posts ante 25
Bayonnedax posts ante 25
christof38 posts ante 25
P1xel7 posts small blind 100
marquestaut7 posts big blind 200
Dealt to P1xel7 [5c 8h]
*** PRE-FLOP *** 
Bayonnedax folds
christof38 folds
Petit.King53 calls 200
P1xel7 folds
marquestaut7 checks
*** FLOP *** [Qd Ah 2d]
marquestaut7 bets 625
Petit.King53 calls 625
*** TURN *** [Qd Ah 2d][3c]
marquestaut7 bets 200
Petit.King53 calls 200
*** RIVER *** [Qd Ah 2d 3c][Tc]
marquestaut7 checks
Petit.King53 bets 796
marquestaut7 calls 796
*** SHOW DOWN ***
Petit.King53 shows [8c Qc] (One pair : Queens)
marquestaut7 shows [Ac 9d] (One pair : Aces)
marquestaut7 collected 3867 from pot
*** SUMMARY ***
Total pot 3867 | No rake
Board: [Qd Ah 2d 3c Tc]
Seat 2: Petit.King53 (button) showed [8c Qc] and lost with One pair : Queens
Seat 4: marquestaut7 (big blind) showed [Ac 9d] and won 3867 with One pair : Aces


Winamax Poker - Tournament "Kill The Fish" buyIn: 0.45€ + 0.05€ level: 1 - HandId: #3040732885884600333-3-1699724031 - Holdem no limit (25/100/200) - 2023/11/11 17:33:51 UTC
Table: 'Kill The Fish(707975795)#012' 6-max (real money) Seat #3 is the button
Seat 1: taveKraise24 (20000, 0.22€ bounty)
Seat 2: Petit.King53 (18029, 0.22€ bounty)
Seat 3: P1xel7 (19650, 0.22€ bounty)
Seat 4: marquestaut7 (42396, 0.33€ bounty)
Seat 5: Bayonnedax (19975, 0.22€ bounty)
Seat 6: christof38 (19950, 0.22€ bounty)
*** ANTE/BLINDS ***
marquestaut7 posts ante 25
Bayonnedax posts ante 25
taveKraise24 posts ante 25
Petit.King53 posts ante 25
P1xel7 posts ante 25
christof38 posts ante 25
marquestaut7 posts small blind 100
Bayonnedax posts big blind 200
Dealt to P1xel7 [5h Qs]
*** PRE-FLOP *** 
christof38 folds
taveKraise24 folds
Petit.King53 raises 17804 to 18004 and is all-in
P1xel7 folds
marquestaut7 folds
Bayonnedax folds
Petit.King53 collected 18454 from pot
*** SUMMARY ***
Total pot 18454 | No rake
Seat 2: Petit.King53 won 18454


Winamax Poker - Tournament "Kill The Fish" buyIn: 0.45€ + 0.05€ level: 1 - HandId: #3040732885884600333-4-1699724057 - Holdem no limit (25/100/200) - 2023/11/11 17:34:17 UTC
Table: 'Kill The Fish(707975795)#012' 6-max (real money) Seat #4 is the button
Seat 1: taveKraise24 (19975, 0.22€ bounty)
Seat 2: Petit.King53 (18454, 0.22€ bounty)
Seat 3: P1xel7 (19625, 0.22€ bounty)
Seat 4: marquestaut7 (42271, 0.33€ bounty)
Seat 5: Bayonnedax (19750, 0.22€ bounty)
Seat 6: christof38 (19925, 0.22€ bounty)
*** ANTE/BLINDS ***
Bayonnedax posts ante 25
christof38 posts ante 25
taveKraise24 posts ante 25
Petit.King53 posts ante 25
P1xel7 posts ante 25
marquestaut7 posts ante 25
Bayonnedax posts small blind 100
christof38 posts big blind 200
Dealt to P1xel7 [Kc 2c]
*** PRE-FLOP *** 
taveKraise24 folds
Petit.King53 calls 200
P1xel7 folds
marquestaut7 folds
Bayonnedax calls 100
christof38 checks
*** FLOP *** [Jd Jh Tc]
Bayonnedax bets 200
christof38 calls 200
Petit.King53 folds
*** TURN *** [Jd Jh Tc][Ac]
Bayonnedax bets 200
christof38 calls 200
*** RIVER *** [Jd Jh Tc Ac][2s]
Bayonnedax bets 200
christof38 folds
Bayonnedax collected 1750 from pot
*** SUMMARY ***
Total pot 1750 | No rake
Board: [Jd Jh Tc Ac 2s]
Seat 5: Bayonnedax (small blind) won 1750


Winamax Poker - Tournament "Kill The Fish" buyIn: 0.45€ + 0.05€ level: 1 - HandId: #3040732885884600333-5-1699724096 - Holdem no limit (25/100/200) - 2023/11/11 17:34:56 UTC
Table: 'Kill The Fish(707975795)#012' 6-max (real money) Seat #5 is the button
Seat 1: taveKraise24 (19950, 0.22€ bounty)
Seat 2: Petit.King53 (18229, 0.22€ bounty)
Seat 3: P1xel7 (19600, 0.22€ bounty)
Seat 4: marquestaut7 (42246, 0.33€ bounty)
Seat 5: Bayonnedax (20675, 0.22€ bounty)
Seat 6: christof38 (19300, 0.22€ bounty)
*** ANTE/BLINDS ***
christof38 posts ante 25
taveKraise24 posts ante 25
Petit.King53 posts ante 25
P1xel7 posts ante 25
marquestaut7 posts ante 25
Bayonnedax posts ante 25
christof38 posts small blind 100
taveKraise24 posts big blind 200
Dealt to P1xel7 [3d 7d]
*** PRE-FLOP *** 
Petit.King53 calls 200
P1xel7 folds
marquestaut7 calls 200
Bayonnedax folds
christof38 calls 100
taveKraise24 checks
*** FLOP *** [Js 9d Qs]
christof38 bets 950
taveKraise24 calls 950
Petit.King53 raises 17054 to 18004 and is all-in
marquestaut7 calls 18004
christof38 calls 17054
taveKraise24 folds
*** TURN *** [Js 9d Qs][9h]
christof38 bets 1071 and is all-in
marquestaut7 calls 1071
*** RIVER *** [Js 9d Qs 9h][Ks]
*** SHOW DOWN ***
marquestaut7 shows [8h Qh] (Two pairs : Queens and 9)
Petit.King53 shows [Tc 7s] (Straight King high)
christof38 shows [8c Td] (Straight King high)
christof38 collected 30098 from side pot 1
Petit.King53 collected 27956 from main pot
*** SUMMARY ***
Total pot 58054 | No rake
Board: [Js 9d Qs 9h Ks]
Seat 2: Petit.King53 showed [Tc 7s] and won 27956 with Straight King high
Seat 4: marquestaut7 showed [8h Qh] and lost with Two pairs : Queens and 9
Seat 6: christof38 (small blind) showed [8c Td] and won 30098 with Straight King high


Winamax Poker - Tournament "Kill The Fish" buyIn: 0.45€ + 0.05€ level: 1 - HandId: #3040732885884600333-6-1699724191 - Holdem no limit (25/100/200) - 2023/11/11 17:36:31 UTC
Table: 'Kill The Fish(707975795)#012' 6-max (real money) Seat #6 is the button
Seat 1: taveKraise24 (18775, 0.22€ bounty)
Seat 2: Petit.King53 (27956, 0.22€ bounty)
Seat 3: P1xel7 (19575, 0.22€ bounty)
Seat 4: marquestaut7 (22946, 0.33€ bounty)
Seat 5: Bayonnedax (20650, 0.22€ bounty)
Seat 6: christof38 (30098, 0.22€ bounty)
*** ANTE/BLINDS ***
taveKraise24 posts ante 25
Petit.King53 posts ante 25
P1xel7 posts ante 25
marquestaut7 posts ante 25
Bayonnedax posts ante 25
christof38 posts ante 25
taveKraise24 posts small blind 100
Petit.King53 posts big blind 200
Dealt to P1xel7 [Jd 6h]
*** PRE-FLOP *** 
P1xel7 folds
marquestaut7 raises 22721 to 22921 and is all-in
Bayonnedax folds
christof38 folds
taveKraise24 folds
Petit.King53 folds
marquestaut7 collected 23371 from pot
*** SUMMARY ***
Total pot 23371 | No rake
Seat 4: marquestaut7 won 23371


Winamax Poker - Tournament "Kill The Fish" buyIn: 0.45€ + 0.05€ level: 1 - HandId: #3040732885884600333-7-1699724275 - Holdem no limit (25/100/200) - 2023/11/11 17:37:55 UTC
Table: 'Kill The Fish(707975795)#012' 6-max (real money) Seat #1 is the button
Seat 1: taveKraise24 (18650, 0.22€ bounty)
Seat 2: Petit.King53 (27731, 0.22€ bounty)
Seat 3: P1xel7 (19550, 0.22€ bounty)
Seat 4: marquestaut7 (23371, 0.33€ bounty)
Seat 5: Bayonnedax (20625, 0.22€ bounty)
Seat 6: christof38 (30073, 0.22€ bounty)
*** ANTE/BLINDS ***
Petit.King53 posts ante 25
P1xel7 posts ante 25
taveKraise24 posts ante 25
marquestaut7 posts ante 25
Bayonnedax posts ante 25
christof38 posts ante 25
Petit.King53 posts small blind 100
P1xel7 posts big blind 200
Dealt to P1xel7 [Jh 2c]
*** PRE-FLOP *** 
marquestaut7 folds
Bayonnedax folds
christof38 folds
taveKraise24 folds
Petit.King53 calls 100
P1xel7 checks
*** FLOP *** [Kd 8c 9s]
Petit.King53 checks
P1xel7 checks
*** TURN *** [Kd 8c 9s][Kh]
Petit.King53 checks
P1xel7 checks
*** RIVER *** [Kd 8c 9s Kh][Qh]
Petit.King53 checks
P1xel7 checks
*** SHOW DOWN ***
Petit.King53 shows [7h 2h] (One pair : Kings)
P1xel7 shows [Jh 2c] (One pair : Kings)
P1xel7 collected 550 from pot
*** SUMMARY ***
Total pot 550 | No rake
Board: [Kd 8c 9s Kh Qh]
Seat 2: Petit.King53 (small blind) showed [7h 2h] and lost with One pair : Kings
Seat 3: P1xel7 (big blind) showed [Jh 2c] and won 550 with One pair : Kings


Winamax Poker - Tournament "Kill The Fish" buyIn: 0.45€ + 0.05€ level: 1 - HandId: #3040732885884600333-8-1699724336 - Holdem no limit (25/100/200) - 2023/11/11 17:38:56 UTC
Table: 'Kill The Fish(707975795)#012' 6-max (real money) Seat #2 is the button
Seat 1: taveKraise24 (18625, 0.22€ bounty)
Seat 2: Petit.King53 (27506, 0.22€ bounty)
Seat 3: P1xel7 (19875, 0.22€ bounty)
Seat 4: marquestaut7 (23346, 0.33€ bounty)
Seat 5: Bayonnedax (20600, 0.22€ bounty)
Seat 6: christof38 (30048, 0.22€ bounty)
*** ANTE/BLINDS ***
P1xel7 posts ante 25
marquestaut7 posts ante 25
taveKraise24 posts ante 25
Petit.King53 posts ante 25
Bayonnedax posts ante 25
christof38 posts ante 25
P1xel7 posts small blind 100
marquestaut7 posts big blind 200
Dealt to P1xel7 [Kd Qd]
*** PRE-FLOP *** 
Bayonnedax folds
christof38 calls 200
taveKraise24 folds
Petit.King53 folds
P1xel7 raises 600 to 800
marquestaut7 folds
christof38 calls 600
*** FLOP *** [Qs 3h 2s]
P1xel7 bets 975
christof38 calls 975
*** TURN *** [Qs 3h 2s][7h]
P1xel7 bets 1365
christof38 calls 1365
*** RIVER *** [Qs 3h 2s 7h][Tc]
P1xel7 checks
christof38 bets 3315
P1xel7 calls 3315
*** SHOW DOWN ***
christof38 shows [7s 8s] (One pair : 7)
P1xel7 shows [Kd Qd] (One pair : Queens)
P1xel7 collected 13260 from pot
*** SUMMARY ***
Total pot 13260 | No rake
Board: [Qs 3h 2s 7h Tc]
Seat 3: P1xel7 (small blind) showed [Kd Qd] and won 13260 with One pair : Queens
Seat 6: christof38 showed [7s 8s] and lost with One pair : 7


Winamax Poker - Tournament "Kill The Fish" buyIn: 0.45€ + 0.05€ level: 1 - HandId: #3040732885884600333-9-1699724417 - Holdem no limit (25/100/200) - 2023/11/11 17:40:17 UTC
Table: 'Kill The Fish(707975795)#012' 6-max (real money) Seat #3 is the button
Seat 1: taveKraise24 (18600, 0.22€ bounty)
Seat 2: Petit.King53 (27481, 0.22€ bounty)
Seat 3: P1xel7 (26655, 0.22€ bounty)
Seat 4: marquestaut7 (23121, 0.33€ bounty)
Seat 5: Bayonnedax (20575, 0.22€ bounty)
Seat 6: christof38 (23568, 0.22€ bounty)
*** ANTE/BLINDS ***
marquestaut7 posts ante 25
Bayonnedax posts ante 25
taveKraise24 posts ante 25
Petit.King53 posts ante 25
P1xel7 posts ante 25
christof38 posts ante 25
marquestaut7 posts small blind 100
Bayonnedax posts big blind 200
Dealt to P1xel7 [Qs Js]
*** PRE-FLOP *** 
christof38 calls 200
taveKraise24 calls 200
Petit.King53 folds
P1xel7 raises 240 to 440
marquestaut7 folds
Bayonnedax folds
christof38 calls 240
taveKraise24 calls 240
*** FLOP *** [Qd Td 9h]
christof38 checks
taveKraise24 checks
P1xel7 bets 620
christof38 calls 620
taveKraise24 folds
*** TURN *** [Qd Td 9h][Jh]
christof38 checks
P1xel7 bets 1054
christof38 calls 1054
*** RIVER *** [Qd Td 9h Jh][3h]
christof38 checks
P1xel7 checks
*** SHOW DOWN ***
christof38 shows [Ts 5s] (One pair : Tens)
P1xel7 shows [Qs Js] (Two pairs : Queens and Jacks)
P1xel7 collected 5118 from pot
*** SUMMARY ***
Total pot 5118 | No rake
Board: [Qd Td 9h Jh 3h]
Seat 3: P1xel7 (button) showed [Qs Js] and won 5118 with Two pairs : Queens and Jacks
Seat 6: christof38 showed [Ts 5s] and lost with One pair : Tens


Winamax Poker - Tournament "Kill The Fish" buyIn: 0.45€ + 0.05€ level: 1 - HandId: #3040732885884600333-10-1699724498 - Holdem no limit (25/100/200) - 2023/11/11 17:41:38 UTC
Table: 'Kill The Fish(707975795)#012' 6-max (real money) Seat #4 is the button
Seat 1: taveKraise24 (18135, 0.22€ bounty)
Seat 2: Petit.King53 (27456, 0.22€ bounty)
Seat 3: P1xel7 (29634, 0.22€ bounty)
Seat 4: marquestaut7 (22996, 0.33€ bounty)
Seat 5: Bayonnedax (20350, 0.22€ bounty)
Seat 6: christof38 (21429, 0.22€ bounty)
*** ANTE/BLINDS ***
Bayonnedax posts ante 25
christof38 posts ante 25
taveKraise24 posts ante 25
Petit.King53 posts ante 25
P1xel7 posts ante 25
marquestaut7 posts ante 25
Bayonnedax posts small blind 100
christof38 posts big blind 200
Dealt to P1xel7 [Ks 8h]
*** PRE-FLOP *** 
taveKraise24 folds
Petit.King53 folds
P1xel7 folds
marquestaut7 folds
Bayonnedax folds
christof38 collected 450 from pot
*** SUMMARY ***
Total pot 450 | No rake
Seat 6: christof38 (big blind) won 450


Winamax Poker - Tournament "Kill The Fish" buyIn: 0.45€ + 0.05€ level: 1 - HandId: #3040732885884600333-11-1699724516 - Holdem no limit (25/100/200) - 2023/11/11 17:41:56 UTC
Table: 'Kill The Fish(707975795)#012' 6-max (real money) Seat #5 is the button
Seat 1: taveKraise24 (18110, 0.22€ bounty)
Seat 3: P1xel7 (29609, 0.22€ bounty)
Seat 4: marquestaut7 (22971, 0.33€ bounty)
Seat 5: Bayonnedax (20225, 0.22€ bounty)
Seat 6: christof38 (21654, 0.22€ bounty)
*** ANTE/BLINDS ***
christof38 posts ante 25
taveKraise24 posts ante 25
P1xel7 posts ante 25
marquestaut7 posts ante 25
Bayonnedax posts ante 25
christof38 posts small blind 100
taveKraise24 posts big blind 200
Dealt to P1xel7 [8d 5s]
*** PRE-FLOP *** 
P1xel7 folds
marquestaut7 folds
Bayonnedax folds
christof38 folds
taveKraise24 collected 425 from pot
*** SUMMARY ***
Total pot 425 | No rake
Seat 1: taveKraise24 (big blind) won 425


Winamax Poker - Tournament "Kill The Fish" buyIn: 0.45€ + 0.05€ level: 1 - HandId: #3040732885884600333-12-1699724530 - Holdem no limit (25/100/200) - 2023/11/11 17:42:10 UTC
Table: 'Kill The Fish(707975795)#012' 6-max (real money) Seat #6 is the button
Seat 1: taveKraise24 (18310, 0.22€ bounty)
Seat 3: P1xel7 (29584, 0.22€ bounty)
Seat 4: marquestaut7 (22946, 0.33€ bounty)
Seat 5: Bayonnedax (20200, 0.22€ bounty)
Seat 6: christof38 (21529, 0.22€ bounty)
*** ANTE/BLINDS ***
taveKraise24 posts ante 25
P1xel7 posts ante 25
marquestaut7 posts ante 25
Bayonnedax posts ante 25
christof38 posts ante 25
taveKraise24 posts small blind 100
P1xel7 posts big blind 200
Dealt to P1xel7 [Jh 7c]
*** PRE-FLOP *** 
marquestaut7 folds
Bayonnedax folds
christof38 folds
taveKraise24 calls 100
P1xel7 checks
*** FLOP *** [9d 3h Ah]
taveKraise24 checks
P1xel7 bets 341
taveKraise24 calls 341
*** TURN *** [9d 3h Ah][Kc]
taveKraise24 checks
P1xel7 bets 422
taveKraise24 raises 422 to 844
P1xel7 folds
taveKraise24 collected 2473 from pot
*** SUMMARY ***
Total pot 2473 | No rake
Board: [9d 3h Ah Kc]
Seat 1: taveKraise24 (small blind) won 2473


Winamax Poker - Tournament "Kill The Fish" buyIn: 0.45€ + 0.05€ level: 1 - HandId: #3040732885884600333-13-1699724563 - Holdem no limit (25/100/200) - 2023/11/11 17:42:43 UTC
Table: 'Kill The Fish(707975795)#012' 6-max (real money) Seat #1 is the button
Seat 1: taveKraise24 (19373, 0.22€ bounty)
Seat 3: P1xel7 (28596, 0.22€ bounty)
Seat 4: marquestaut7 (22921, 0.33€ bounty)
Seat 5: Bayonnedax (20175, 0.22€ bounty)
Seat 6: christof38 (21504, 0.22€ bounty)
*** ANTE/BLINDS ***
P1xel7 posts ante 25
marquestaut7 posts ante 25
taveKraise24 posts ante 25
Bayonnedax posts ante 25
christof38 posts ante 25
P1xel7 posts small blind 100
marquestaut7 posts big blind 200
Dealt to P1xel7 [5c 3c]
*** PRE-FLOP *** 
Bayonnedax calls 200
christof38 folds
taveKraise24 folds
P1xel7 calls 100
marquestaut7 checks
*** FLOP *** [Jc Ts 6d]
P1xel7 checks
marquestaut7 checks
Bayonnedax bets 200
P1xel7 folds
marquestaut7 folds
Bayonnedax collected 925 from pot
*** SUMMARY ***
Total pot 925 | No rake
Board: [Jc Ts 6d]
Seat 5: Bayonnedax won 925


Winamax Poker - Tournament "Kill The Fish" buyIn: 0.45€ + 0.05€ level: 1 - HandId: #3040732885884600333-14-1699724592 - Holdem no limit (25/100/200) - 2023/11/11 17:43:12 UTC
Table: 'Kill The Fish(707975795)#012' 6-max (real money) Seat #3 is the button
Seat 1: taveKraise24 (19348, 0.22€ bounty)
Seat 3: P1xel7 (28371, 0.22€ bounty)
Seat 4: marquestaut7 (22696, 0.33€ bounty)
Seat 5: Bayonnedax (20675, 0.22€ bounty)
Seat 6: christof38 (21479, 0.22€ bounty)
*** ANTE/BLINDS ***
marquestaut7 posts ante 25
Bayonnedax posts ante 25
taveKraise24 posts ante 25
P1xel7 posts ante 25
christof38 posts ante 25
marquestaut7 posts small blind 100
Bayonnedax posts big blind 200
Dealt to P1xel7 [4d Qc]
*** PRE-FLOP *** 
christof38 calls 200
taveKraise24 calls 200
P1xel7 folds
marquestaut7 folds
Bayonnedax checks
*** FLOP *** [8d 2s 4s]
Bayonnedax checks
christof38 checks
taveKraise24 checks
*** TURN *** [8d 2s 4s][8h]
Bayonnedax checks
christof38 bets 825
taveKraise24 calls 825
Bayonnedax folds
*** RIVER *** [8d 2s 4s 8h][4c]
christof38 checks
taveKraise24 checks
*** SHOW DOWN ***
christof38 shows [2d Td] (Two pairs : 8 and 4)
taveKraise24 shows [Ts Ks] (Two pairs : 8 and 4)
taveKraise24 collected 2475 from pot
*** SUMMARY ***
Total pot 2475 | No rake
Board: [8d 2s 4s 8h 4c]
Seat 1: taveKraise24 showed [Ts Ks] and won 2475 with Two pairs : 8 and 4
Seat 6: christof38 showed [2d Td] and lost with Two pairs : 8 and 4


Winamax Poker - Tournament "Kill The Fish" buyIn: 0.45€ + 0.05€ level: 1 - HandId: #3040732885884600333-15-1699724656 - Holdem no limit (25/100/200) - 2023/11/11 17:44:16 UTC
Table: 'Kill The Fish(707975795)#012' 6-max (real money) Seat #4 is the button
Seat 1: taveKraise24 (20773, 0.22€ bounty)
Seat 2: Zanzibar25 (20000, 0.22€ bounty)
Seat 3: P1xel7 (28346, 0.22€ bounty)
Seat 4: marquestaut7 (22571, 0.33€ bounty)
Seat 5: Bayonnedax (20450, 0.22€ bounty)
Seat 6: christof38 (20429, 0.22€ bounty)
*** ANTE/BLINDS ***
Bayonnedax posts ante 25
christof38 posts ante 25
taveKraise24 posts ante 25
Zanzibar25 posts ante 25
P1xel7 posts ante 25
marquestaut7 posts ante 25
Bayonnedax posts small blind 100
christof38 posts big blind 200
Dealt to P1xel7 [8c 2d]
*** PRE-FLOP *** 
taveKraise24 folds
Zanzibar25 calls 200
P1xel7 folds
marquestaut7 folds
Bayonnedax calls 100
christof38 raises 750 to 950
Zanzibar25 calls 750
Bayonnedax folds
*** FLOP *** [Jc 7s 2s]
christof38 bets 1125
Zanzibar25 raises 17900 to 19025 and is all-in
christof38 raises 429 to 19454 and is all-in
*** TURN *** [Jc 7s 2s][5d]
*** RIVER *** [Jc 7s 2s 5d][5s]
*** SHOW DOWN ***
Zanzibar25 shows [Jh 6d] (Two pairs : Jacks and 5)
christof38 shows [9s Js] (Flush Jack high)
christof38 collected 40729 from pot
*** SUMMARY ***
Total pot 40729 | No rake
Board: [Jc 7s 2s 5d 5s]
Seat 2: Zanzibar25 showed [Jh 6d] and lost with Two pairs : Jacks and 5
Seat 6: christof38 (big blind) showed [9s Js] and won 40729 with Flush Jack high


Winamax Poker - Tournament "Kill The Fish" buyIn: 0.45€ + 0.05€ level: 1 - HandId: #3040732885884600333-16-1699724716 - Holdem no limit (25/100/200) - 2023/11/11 17:45:16 UTC
Table: 'Kill The Fish(707975795)#012' 6-max (real money) Seat #5 is the button
Seat 1: taveKraise24 (20748, 0.22€ bounty)
Seat 3: P1xel7 (28321, 0.22€ bounty)
Seat 4: marquestaut7 (22546, 0.33€ bounty)
Seat 5: Bayonnedax (20225, 0.22€ bounty)
Seat 6: christof38 (40729, 0.33€ bounty)
*** ANTE/BLINDS ***
christof38 posts ante 25
taveKraise24 posts ante 25
P1xel7 posts ante 25
marquestaut7 posts ante 25
Bayonnedax posts ante 25
christof38 posts small blind 100
taveKraise24 posts big blind 200
Dealt to P1xel7 [7h Ah]
*** PRE-FLOP *** 
P1xel7 raises 240 to 440
marquestaut7 folds
Bayonnedax folds
christof38 calls 340
taveKraise24 calls 240
*** FLOP *** [8h Jd 8d]
christof38 checks
taveKraise24 checks
P1xel7 checks
*** TURN *** [8h Jd 8d][Jc]
christof38 checks
taveKraise24 checks
P1xel7 bets 840
christof38 calls 840
taveKraise24 folds
*** RIVER *** [8h Jd 8d Jc][6s]
christof38 checks
P1xel7 checks
*** SHOW DOWN ***
christof38 shows [Qs Ts] (Two pairs : Jacks and 8)
P1xel7 shows [7h Ah] (Two pairs : Jacks and 8)
P1xel7 collected 3125 from pot
*** SUMMARY ***
Total pot 3125 | No rake
Board: [8h Jd 8d Jc 6s]
Seat 3: P1xel7 showed [7h Ah] and won 3125 with Two pairs : Jacks and 8
Seat 6: christof38 (small blind) showed [Qs Ts] and lost with Two pairs : Jacks and 8


Winamax Poker - Tournament "Kill The Fish" buyIn: 0.45€ + 0.05€ level: 1 - HandId: #3040732885884600333-17-1699724808 - Holdem no limit (25/100/200) - 2023/11/11 17:46:48 UTC
Table: 'Kill The Fish(707975795)#012' 6-max (real money) Seat #6 is the button
Seat 1: taveKraise24 (20283, 0.22€ bounty)
Seat 2: vivelefric (20000, 0.22€ bounty)
Seat 3: P1xel7 (30141, 0.22€ bounty)
Seat 4: marquestaut7 (22521, 0.33€ bounty)
Seat 5: Bayonnedax (20200, 0.22€ bounty)
Seat 6: christof38 (39424, 0.33€ bounty)
*** ANTE/BLINDS ***
taveKraise24 posts ante 25
vivelefric posts ante 25
P1xel7 posts ante 25
marquestaut7 posts ante 25
Bayonnedax posts ante 25
christof38 posts ante 25
taveKraise24 posts small blind 100
vivelefric posts big blind 200
Dealt to P1xel7 [7c 2h]
*** PRE-FLOP *** 
P1xel7 folds
marquestaut7 folds
Bayonnedax folds
christof38 calls 200
taveKraise24 folds
vivelefric raises 19775 to 19975 and is all-in
christof38 folds
vivelefric collected 20425 from pot
*** SUMMARY ***
Total pot 20425 | No rake
Seat 2: vivelefric (big blind) won 20425


Winamax Poker - Tournament "Kill The Fish" buyIn: 0.45€ + 0.05€ level: 1 - HandId: #3040732885884600333-18-1699724830 - Holdem no limit (25/100/200) - 2023/11/11 17:47:10 UTC
Table: 'Kill The Fish(707975795)#012' 6-max (real money) Seat #1 is the button
Seat 1: taveKraise24 (20158, 0.22€ bounty)
Seat 2: vivelefric (20425, 0.22€ bounty)
Seat 3: P1xel7 (30116, 0.22€ bounty)
Seat 4: marquestaut7 (22496, 0.33€ bounty)
Seat 5: Bayonnedax (20175, 0.22€ bounty)
Seat 6: christof38 (39199, 0.33€ bounty)
*** ANTE/BLINDS ***
vivelefric posts ante 25
P1xel7 posts ante 25
taveKraise24 posts ante 25
marquestaut7 posts ante 25
Bayonnedax posts ante 25
christof38 posts ante 25
vivelefric posts small blind 100
P1xel7 posts big blind 200
Dealt to P1xel7 [Ks 4c]
*** PRE-FLOP *** 
marquestaut7 folds
Bayonnedax folds
christof38 calls 200
taveKraise24 folds
vivelefric folds
P1xel7 checks
*** FLOP *** [2s 3s Qd]
P1xel7 checks
christof38 checks
*** TURN *** [2s 3s Qd][6s]
P1xel7 checks
christof38 checks
*** RIVER *** [2s 3s Qd 6s][Ad]
P1xel7 checks
christof38 checks
*** SHOW DOWN ***
christof38 shows [9d 4d] (High card : Ace)
P1xel7 shows [Ks 4c] (High card : Ace)
P1xel7 collected 650 from pot
*** SUMMARY ***
Total pot 650 | No rake
Board: [2s 3s Qd 6s Ad]
Seat 3: P1xel7 (big blind) showed [Ks 4c] and won 650 with High card : Ace
Seat 6: christof38 showed [9d 4d] and lost with High card : Ace


Winamax Poker - Tournament "Kill The Fish" buyIn: 0.45€ + 0.05€ level: 1 - HandId: #3040732885884600333-19-1699724865 - Holdem no limit (25/100/200) - 2023/11/11 17:47:45 UTC
Table: 'Kill The Fish(707975795)#012' 6-max (real money) Seat #2 is the button
Seat 1: taveKraise24 (20133, 0.22€ bounty)
Seat 2: vivelefric (20300, 0.22€ bounty)
Seat 3: P1xel7 (30541, 0.22€ bounty)
Seat 4: marquestaut7 (22471, 0.33€ bounty)
Seat 5: Bayonnedax (20150, 0.22€ bounty)
Seat 6: christof38 (38974, 0.33€ bounty)
*** ANTE/BLINDS ***
P1xel7 posts ante 25
marquestaut7 posts ante 25
taveKraise24 posts ante 25
vivelefric posts ante 25
Bayonnedax posts ante 25
christof38 posts ante 25
P1xel7 posts small blind 100
marquestaut7 posts big blind 200
Dealt to P1xel7 [3c Js]
*** PRE-FLOP *** 
Bayonnedax folds
christof38 folds
taveKraise24 folds
vivelefric raises 650 to 850
P1xel7 folds
marquestaut7 folds
vivelefric collected 1300 from pot
*** SUMMARY ***
Total pot 1300 | No rake
Seat 2: vivelefric (button) won 1300


Winamax Poker - Tournament "Kill The Fish" buyIn: 0.45€ + 0.05€ level: 1 - HandId: #3040732885884600333-20-1699724885 - Holdem no limit (25/100/200) - 2023/11/11 17:48:05 UTC
Table: 'Kill The Fish(707975795)#012' 6-max (real money) Seat #3 is the button
Seat 1: taveKraise24 (20108, 0.22€ bounty)
Seat 2: vivelefric (20725, 0.22€ bounty)
Seat 3: P1xel7 (30416, 0.22€ bounty)
Seat 4: marquestaut7 (22246, 0.33€ bounty)
Seat 5: Bayonnedax (20125, 0.22€ bounty)
*** ANTE/BLINDS ***
marquestaut7 posts ante 25
Bayonnedax posts ante 25
taveKraise24 posts ante 25
vivelefric posts ante 25
P1xel7 posts ante 25
marquestaut7 posts small blind 100
Bayonnedax posts big blind 200
Dealt to P1xel7 [5c 3c]
*** PRE-FLOP *** 
taveKraise24 folds
vivelefric raises 20500 to 20700 and is all-in
P1xel7 folds
marquestaut7 folds
Bayonnedax folds
vivelefric collected 21125 from pot
*** SUMMARY ***
Total pot 21125 | No rake
Seat 2: vivelefric won 21125


Winamax Poker - Tournament "Kill The Fish" buyIn: 0.45€ + 0.05€ level: 1 - HandId: #3040732885884600333-21-1699724901 - Holdem no limit (25/100/200) - 2023/11/11 17:48:21 UTC
Table: 'Kill The Fish(707975795)#012' 6-max (real money) Seat #4 is the button
Seat 1: taveKraise24 (20083, 0.22€ bounty)
Seat 2: vivelefric (21125, 0.22€ bounty)
Seat 3: P1xel7 (30391, 0.22€ bounty)
Seat 4: marquestaut7 (22121, 0.33€ bounty)
Seat 5: Bayonnedax (19900, 0.22€ bounty)
*** ANTE/BLINDS ***
Bayonnedax posts ante 25
taveKraise24 posts ante 25
vivelefric posts ante 25
P1xel7 posts ante 25
marquestaut7 posts ante 25
Bayonnedax posts small blind 100
taveKraise24 posts big blind 200
Dealt to P1xel7 [As Jd]
*** PRE-FLOP *** 
vivelefric folds
P1xel7 raises 400 to 600
marquestaut7 folds
Bayonnedax folds
taveKraise24 calls 400
*** FLOP *** [6h 3d 9d]
taveKraise24 checks
P1xel7 bets 499
taveKraise24 calls 499
*** TURN *** [6h 3d 9d][Kh]
taveKraise24 checks
P1xel7 bets 848
taveKraise24 raises 848 to 1696
P1xel7 calls 848
*** RIVER *** [6h 3d 9d Kh][8c]
taveKraise24 bets 3780
P1xel7 folds
taveKraise24 collected 9595 from pot
*** SUMMARY ***
Total pot 9595 | No rake
Board: [6h 3d 9d Kh 8c]
Seat 1: taveKraise24 (big blind) won 9595


Winamax Poker - Tournament "Kill The Fish" buyIn: 0.45€ + 0.05€ level: 1 - HandId: #3040732885884600333-22-1699724958 - Holdem no limit (25/100/200) - 2023/11/11 17:49:18 UTC
Table: 'Kill The Fish(707975795)#012' 6-max (real money) Seat #5 is the button
Seat 1: taveKraise24 (23078, 0.22€ bounty)
Seat 2: vivelefric (21100, 0.22€ bounty)
Seat 3: P1xel7 (27571, 0.22€ bounty)
Seat 4: marquestaut7 (22096, 0.33€ bounty)
Seat 5: Bayonnedax (19775, 0.22€ bounty)
Seat 6: Ducro2A (20000, 0.22€ bounty)
*** ANTE/BLINDS ***
taveKraise24 posts ante 25
vivelefric posts ante 25
P1xel7 posts ante 25
marquestaut7 posts ante 25
Bayonnedax posts ante 25
taveKraise24 posts small blind 100
vivelefric posts big blind 200
Dealt to P1xel7 [8d Jc]
*** PRE-FLOP *** 
P1xel7 folds
marquestaut7 calls 200
Bayonnedax folds
taveKraise24 folds
vivelefric checks
*** FLOP *** [Td 7s Jd]
vivelefric checks
marquestaut7 checks
*** TURN *** [Td 7s Jd][9h]
vivelefric bets 625
marquestaut7 calls 625
*** RIVER *** [Td 7s Jd 9h][As]
vivelefric bets 1875
marquestaut7 folds
vivelefric collected 3750 from pot
*** SUMMARY ***
Total pot 3750 | No rake
Board: [Td 7s Jd 9h As]
Seat 2: vivelefric (big blind) won 3750


Winamax Poker - Tournament "Kill The Fish" buyIn: 0.45€ + 0.05€ level: 1 - HandId: #3040732885884600333-23-1699725019 - Holdem no limit (25/100/200) - 2023/11/11 17:50:19 UTC
Table: 'Kill The Fish(707975795)#012' 6-max (real money) Seat #1 is the button
Seat 1: taveKraise24 (22953, 0.22€ bounty)
Seat 2: vivelefric (22125, 0.22€ bounty)
Seat 3: P1xel7 (27546, 0.22€ bounty)
Seat 4: marquestaut7 (21246, 0.33€ bounty)
Seat 5: Bayonnedax (19750, 0.22€ bounty)
Seat 6: Ducro2A (20000, 0.22€ bounty)
*** ANTE/BLINDS ***
vivelefric posts ante 25
P1xel7 posts ante 25
taveKraise24 posts ante 25
marquestaut7 posts ante 25
Bayonnedax posts ante 25
Ducro2A posts ante 25
vivelefric posts small blind 100
P1xel7 posts big blind 200
Dealt to P1xel7 [2c 5c]
*** PRE-FLOP *** 
marquestaut7 calls 200
Bayonnedax folds
Ducro2A calls 200
taveKraise24 calls 200
vivelefric raises 1150 to 1350
P1xel7 folds
marquestaut7 calls 1150
Ducro2A calls 1150
taveKraise24 folds
*** FLOP *** [4c 4s 9c]
vivelefric bets 4600
marquestaut7 folds
Ducro2A calls 4600
*** TURN *** [4c 4s 9c][Ac]
vivelefric bets 16150 and is all-in
Ducro2A calls 14025 and is all-in
*** RIVER *** [4c 4s 9c Ac][9d]
*** SHOW DOWN ***
Ducro2A shows [8h 8s] (Two pairs : 9 and 8)
vivelefric shows [9h As] (Full of 9 and Aces)
vivelefric collected 43975 from pot
*** SUMMARY ***
Total pot 43975 | No rake
Board: [4c 4s 9c Ac 9d]
Seat 2: vivelefric (small blind) showed [9h As] and won 43975 with Full of 9 and Aces
Seat 6: Ducro2A showed [8h 8s] and lost with Two pairs : 9 and 8


Winamax Poker - Tournament "Kill The Fish" buyIn: 0.45€ + 0.05€ level: 1 - HandId: #3040732885884600333-24-1699725073 - Holdem no limit (25/100/200) - 2023/11/11 17:51:13 UTC
Table: 'Kill The Fish(707975795)#012' 6-max (real money) Seat #2 is the button
Seat 1: taveKraise24 (22728, 0.22€ bounty)
Seat 2: vivelefric (43975, 0.33€ bounty)
Seat 3: P1xel7 (27321, 0.22€ bounty)
Seat 4: marquestaut7 (19871, 0.33€ bounty)
Seat 5: Bayonnedax (19725, 0.22€ bounty)
*** ANTE/BLINDS ***
P1xel7 posts ante 25
marquestaut7 posts ante 25
taveKraise24 posts ante 25
vivelefric posts ante 25
Bayonnedax posts ante 25
P1xel7 posts small blind 100
marquestaut7 posts big blind 200
Dealt to P1xel7 [5d 6c]
*** PRE-FLOP *** 
Bayonnedax folds
taveKraise24 folds
vivelefric folds
P1xel7 folds
marquestaut7 collected 425 from pot
*** SUMMARY ***
Total pot 425 | No rake
Seat 4: marquestaut7 (big blind) won 425


Winamax Poker - Tournament "Kill The Fish" buyIn: 0.45€ + 0.05€ level: 1 - HandId: #3040732885884600333-25-1699725091 - Holdem no limit (25/100/200) - 2023/11/11 17:51:31 UTC
Table: 'Kill The Fish(707975795)#012' 6-max (real money) Seat #3 is the button
Seat 1: taveKraise24 (22703, 0.22€ bounty)
Seat 2: vivelefric (43950, 0.33€ bounty)
Seat 3: P1xel7 (27196, 0.22€ bounty)
Seat 4: marquestaut7 (20071, 0.33€ bounty)
Seat 5: Bayonnedax (19700, 0.22€ bounty)
*** ANTE/BLINDS ***
marquestaut7 posts ante 25
Bayonnedax posts ante 25
taveKraise24 posts ante 25
vivelefric posts ante 25
P1xel7 posts ante 25
marquestaut7 posts small blind 100
Bayonnedax posts big blind 200
Dealt to P1xel7 [Tc Ah]
*** PRE-FLOP *** 
taveKraise24 folds
vivelefric calls 200
P1xel7 folds
marquestaut7 raises 725 to 925
Bayonnedax folds
vivelefric calls 725
*** FLOP *** [3c Jd Kh]
marquestaut7 bets 2175
vivelefric calls 2175
*** TURN *** [3c Jd Kh][8c]
marquestaut7 bets 6525
vivelefric calls 6525
*** RIVER *** [3c Jd Kh 8c][6h]
marquestaut7 checks
vivelefric bets 19575
marquestaut7 calls 10421 and is all-in
*** SHOW DOWN ***
vivelefric shows [Jc 9s] (One pair : Jacks)
marquestaut7 shows [Qd Kc] (One pair : Kings)
marquestaut7 collected 40417 from main pot
vivelefric collected 9154 from side pot 1
*** SUMMARY ***
Total pot 49571 | No rake
Board: [3c Jd Kh 8c 6h]
Seat 2: vivelefric showed [Jc 9s] and won 9154 with One pair : Jacks
Seat 4: marquestaut7 (small blind) showed [Qd Kc] and won 40417 with One pair : Kings


Winamax Poker - Tournament "Kill The Fish" buyIn: 0.45€ + 0.05€ level: 1 - HandId: #3040732885884600333-26-1699725181 - Holdem no limit (25/100/200) - 2023/11/11 17:53:01 UTC
Table: 'Kill The Fish(707975795)#012' 6-max (real money) Seat #4 is the button
Seat 1: taveKraise24 (22678, 0.22€ bounty)
Seat 2: vivelefric (23879, 0.33€ bounty)
Seat 3: P1xel7 (27171, 0.22€ bounty)
Seat 4: marquestaut7 (40417, 0.33€ bounty)
Seat 5: Bayonnedax (19475, 0.22€ bounty)
Seat 6: mAgA_ (20000, 0.22€ bounty)
*** ANTE/BLINDS ***
Bayonnedax posts ante 25
mAgA_ posts ante 25
taveKraise24 posts ante 25
vivelefric posts ante 25
P1xel7 posts ante 25
marquestaut7 posts ante 25
Bayonnedax posts small blind 100
mAgA_ posts big blind 200
Dealt to P1xel7 [7d Ad]
*** PRE-FLOP *** 
taveKraise24 folds
vivelefric folds
P1xel7 raises 240 to 440
marquestaut7 folds
Bayonnedax folds
mAgA_ calls 240
*** FLOP *** [Jd 3s Jc]
mAgA_ checks
P1xel7 checks
*** TURN *** [Jd 3s Jc][4s]
mAgA_ checks
P1xel7 bets 396
mAgA_ folds
P1xel7 collected 1526 from pot
*** SUMMARY ***
Total pot 1526 | No rake
Board: [Jd 3s Jc 4s]
Seat 3: P1xel7 won 1526


Winamax Poker - Tournament "Kill The Fish" buyIn: 0.45€ + 0.05€ level: 1 - HandId: #3040732885884600333-27-1699725250 - Holdem no limit (25/100/200) - 2023/11/11 17:54:10 UTC
Table: 'Kill The Fish(707975795)#012' 6-max (real money) Seat #5 is the button
Seat 1: taveKraise24 (22653, 0.22€ bounty)
Seat 2: vivelefric (23854, 0.33€ bounty)
Seat 3: P1xel7 (27836, 0.22€ bounty)
Seat 4: marquestaut7 (40392, 0.33€ bounty)
Seat 5: Bayonnedax (19350, 0.22€ bounty)
Seat 6: mAgA_ (19535, 0.22€ bounty)
*** ANTE/BLINDS ***
mAgA_ posts ante 25
taveKraise24 posts ante 25
vivelefric posts ante 25
P1xel7 posts ante 25
marquestaut7 posts ante 25
Bayonnedax posts ante 25
mAgA_ posts small blind 100
taveKraise24 posts big blind 200
Dealt to P1xel7 [Qh Qs]
*** PRE-FLOP *** 
vivelefric calls 200
P1xel7 raises 600 to 800
marquestaut7 folds
Bayonnedax folds
mAgA_ folds
taveKraise24 folds
vivelefric calls 600
*** FLOP *** [9h Qd As]
vivelefric checks
P1xel7 checks
*** TURN *** [9h Qd As][4h]
vivelefric checks
P1xel7 bets 513
vivelefric calls 513
*** RIVER *** [9h Qd As 4h][7c]
vivelefric bets 3076
P1xel7 raises 3076 to 6152
vivelefric folds
P1xel7 collected 12304 from pot
*** SUMMARY ***
Total pot 12304 | No rake
Board: [9h Qd As 4h 7c]
Seat 3: P1xel7 won 12304


Winamax Poker - Tournament "Kill The Fish" buyIn: 0.45€ + 0.05€ level: 2 - HandId: #3040732885884600333-28-1699725661 - Holdem no limit (30/125/250) - 2023/11/11 18:01:01 UTC
Table: 'Kill The Fish(707975795)#012' 6-max (real money) Seat #6 is the button
Seat 1: taveKraise24 (22428, 0.22€ bounty)
Seat 2: vivelefric (19440, 0.33€ bounty)
Seat 3: P1xel7 (32650, 0.22€ bounty)
Seat 4: marquestaut7 (40367, 0.33€ bounty)
Seat 5: Bayonnedax (19325, 0.22€ bounty)
Seat 6: mAgA_ (19410, 0.22€ bounty)
*** ANTE/BLINDS ***
taveKraise24 posts ante 30
vivelefric posts ante 30
P1xel7 posts ante 30
marquestaut7 posts ante 30
Bayonnedax posts ante 30
mAgA_ posts ante 30
taveKraise24 posts small blind 125
vivelefric posts big blind 250
Dealt to P1xel7 [5s Kc]
*** PRE-FLOP *** 
P1xel7 folds
marquestaut7 folds
Bayonnedax folds
mAgA_ folds
taveKraise24 raises 500 to 750
vivelefric folds
taveKraise24 collected 1180 from pot
*** SUMMARY ***
Total pot 1180 | No rake
Seat 1: taveKraise24 (small blind) won 1180


Winamax Poker - Tournament "Kill The Fish" buyIn: 0.45€ + 0.05€ level: 2 - HandId: #3040732885884600333-29-1699725771 - Holdem no limit (30/125/250) - 2023/11/11 18:02:51 UTC
Table: 'Kill The Fish(707975795)#012' 6-max (real money) Seat #1 is the button
Seat 1: taveKraise24 (22828, 0.22€ bounty)
Seat 2: vivelefric (19160, 0.33€ bounty)
Seat 3: P1xel7 (32620, 0.22€ bounty)
Seat 4: marquestaut7 (40337, 0.33€ bounty)
Seat 5: Bayonnedax (19295, 0.22€ bounty)
Seat 6: mAgA_ (19380, 0.22€ bounty)
*** ANTE/BLINDS ***
vivelefric posts ante 30
P1xel7 posts ante 30
taveKraise24 posts ante 30
marquestaut7 posts ante 30
Bayonnedax posts ante 30
mAgA_ posts ante 30
vivelefric posts small blind 125
P1xel7 posts big blind 250
Dealt to P1xel7 [4s 7h]
*** PRE-FLOP *** 
marquestaut7 calls 250
Bayonnedax folds
mAgA_ calls 250
taveKraise24 folds
vivelefric folds
P1xel7 checks
*** FLOP *** [Jd 9s 7s]
P1xel7 checks
marquestaut7 checks
mAgA_ checks
*** TURN *** [Jd 9s 7s][5h]
P1xel7 checks
marquestaut7 checks
mAgA_ checks
*** RIVER *** [Jd 9s 7s 5h][6s]
P1xel7 checks
marquestaut7 checks
mAgA_ checks
*** SHOW DOWN ***
P1xel7 shows [4s 7h] (One pair : 7)
mAgA_ shows [3d 3s] (One pair : 3)
marquestaut7 shows [Kc 7d] (One pair : 7)
marquestaut7 collected 1055 from pot
*** SUMMARY ***
Total pot 1055 | No rake
Board: [Jd 9s 7s 5h 6s]
Seat 3: P1xel7 (big blind) showed [4s 7h] and lost with One pair : 7
Seat 4: marquestaut7 showed [Kc 7d] and won 1055 with One pair : 7
Seat 6: mAgA_ showed [3d 3s] and lost with One pair : 3


Winamax Poker - Tournament "Kill The Fish" buyIn: 0.45€ + 0.05€ level: 2 - HandId: #3040732885884600333-30-1699725878 - Holdem no limit (30/125/250) - 2023/11/11 18:04:38 UTC
Table: 'Kill The Fish(707975795)#012' 6-max (real money) Seat #2 is the button
Seat 1: taveKraise24 (22798, 0.22€ bounty)
Seat 2: vivelefric (19005, 0.33€ bounty)
Seat 3: P1xel7 (32340, 0.22€ bounty)
Seat 4: marquestaut7 (41112, 0.33€ bounty)
Seat 5: Bayonnedax (19265, 0.22€ bounty)
Seat 6: mAgA_ (19100, 0.22€ bounty)
*** ANTE/BLINDS ***
P1xel7 posts ante 30
marquestaut7 posts ante 30
taveKraise24 posts ante 30
vivelefric posts ante 30
Bayonnedax posts ante 30
mAgA_ posts ante 30
P1xel7 posts small blind 125
marquestaut7 posts big blind 250
Dealt to P1xel7 [2h Js]
*** PRE-FLOP *** 
Bayonnedax folds
mAgA_ folds
taveKraise24 folds
vivelefric calls 250
P1xel7 folds
marquestaut7 checks
*** FLOP *** [Td 6s 4c]
marquestaut7 checks
vivelefric checks
*** TURN *** [Td 6s 4c][9s]
marquestaut7 checks
vivelefric checks
*** RIVER *** [Td 6s 4c 9s][5d]
marquestaut7 checks
vivelefric checks
*** SHOW DOWN ***
vivelefric shows [Ad 8h] (High card : Ace)
marquestaut7 shows [Kc 6c] (One pair : 6)
marquestaut7 collected 805 from pot
*** SUMMARY ***
Total pot 805 | No rake
Board: [Td 6s 4c 9s 5d]
Seat 2: vivelefric (button) showed [Ad 8h] and lost with High card : Ace
Seat 4: marquestaut7 (big blind) showed [Kc 6c] and won 805 with One pair : 6


Winamax Poker - Tournament "Kill The Fish" buyIn: 0.45€ + 0.05€ level: 2 - HandId: #3040732885884600333-31-1699725943 - Holdem no limit (30/125/250) - 2023/11/11 18:05:43 UTC
Table: 'Kill The Fish(707975795)#012' 6-max (real money) Seat #3 is the button
Seat 1: taveKraise24 (22768, 0.22€ bounty)
Seat 2: vivelefric (18725, 0.33€ bounty)
Seat 3: P1xel7 (32185, 0.22€ bounty)
Seat 4: marquestaut7 (41637, 0.33€ bounty)
Seat 5: Bayonnedax (19235, 0.22€ bounty)
Seat 6: mAgA_ (19070, 0.22€ bounty)
*** ANTE/BLINDS ***
marquestaut7 posts ante 30
Bayonnedax posts ante 30
taveKraise24 posts ante 30
vivelefric posts ante 30
P1xel7 posts ante 30
mAgA_ posts ante 30
marquestaut7 posts small blind 125
Bayonnedax posts big blind 250
Dealt to P1xel7 [2h Ah]
*** PRE-FLOP *** 
mAgA_ folds
taveKraise24 folds
vivelefric raises 250 to 500
P1xel7 calls 500
marquestaut7 raises 1930 to 2430
Bayonnedax folds
vivelefric calls 1930
P1xel7 folds
*** FLOP *** [Kc 8h 7c]
marquestaut7 checks
vivelefric bets 5790
marquestaut7 calls 5790
*** TURN *** [Kc 8h 7c][3h]
marquestaut7 checks
vivelefric bets 10475 and is all-in
marquestaut7 folds
vivelefric collected 27845 from pot
*** SUMMARY ***
Total pot 27845 | No rake
Board: [Kc 8h 7c 3h]
Seat 2: vivelefric won 27845


Winamax Poker - Tournament "Kill The Fish" buyIn: 0.45€ + 0.05€ level: 3 - HandId: #3040732885884600333-32-1699726002 - Holdem no limit (35/150/300) - 2023/11/11 18:06:42 UTC
Table: 'Kill The Fish(707975795)#012' 6-max (real money) Seat #4 is the button
Seat 1: taveKraise24 (22738, 0.22€ bounty)
Seat 2: vivelefric (27845, 0.33€ bounty)
Seat 3: P1xel7 (31655, 0.22€ bounty)
Seat 4: marquestaut7 (33387, 0.33€ bounty)
Seat 5: Bayonnedax (18955, 0.22€ bounty)
Seat 6: mAgA_ (19040, 0.22€ bounty)
*** ANTE/BLINDS ***
Bayonnedax posts ante 35
mAgA_ posts ante 35
taveKraise24 posts ante 35
vivelefric posts ante 35
P1xel7 posts ante 35
marquestaut7 posts ante 35
Bayonnedax posts small blind 150
mAgA_ posts big blind 300
Dealt to P1xel7 [8d 7c]
*** PRE-FLOP *** 
taveKraise24 raises 450 to 750
vivelefric calls 750
P1xel7 folds
marquestaut7 folds
Bayonnedax folds
mAgA_ calls 450
*** FLOP *** [Ts As 7d]
mAgA_ checks
taveKraise24 checks
vivelefric checks
*** TURN *** [Ts As 7d][6s]
mAgA_ checks
taveKraise24 bets 913
vivelefric folds
mAgA_ folds
taveKraise24 collected 3523 from pot
*** SUMMARY ***
Total pot 3523 | No rake
Board: [Ts As 7d 6s]
Seat 1: taveKraise24 won 3523


Winamax Poker - Tournament "Kill The Fish" buyIn: 0.45€ + 0.05€ level: 3 - HandId: #3040732885884600333-33-1699726060 - Holdem no limit (35/150/300) - 2023/11/11 18:07:40 UTC
Table: 'Kill The Fish(707975795)#012' 6-max (real money) Seat #5 is the button
Seat 1: taveKraise24 (24563, 0.22€ bounty)
Seat 2: vivelefric (27060, 0.33€ bounty)
Seat 3: P1xel7 (31620, 0.22€ bounty)
Seat 4: marquestaut7 (33352, 0.33€ bounty)
Seat 5: Bayonnedax (18770, 0.22€ bounty)
Seat 6: mAgA_ (18255, 0.22€ bounty)
*** ANTE/BLINDS ***
mAgA_ posts ante 35
taveKraise24 posts ante 35
vivelefric posts ante 35
P1xel7 posts ante 35
marquestaut7 posts ante 35
Bayonnedax posts ante 35
mAgA_ posts small blind 150
taveKraise24 posts big blind 300
Dealt to P1xel7 [Jc 5c]
*** PRE-FLOP *** 
vivelefric calls 300
P1xel7 folds
marquestaut7 raises 1260 to 1560
Bayonnedax folds
mAgA_ folds
taveKraise24 folds
vivelefric calls 1260
*** FLOP *** [4h Js Qs]
vivelefric checks
marquestaut7 checks
*** TURN *** [4h Js Qs][2h]
vivelefric checks
marquestaut7 checks
*** RIVER *** [4h Js Qs 2h][9s]
vivelefric bets 300
marquestaut7 folds
vivelefric collected 4080 from pot
*** SUMMARY ***
Total pot 4080 | No rake
Board: [4h Js Qs 2h 9s]
Seat 2: vivelefric won 4080


Winamax Poker - Tournament "Kill The Fish" buyIn: 0.45€ + 0.05€ level: 3 - HandId: #3040732885884600333-34-1699726101 - Holdem no limit (35/150/300) - 2023/11/11 18:08:21 UTC
Table: 'Kill The Fish(707975795)#012' 6-max (real money) Seat #6 is the button
Seat 1: taveKraise24 (24228, 0.22€ bounty)
Seat 2: vivelefric (29245, 0.33€ bounty)
Seat 3: P1xel7 (31585, 0.22€ bounty)
Seat 4: marquestaut7 (31757, 0.33€ bounty)
Seat 5: Bayonnedax (18735, 0.22€ bounty)
Seat 6: mAgA_ (18070, 0.22€ bounty)
*** ANTE/BLINDS ***
taveKraise24 posts ante 35
vivelefric posts ante 35
P1xel7 posts ante 35
marquestaut7 posts ante 35
Bayonnedax posts ante 35
mAgA_ posts ante 35
taveKraise24 posts small blind 150
vivelefric posts big blind 300
Dealt to P1xel7 [9d 2d]
*** PRE-FLOP *** 
P1xel7 folds
marquestaut7 folds
Bayonnedax calls 300
mAgA_ calls 300
taveKraise24 folds
vivelefric checks
*** FLOP *** [9c 9h Kc]
vivelefric checks
Bayonnedax bets 300
mAgA_ folds
vivelefric folds
Bayonnedax collected 1560 from pot
*** SUMMARY ***
Total pot 1560 | No rake
Board: [9c 9h Kc]
Seat 5: Bayonnedax won 1560


Winamax Poker - Tournament "Kill The Fish" buyIn: 0.45€ + 0.05€ level: 3 - HandId: #3040732885884600333-35-1699726149 - Holdem no limit (35/150/300) - 2023/11/11 18:09:09 UTC
Table: 'Kill The Fish(707975795)#012' 6-max (real money) Seat #1 is the button
Seat 1: taveKraise24 (24043, 0.22€ bounty)
Seat 2: vivelefric (28910, 0.33€ bounty)
Seat 3: P1xel7 (31550, 0.22€ bounty)
Seat 4: marquestaut7 (31722, 0.33€ bounty)
Seat 5: Bayonnedax (19660, 0.22€ bounty)
Seat 6: mAgA_ (17735, 0.22€ bounty)
*** ANTE/BLINDS ***
vivelefric posts ante 35
P1xel7 posts ante 35
taveKraise24 posts ante 35
marquestaut7 posts ante 35
Bayonnedax posts ante 35
mAgA_ posts ante 35
vivelefric posts small blind 150
P1xel7 posts big blind 300
Dealt to P1xel7 [8d 3h]
*** PRE-FLOP *** 
marquestaut7 calls 300
Bayonnedax calls 300
mAgA_ calls 300
taveKraise24 calls 300
vivelefric calls 150
P1xel7 checks
*** FLOP *** [7d As 5h]
vivelefric bets 2010
P1xel7 folds
marquestaut7 folds
Bayonnedax calls 2010
mAgA_ folds
taveKraise24 raises 8040 to 10050
vivelefric raises 18525 to 28575 and is all-in
Bayonnedax folds
taveKraise24 calls 13658 and is all-in
*** TURN *** [7d As 5h][Jc]
*** RIVER *** [7d As 5h Jc][8h]
*** SHOW DOWN ***
taveKraise24 shows [Ah 5d] (Two pairs : Aces and 5)
vivelefric shows [Ad 7h] (Two pairs : Aces and 7)
vivelefric collected 56303 from pot
*** SUMMARY ***
Total pot 56303 | No rake
Board: [7d As 5h Jc 8h]
Seat 1: taveKraise24 (button) showed [Ah 5d] and lost with Two pairs : Aces and 5
Seat 2: vivelefric (small blind) showed [Ad 7h] and won 56303 with Two pairs : Aces and 7


Winamax Poker - Tournament "Kill The Fish" buyIn: 0.45€ + 0.05€ level: 3 - HandId: #3040732885884600333-36-1699726230 - Holdem no limit (35/150/300) - 2023/11/11 18:10:30 UTC
Table: 'Kill The Fish(707975795)#012' 6-max (real money) Seat #2 is the button
Seat 2: vivelefric (56303, 0.44€ bounty)
Seat 3: P1xel7 (31215, 0.22€ bounty)
Seat 4: marquestaut7 (31387, 0.33€ bounty)
Seat 5: Bayonnedax (17315, 0.22€ bounty)
Seat 6: mAgA_ (17400, 0.22€ bounty)
*** ANTE/BLINDS ***
P1xel7 posts ante 35
marquestaut7 posts ante 35
vivelefric posts ante 35
Bayonnedax posts ante 35
mAgA_ posts ante 35
P1xel7 posts small blind 150
marquestaut7 posts big blind 300
Dealt to P1xel7 [Kd 7s]
*** PRE-FLOP *** 
Bayonnedax folds
mAgA_ calls 300
vivelefric folds
P1xel7 folds
marquestaut7 raises 925 to 1225
mAgA_ calls 925
*** FLOP *** [3s Qd Ac]
marquestaut7 bets 2775
mAgA_ folds
marquestaut7 collected 5550 from pot
*** SUMMARY ***
Total pot 5550 | No rake
Board: [3s Qd Ac]
Seat 4: marquestaut7 (big blind) won 5550


Winamax Poker - Tournament "Kill The Fish" buyIn: 0.45€ + 0.05€ level: 3 - HandId: #3040732885884600333-37-1699726258 - Holdem no limit (35/150/300) - 2023/11/11 18:10:58 UTC
Table: 'Kill The Fish(707975795)#012' 6-max (real money) Seat #3 is the button
Seat 1: Rizvertpomme (20000, 0.22€ bounty)
Seat 2: vivelefric (56268, 0.44€ bounty)
Seat 3: P1xel7 (31030, 0.22€ bounty)
Seat 4: marquestaut7 (32902, 0.33€ bounty)
Seat 5: Bayonnedax (17280, 0.22€ bounty)
Seat 6: mAgA_ (16140, 0.22€ bounty)
*** ANTE/BLINDS ***
marquestaut7 posts ante 35
Bayonnedax posts ante 35
Rizvertpomme posts ante 35
vivelefric posts ante 35
P1xel7 posts ante 35
mAgA_ posts ante 35
marquestaut7 posts small blind 150
Bayonnedax posts big blind 300
Dealt to P1xel7 [3d 9h]
*** PRE-FLOP *** 
mAgA_ folds
Rizvertpomme folds
vivelefric raises 960 to 1260
P1xel7 folds
marquestaut7 calls 1110
Bayonnedax folds
*** FLOP *** [9c 6d As]
marquestaut7 checks
vivelefric bets 3030
marquestaut7 folds
vivelefric collected 6060 from pot
*** SUMMARY ***
Total pot 6060 | No rake
Board: [9c 6d As]
Seat 2: vivelefric won 6060


Winamax Poker - Tournament "Kill The Fish" buyIn: 0.45€ + 0.05€ level: 4 - HandId: #3040732885884600333-38-1699726307 - Holdem no limit (40/175/350) - 2023/11/11 18:11:47 UTC
Table: 'Kill The Fish(707975795)#012' 6-max (real money) Seat #4 is the button
Seat 1: Rizvertpomme (19965, 0.22€ bounty)
Seat 2: vivelefric (58003, 0.44€ bounty)
Seat 3: P1xel7 (30995, 0.22€ bounty)
Seat 4: marquestaut7 (31607, 0.33€ bounty)
Seat 5: Bayonnedax (16945, 0.22€ bounty)
Seat 6: mAgA_ (16105, 0.22€ bounty)
*** ANTE/BLINDS ***
Bayonnedax posts ante 40
mAgA_ posts ante 40
Rizvertpomme posts ante 40
vivelefric posts ante 40
P1xel7 posts ante 40
marquestaut7 posts ante 40
Bayonnedax posts small blind 175
mAgA_ posts big blind 350
Dealt to P1xel7 [Ah 9s]
*** PRE-FLOP *** 
Rizvertpomme folds
vivelefric folds
P1xel7 raises 420 to 770
marquestaut7 calls 770
Bayonnedax folds
mAgA_ calls 420
*** FLOP *** [9h 3d 7c]
mAgA_ checks
P1xel7 bets 1771
marquestaut7 folds
mAgA_ folds
P1xel7 collected 4496 from pot
*** SUMMARY ***
Total pot 4496 | No rake
Board: [9h 3d 7c]
Seat 3: P1xel7 won 4496


Winamax Poker - Tournament "Kill The Fish" buyIn: 0.45€ + 0.05€ level: 4 - HandId: #3040732885884600333-39-1699726388 - Holdem no limit (40/175/350) - 2023/11/11 18:13:08 UTC
Table: 'Kill The Fish(707975795)#012' 6-max (real money) Seat #5 is the button
Seat 1: Rizvertpomme (19925, 0.22€ bounty)
Seat 2: vivelefric (57963, 0.44€ bounty)
Seat 3: P1xel7 (32910, 0.22€ bounty)
Seat 4: marquestaut7 (30797, 0.33€ bounty)
Seat 5: Bayonnedax (16730, 0.22€ bounty)
Seat 6: mAgA_ (15295, 0.22€ bounty)
*** ANTE/BLINDS ***
mAgA_ posts ante 40
Rizvertpomme posts ante 40
vivelefric posts ante 40
P1xel7 posts ante 40
marquestaut7 posts ante 40
Bayonnedax posts ante 40
mAgA_ posts small blind 175
Rizvertpomme posts big blind 350
Dealt to P1xel7 [9c 5h]
*** PRE-FLOP *** 
vivelefric folds
P1xel7 folds
marquestaut7 folds
Bayonnedax folds
mAgA_ raises 700 to 1050
Rizvertpomme folds
mAgA_ collected 1640 from pot
*** SUMMARY ***
Total pot 1640 | No rake
Seat 6: mAgA_ (small blind) won 1640


Winamax Poker - Tournament "Kill The Fish" buyIn: 0.45€ + 0.05€ level: 4 - HandId: #3040732885884600333-40-1699726405 - Holdem no limit (40/175/350) - 2023/11/11 18:13:25 UTC
Table: 'Kill The Fish(707975795)#012' 6-max (real money) Seat #6 is the button
Seat 1: Rizvertpomme (19535, 0.22€ bounty)
Seat 2: vivelefric (57923, 0.44€ bounty)
Seat 3: P1xel7 (32870, 0.22€ bounty)
Seat 4: marquestaut7 (30757, 0.33€ bounty)
Seat 5: Bayonnedax (16690, 0.22€ bounty)
Seat 6: mAgA_ (15845, 0.22€ bounty)
*** ANTE/BLINDS ***
Rizvertpomme posts ante 40
vivelefric posts ante 40
P1xel7 posts ante 40
marquestaut7 posts ante 40
Bayonnedax posts ante 40
mAgA_ posts ante 40
Rizvertpomme posts small blind 175
vivelefric posts big blind 350
Dealt to P1xel7 [8h 9d]
*** PRE-FLOP *** 
P1xel7 folds
marquestaut7 folds
Bayonnedax folds
mAgA_ folds
Rizvertpomme raises 350 to 700
vivelefric folds
Rizvertpomme collected 1290 from pot
*** SUMMARY ***
Total pot 1290 | No rake
Seat 1: Rizvertpomme (small blind) won 1290


Winamax Poker - Tournament "Kill The Fish" buyIn: 0.45€ + 0.05€ level: 4 - HandId: #3040732885884600333-41-1699726436 - Holdem no limit (40/175/350) - 2023/11/11 18:13:56 UTC
Table: 'Kill The Fish(707975795)#012' 6-max (real money) Seat #1 is the button
Seat 1: Rizvertpomme (20085, 0.22€ bounty)
Seat 2: vivelefric (57533, 0.44€ bounty)
Seat 3: P1xel7 (32830, 0.22€ bounty)
Seat 4: marquestaut7 (30717, 0.33€ bounty)
Seat 5: Bayonnedax (16650, 0.22€ bounty)
Seat 6: mAgA_ (15805, 0.22€ bounty)
*** ANTE/BLINDS ***
vivelefric posts ante 40
P1xel7 posts ante 40
Rizvertpomme posts ante 40
marquestaut7 posts ante 40
Bayonnedax posts ante 40
mAgA_ posts ante 40
vivelefric posts small blind 175
P1xel7 posts big blind 350
Dealt to P1xel7 [Kh 7d]
*** PRE-FLOP *** 
marquestaut7 folds
Bayonnedax folds
mAgA_ calls 350
Rizvertpomme folds
vivelefric calls 175
P1xel7 checks
*** FLOP *** [5c Ah Td]
vivelefric checks
P1xel7 checks
mAgA_ checks
*** TURN *** [5c Ah Td][7s]
vivelefric checks
P1xel7 bets 452
mAgA_ folds
vivelefric calls 452
*** RIVER *** [5c Ah Td 7s][7c]
vivelefric checks
P1xel7 bets 1426
vivelefric folds
P1xel7 collected 3620 from pot
*** SUMMARY ***
Total pot 3620 | No rake
Board: [5c Ah Td 7s 7c]
Seat 3: P1xel7 (big blind) won 3620


Winamax Poker - Tournament "Kill The Fish" buyIn: 0.45€ + 0.05€ level: 4 - HandId: #3040732885884600333-42-1699726495 - Holdem no limit (40/175/350) - 2023/11/11 18:14:55 UTC
Table: 'Kill The Fish(707975795)#012' 6-max (real money) Seat #2 is the button
Seat 1: Rizvertpomme (20045, 0.22€ bounty)
Seat 2: vivelefric (56691, 0.44€ bounty)
Seat 3: P1xel7 (34182, 0.22€ bounty)
Seat 4: marquestaut7 (30677, 0.33€ bounty)
Seat 5: Bayonnedax (16610, 0.22€ bounty)
Seat 6: mAgA_ (15415, 0.22€ bounty)
*** ANTE/BLINDS ***
P1xel7 posts ante 40
marquestaut7 posts ante 40
Rizvertpomme posts ante 40
vivelefric posts ante 40
Bayonnedax posts ante 40
mAgA_ posts ante 40
P1xel7 posts small blind 175
marquestaut7 posts big blind 350
Dealt to P1xel7 [4c 5d]
*** PRE-FLOP *** 
Bayonnedax folds
mAgA_ folds
Rizvertpomme folds
vivelefric folds
P1xel7 raises 350 to 700
marquestaut7 folds
P1xel7 collected 1290 from pot
*** SUMMARY ***
Total pot 1290 | No rake
Seat 3: P1xel7 (small blind) won 1290


Winamax Poker - Tournament "Kill The Fish" buyIn: 0.45€ + 0.05€ level: 4 - HandId: #3040732885884600333-43-1699726510 - Holdem no limit (40/175/350) - 2023/11/11 18:15:10 UTC
Table: 'Kill The Fish(707975795)#012' 6-max (real money) Seat #3 is the button
Seat 1: Rizvertpomme (20005, 0.22€ bounty)
Seat 2: vivelefric (56651, 0.44€ bounty)
Seat 3: P1xel7 (34732, 0.22€ bounty)
Seat 4: marquestaut7 (30287, 0.33€ bounty)
Seat 5: Bayonnedax (16570, 0.22€ bounty)
Seat 6: mAgA_ (15375, 0.22€ bounty)
*** ANTE/BLINDS ***
marquestaut7 posts ante 40
Bayonnedax posts ante 40
Rizvertpomme posts ante 40
vivelefric posts ante 40
P1xel7 posts ante 40
mAgA_ posts ante 40
marquestaut7 posts small blind 175
Bayonnedax posts big blind 350
Dealt to P1xel7 [7h Qs]
*** PRE-FLOP *** 
mAgA_ folds
Rizvertpomme folds
vivelefric calls 350
P1xel7 folds
marquestaut7 folds
Bayonnedax checks
*** FLOP *** [Kc 3h Th]
Bayonnedax bets 350
vivelefric calls 350
*** TURN *** [Kc 3h Th][Tc]
Bayonnedax bets 635
vivelefric calls 635
*** RIVER *** [Kc 3h Th Tc][4c]
Bayonnedax checks
vivelefric bets 3085
Bayonnedax folds
vivelefric collected 6170 from pot
*** SUMMARY ***
Total pot 6170 | No rake
Board: [Kc 3h Th Tc 4c]
Seat 2: vivelefric won 6170


Winamax Poker - Tournament "Kill The Fish" buyIn: 0.45€ + 0.05€ level: 4 - HandId: #3040732885884600333-44-1699726546 - Holdem no limit (40/175/350) - 2023/11/11 18:15:46 UTC
Table: 'Kill The Fish(707975795)#012' 6-max (real money) Seat #4 is the button
Seat 1: Rizvertpomme (19965, 0.22€ bounty)
Seat 2: vivelefric (58361, 0.44€ bounty)
Seat 3: P1xel7 (34692, 0.22€ bounty)
Seat 4: marquestaut7 (30072, 0.33€ bounty)
Seat 5: Bayonnedax (15195, 0.22€ bounty)
Seat 6: mAgA_ (15335, 0.22€ bounty)
*** ANTE/BLINDS ***
Bayonnedax posts ante 40
mAgA_ posts ante 40
Rizvertpomme posts ante 40
vivelefric posts ante 40
P1xel7 posts ante 40
marquestaut7 posts ante 40
Bayonnedax posts small blind 175
mAgA_ posts big blind 350
Dealt to P1xel7 [7c Kh]
*** PRE-FLOP *** 
Rizvertpomme folds
vivelefric calls 350
P1xel7 folds
marquestaut7 folds
Bayonnedax calls 175
mAgA_ checks
*** FLOP *** [2d 9c 4s]
Bayonnedax checks
mAgA_ checks
vivelefric checks
*** TURN *** [2d 9c 4s][Qc]
Bayonnedax bets 350
mAgA_ folds
vivelefric calls 350
*** RIVER *** [2d 9c 4s Qc][Kc]
Bayonnedax bets 14455 and is all-in
vivelefric folds
Bayonnedax collected 16445 from pot
*** SUMMARY ***
Total pot 16445 | No rake
Board: [2d 9c 4s Qc Kc]
Seat 5: Bayonnedax (small blind) won 16445


Winamax Poker - Tournament "Kill The Fish" buyIn: 0.45€ + 0.05€ level: 5 - HandId: #3040732885884600333-45-1699726611 - Holdem no limit (50/200/400) - 2023/11/11 18:16:51 UTC
Table: 'Kill The Fish(707975795)#012' 6-max (real money) Seat #5 is the button
Seat 1: Rizvertpomme (19925, 0.22€ bounty)
Seat 2: vivelefric (57621, 0.44€ bounty)
Seat 3: P1xel7 (34652, 0.22€ bounty)
Seat 4: marquestaut7 (30032, 0.33€ bounty)
Seat 5: Bayonnedax (16445, 0.22€ bounty)
Seat 6: mAgA_ (14945, 0.22€ bounty)
*** ANTE/BLINDS ***
mAgA_ posts ante 50
Rizvertpomme posts ante 50
vivelefric posts ante 50
P1xel7 posts ante 50
marquestaut7 posts ante 50
Bayonnedax posts ante 50
mAgA_ posts small blind 200
Rizvertpomme posts big blind 400
Dealt to P1xel7 [Kh 2c]
*** PRE-FLOP *** 
vivelefric folds
P1xel7 folds
marquestaut7 folds
Bayonnedax folds
mAgA_ calls 200
Rizvertpomme checks
*** FLOP *** [Jh 5s 3s]
mAgA_ checks
Rizvertpomme bets 800
mAgA_ folds
Rizvertpomme collected 1900 from pot
*** SUMMARY ***
Total pot 1900 | No rake
Board: [Jh 5s 3s]
Seat 1: Rizvertpomme (big blind) won 1900


Winamax Poker - Tournament "Kill The Fish" buyIn: 0.45€ + 0.05€ level: 5 - HandId: #3040732885884600333-46-1699726650 - Holdem no limit (50/200/400) - 2023/11/11 18:17:30 UTC
Table: 'Kill The Fish(707975795)#012' 6-max (real money) Seat #6 is the button
Seat 1: Rizvertpomme (20575, 0.22€ bounty)
Seat 2: vivelefric (57571, 0.44€ bounty)
Seat 3: P1xel7 (34602, 0.22€ bounty)
Seat 4: marquestaut7 (29982, 0.33€ bounty)
Seat 5: Bayonnedax (16395, 0.22€ bounty)
Seat 6: mAgA_ (14495, 0.22€ bounty)
*** ANTE/BLINDS ***
Rizvertpomme posts ante 50
vivelefric posts ante 50
P1xel7 posts ante 50
marquestaut7 posts ante 50
Bayonnedax posts ante 50
mAgA_ posts ante 50
Rizvertpomme posts small blind 200
vivelefric posts big blind 400
Dealt to P1xel7 [Jh Jd]
*** PRE-FLOP *** 
P1xel7 raises 600 to 1000
marquestaut7 folds
Bayonnedax folds
mAgA_ folds
Rizvertpomme calls 800
vivelefric calls 600
*** FLOP *** [Jc 3c 8d]
Rizvertpomme checks
vivelefric bets 3300
P1xel7 calls 3300
Rizvertpomme calls 3300
*** TURN *** [Jc 3c 8d][7d]
Rizvertpomme checks
vivelefric bets 13200
P1xel7 raises 17052 to 30252 and is all-in
Rizvertpomme folds
vivelefric calls 17052
*** RIVER *** [Jc 3c 8d 7d][As]
*** SHOW DOWN ***
vivelefric shows [8c 7s] (Two pairs : 8 and 7)
P1xel7 shows [Jh Jd] (Trips of Jacks)
P1xel7 collected 73704 from pot
*** SUMMARY ***
Total pot 73704 | No rake
Board: [Jc 3c 8d 7d As]
Seat 2: vivelefric (big blind) showed [8c 7s] and lost with Two pairs : 8 and 7
Seat 3: P1xel7 showed [Jh Jd] and won 73704 with Trips of Jacks


Winamax Poker - Tournament "Kill The Fish" buyIn: 0.45€ + 0.05€ level: 5 - HandId: #3040732885884600333-47-1699726710 - Holdem no limit (50/200/400) - 2023/11/11 18:18:30 UTC
Table: 'Kill The Fish(707975795)#012' 6-max (real money) Seat #1 is the button
Seat 1: Rizvertpomme (16225, 0.22€ bounty)
Seat 2: vivelefric (22969, 0.44€ bounty)
Seat 3: P1xel7 (73704, 0.22€ bounty)
Seat 4: marquestaut7 (29932, 0.33€ bounty)
Seat 5: Bayonnedax (16345, 0.22€ bounty)
Seat 6: mAgA_ (14445, 0.22€ bounty)
*** ANTE/BLINDS ***
vivelefric posts ante 50
P1xel7 posts ante 50
Rizvertpomme posts ante 50
marquestaut7 posts ante 50
Bayonnedax posts ante 50
mAgA_ posts ante 50
vivelefric posts small blind 200
P1xel7 posts big blind 400
Dealt to P1xel7 [Js 8d]
*** PRE-FLOP *** 
marquestaut7 folds
Bayonnedax folds
mAgA_ folds
Rizvertpomme folds
vivelefric raises 1100 to 1500
P1xel7 folds
vivelefric collected 2200 from pot
*** SUMMARY ***
Total pot 2200 | No rake
Seat 2: vivelefric (small blind) won 2200


Winamax Poker - Tournament "Kill The Fish" buyIn: 0.45€ + 0.05€ level: 5 - HandId: #3040732885884600333-48-1699726739 - Holdem no limit (50/200/400) - 2023/11/11 18:18:59 UTC
Table: 'Kill The Fish(707975795)#012' 6-max (real money) Seat #2 is the button
Seat 1: Rizvertpomme (16175, 0.22€ bounty)
Seat 2: vivelefric (23619, 0.44€ bounty)
Seat 3: P1xel7 (73254, 0.22€ bounty)
Seat 4: marquestaut7 (29882, 0.33€ bounty)
Seat 5: Bayonnedax (16295, 0.22€ bounty)
Seat 6: mAgA_ (14395, 0.22€ bounty)
*** ANTE/BLINDS ***
P1xel7 posts ante 50
marquestaut7 posts ante 50
Rizvertpomme posts ante 50
vivelefric posts ante 50
Bayonnedax posts ante 50
mAgA_ posts ante 50
P1xel7 posts small blind 200
marquestaut7 posts big blind 400
Dealt to P1xel7 [2c 9c]
*** PRE-FLOP *** 
Bayonnedax folds
mAgA_ calls 400
Rizvertpomme folds
vivelefric calls 400
P1xel7 folds
marquestaut7 folds
*** FLOP *** [9s Ks Tc]
mAgA_ bets 595
vivelefric calls 595
*** TURN *** [9s Ks Tc][5d]
mAgA_ checks
vivelefric checks
*** RIVER *** [9s Ks Tc 5d][8h]
mAgA_ bets 1445
vivelefric folds
mAgA_ collected 4335 from pot
*** SUMMARY ***
Total pot 4335 | No rake
Board: [9s Ks Tc 5d 8h]
Seat 6: mAgA_ won 4335


Winamax Poker - Tournament "Kill The Fish" buyIn: 0.45€ + 0.05€ level: 5 - HandId: #3040732885884600333-49-1699726770 - Holdem no limit (50/200/400) - 2023/11/11 18:19:30 UTC
Table: 'Kill The Fish(707975795)#012' 6-max (real money) Seat #3 is the button
Seat 1: Rizvertpomme (16125, 0.22€ bounty)
Seat 2: vivelefric (22574, 0.44€ bounty)
Seat 3: P1xel7 (73004, 0.22€ bounty)
Seat 4: marquestaut7 (29432, 0.33€ bounty)
Seat 5: Bayonnedax (16245, 0.22€ bounty)
Seat 6: mAgA_ (16240, 0.22€ bounty)
*** ANTE/BLINDS ***
marquestaut7 posts ante 50
Bayonnedax posts ante 50
Rizvertpomme posts ante 50
vivelefric posts ante 50
P1xel7 posts ante 50
mAgA_ posts ante 50
marquestaut7 posts small blind 200
Bayonnedax posts big blind 400
Dealt to P1xel7 [2h 5d]
*** PRE-FLOP *** 
mAgA_ folds
Rizvertpomme raises 400 to 800
vivelefric raises 21724 to 22524 and is all-in
P1xel7 folds
marquestaut7 folds
Bayonnedax folds
Rizvertpomme folds
vivelefric collected 24224 from pot
*** SUMMARY ***
Total pot 24224 | No rake
Seat 2: vivelefric won 24224


Winamax Poker - Tournament "Kill The Fish" buyIn: 0.45€ + 0.05€ level: 5 - HandId: #3040732885884600333-50-1699726783 - Holdem no limit (50/200/400) - 2023/11/11 18:19:43 UTC
Table: 'Kill The Fish(707975795)#012' 6-max (real money) Seat #4 is the button
Seat 1: Rizvertpomme (15275, 0.22€ bounty)
Seat 2: vivelefric (24224, 0.44€ bounty)
Seat 3: P1xel7 (72954, 0.22€ bounty)
Seat 4: marquestaut7 (29182, 0.33€ bounty)
Seat 5: Bayonnedax (15795, 0.22€ bounty)
Seat 6: mAgA_ (16190, 0.22€ bounty)
*** ANTE/BLINDS ***
Bayonnedax posts ante 50
mAgA_ posts ante 50
Rizvertpomme posts ante 50
vivelefric posts ante 50
P1xel7 posts ante 50
marquestaut7 posts ante 50
Bayonnedax posts small blind 200
mAgA_ posts big blind 400
Dealt to P1xel7 [Td Kh]
*** PRE-FLOP *** 
Rizvertpomme folds
vivelefric calls 400
P1xel7 raises 480 to 880
marquestaut7 folds
Bayonnedax folds
mAgA_ calls 480
vivelefric raises 3140 to 4020
P1xel7 folds
mAgA_ folds
vivelefric collected 6280 from pot
*** SUMMARY ***
Total pot 6280 | No rake
Seat 2: vivelefric won 6280


Winamax Poker - Tournament "Kill The Fish" buyIn: 0.45€ + 0.05€ level: 5 - HandId: #3040732885884600333-51-1699726821 - Holdem no limit (50/200/400) - 2023/11/11 18:20:21 UTC
Table: 'Kill The Fish(707975795)#012' 6-max (real money) Seat #5 is the button
Seat 1: Rizvertpomme (15225, 0.22€ bounty)
Seat 2: vivelefric (26434, 0.44€ bounty)
Seat 3: P1xel7 (72024, 0.22€ bounty)
Seat 4: marquestaut7 (29132, 0.33€ bounty)
Seat 5: Bayonnedax (15545, 0.22€ bounty)
Seat 6: mAgA_ (15260, 0.22€ bounty)
*** ANTE/BLINDS ***
mAgA_ posts ante 50
Rizvertpomme posts ante 50
vivelefric posts ante 50
P1xel7 posts ante 50
marquestaut7 posts ante 50
Bayonnedax posts ante 50
mAgA_ posts small blind 200
Rizvertpomme posts big blind 400
Dealt to P1xel7 [Qd 5s]
*** PRE-FLOP *** 
vivelefric calls 400
P1xel7 folds
marquestaut7 folds
Bayonnedax calls 400
mAgA_ calls 200
Rizvertpomme checks
*** FLOP *** [Jc 6s 5d]
mAgA_ bets 1235
Rizvertpomme folds
vivelefric folds
Bayonnedax folds
mAgA_ collected 3135 from pot
*** SUMMARY ***
Total pot 3135 | No rake
Board: [Jc 6s 5d]
Seat 6: mAgA_ (small blind) won 3135


Winamax Poker - Tournament "Kill The Fish" buyIn: 0.45€ + 0.05€ level: 5 - HandId: #3040732885884600333-52-1699726851 - Holdem no limit (50/200/400) - 2023/11/11 18:20:51 UTC
Table: 'Kill The Fish(707975795)#012' 6-max (real money) Seat #6 is the button
Seat 1: Rizvertpomme (14775, 0.22€ bounty)
Seat 2: vivelefric (25984, 0.44€ bounty)
Seat 3: P1xel7 (71974, 0.22€ bounty)
Seat 4: marquestaut7 (29082, 0.33€ bounty)
Seat 5: Bayonnedax (15095, 0.22€ bounty)
Seat 6: mAgA_ (16710, 0.22€ bounty)
*** ANTE/BLINDS ***
Rizvertpomme posts ante 50
vivelefric posts ante 50
P1xel7 posts ante 50
marquestaut7 posts ante 50
Bayonnedax posts ante 50
mAgA_ posts ante 50
Rizvertpomme posts small blind 200
vivelefric posts big blind 400
Dealt to P1xel7 [Kc 9h]
*** PRE-FLOP *** 
P1xel7 raises 480 to 880
marquestaut7 folds
Bayonnedax folds
mAgA_ folds
Rizvertpomme calls 680
vivelefric raises 25054 to 25934 and is all-in
P1xel7 folds
Rizvertpomme calls 13845 and is all-in
*** FLOP *** [Jc 2s Ad]
*** TURN *** [Jc 2s Ad][6h]
*** RIVER *** [Jc 2s Ad 6h][5d]
*** SHOW DOWN ***
Rizvertpomme shows [Qd Kd] (High card : Ace)
vivelefric shows [Qs 4s] (High card : Ace)
vivelefric collected 11209 from side pot 1
Rizvertpomme collected 30630 from main pot
*** SUMMARY ***
Total pot 41839 | No rake
Board: [Jc 2s Ad 6h 5d]
Seat 1: Rizvertpomme (small blind) showed [Qd Kd] and won 30630 with High card : Ace
Seat 2: vivelefric (big blind) showed [Qs 4s] and won 11209 with High card : Ace


Winamax Poker - Tournament "Kill The Fish" buyIn: 0.45€ + 0.05€ level: 6 - HandId: #3040732885884600333-53-1699726883 - Holdem no limit (60/250/500) - 2023/11/11 18:21:23 UTC
Table: 'Kill The Fish(707975795)#012' 6-max (real money) Seat #1 is the button
Seat 1: Rizvertpomme (30630, 0.22€ bounty)
Seat 2: vivelefric (11209, 0.44€ bounty)
Seat 3: P1xel7 (71044, 0.22€ bounty)
Seat 4: marquestaut7 (29032, 0.33€ bounty)
Seat 5: Bayonnedax (15045, 0.22€ bounty)
Seat 6: mAgA_ (16660, 0.22€ bounty)
*** ANTE/BLINDS ***
vivelefric posts ante 60
P1xel7 posts ante 60
Rizvertpomme posts ante 60
marquestaut7 posts ante 60
Bayonnedax posts ante 60
mAgA_ posts ante 60
vivelefric posts small blind 250
P1xel7 posts big blind 500
Dealt to P1xel7 [Ad 7d]
*** PRE-FLOP *** 
marquestaut7 folds
Bayonnedax calls 500
mAgA_ calls 500
Rizvertpomme folds
vivelefric raises 10649 to 11149 and is all-in
P1xel7 calls 10649
Bayonnedax folds
mAgA_ folds
*** FLOP *** [2s 4c 6c]
*** TURN *** [2s 4c 6c][4h]
*** RIVER *** [2s 4c 6c 4h][Qd]
*** SHOW DOWN ***
P1xel7 shows [Ad 7d] (One pair : 4)
vivelefric shows [3s Qh] (Two pairs : Queens and 4)
vivelefric collected 23658 from pot
*** SUMMARY ***
Total pot 23658 | No rake
Board: [2s 4c 6c 4h Qd]
Seat 2: vivelefric (small blind) showed [3s Qh] and won 23658 with Two pairs : Queens and 4
Seat 3: P1xel7 (big blind) showed [Ad 7d] and lost with One pair : 4


Winamax Poker - Tournament "Kill The Fish" buyIn: 0.45€ + 0.05€ level: 6 - HandId: #3040732885884600333-54-1699726909 - Holdem no limit (60/250/500) - 2023/11/11 18:21:49 UTC
Table: 'Kill The Fish(707975795)#012' 6-max (real money) Seat #2 is the button
Seat 1: Rizvertpomme (30570, 0.22€ bounty)
Seat 2: vivelefric (23658, 0.44€ bounty)
Seat 3: P1xel7 (59835, 0.22€ bounty)
Seat 4: marquestaut7 (28972, 0.33€ bounty)
Seat 5: Bayonnedax (14485, 0.22€ bounty)
Seat 6: mAgA_ (16100, 0.22€ bounty)
*** ANTE/BLINDS ***
P1xel7 posts ante 60
marquestaut7 posts ante 60
Rizvertpomme posts ante 60
vivelefric posts ante 60
Bayonnedax posts ante 60
mAgA_ posts ante 60
P1xel7 posts small blind 250
marquestaut7 posts big blind 500
Dealt to P1xel7 [6d 7h]
*** PRE-FLOP *** 
Bayonnedax folds
mAgA_ folds
Rizvertpomme folds
vivelefric raises 23098 to 23598 and is all-in
P1xel7 folds
marquestaut7 folds
vivelefric collected 24708 from pot
*** SUMMARY ***
Total pot 24708 | No rake
Seat 2: vivelefric (button) won 24708


Winamax Poker - Tournament "Kill The Fish" buyIn: 0.45€ + 0.05€ level: 6 - HandId: #3040732885884600333-55-1699726927 - Holdem no limit (60/250/500) - 2023/11/11 18:22:07 UTC
Table: 'Kill The Fish(707975795)#012' 6-max (real money) Seat #3 is the button
Seat 1: Rizvertpomme (30510, 0.22€ bounty)
Seat 2: vivelefric (24708, 0.44€ bounty)
Seat 3: P1xel7 (59525, 0.22€ bounty)
Seat 4: marquestaut7 (28412, 0.33€ bounty)
Seat 5: Bayonnedax (14425, 0.22€ bounty)
Seat 6: mAgA_ (16040, 0.22€ bounty)
*** ANTE/BLINDS ***
marquestaut7 posts ante 60
Bayonnedax posts ante 60
Rizvertpomme posts ante 60
vivelefric posts ante 60
P1xel7 posts ante 60
mAgA_ posts ante 60
marquestaut7 posts small blind 250
Bayonnedax posts big blind 500
Dealt to P1xel7 [3s 3d]
*** PRE-FLOP *** 
mAgA_ calls 500
Rizvertpomme folds
vivelefric calls 500
P1xel7 raises 750 to 1250
marquestaut7 folds
Bayonnedax folds
mAgA_ folds
vivelefric calls 750
*** FLOP *** [Jc Kc 6s]
vivelefric checks
P1xel7 bets 1439
vivelefric calls 1439
*** TURN *** [Jc Kc 6s][7s]
vivelefric bets 6988
P1xel7 folds
vivelefric collected 13976 from pot
*** SUMMARY ***
Total pot 13976 | No rake
Board: [Jc Kc 6s 7s]
Seat 2: vivelefric won 13976


Winamax Poker - Tournament "Kill The Fish" buyIn: 0.45€ + 0.05€ level: 6 - HandId: #3040732885884600333-56-1699726958 - Holdem no limit (60/250/500) - 2023/11/11 18:22:38 UTC
Table: 'Kill The Fish(707975795)#012' 6-max (real money) Seat #4 is the button
Seat 1: Rizvertpomme (30450, 0.22€ bounty)
Seat 2: vivelefric (28947, 0.44€ bounty)
Seat 3: P1xel7 (56776, 0.22€ bounty)
Seat 4: marquestaut7 (28102, 0.33€ bounty)
Seat 5: Bayonnedax (13865, 0.22€ bounty)
Seat 6: mAgA_ (15480, 0.22€ bounty)
*** ANTE/BLINDS ***
Bayonnedax posts ante 60
mAgA_ posts ante 60
Rizvertpomme posts ante 60
vivelefric posts ante 60
P1xel7 posts ante 60
marquestaut7 posts ante 60
Bayonnedax posts small blind 250
mAgA_ posts big blind 500
Dealt to P1xel7 [8h Jd]
*** PRE-FLOP *** 
Rizvertpomme folds
vivelefric calls 500
P1xel7 folds
marquestaut7 folds
Bayonnedax folds
mAgA_ checks
*** FLOP *** [2h Kh Qc]
mAgA_ checks
vivelefric checks
*** TURN *** [2h Kh Qc][8d]
mAgA_ checks
vivelefric bets 1610
mAgA_ folds
vivelefric collected 3220 from pot
*** SUMMARY ***
Total pot 3220 | No rake
Board: [2h Kh Qc 8d]
Seat 2: vivelefric won 3220


Winamax Poker - Tournament "Kill The Fish" buyIn: 0.45€ + 0.05€ level: 6 - HandId: #3040732885884600333-57-1699727034 - Holdem no limit (60/250/500) - 2023/11/11 18:23:54 UTC
Table: 'Kill The Fish(707975795)#012' 6-max (real money) Seat #5 is the button
Seat 1: Rizvertpomme (30390, 0.22€ bounty)
Seat 2: vivelefric (29997, 0.44€ bounty)
Seat 3: P1xel7 (56716, 0.22€ bounty)
Seat 4: marquestaut7 (28042, 0.33€ bounty)
Seat 5: Bayonnedax (13555, 0.22€ bounty)
Seat 6: mAgA_ (14920, 0.22€ bounty)
*** ANTE/BLINDS ***
mAgA_ posts ante 60
Rizvertpomme posts ante 60
vivelefric posts ante 60
P1xel7 posts ante 60
marquestaut7 posts ante 60
Bayonnedax posts ante 60
mAgA_ posts small blind 250
Rizvertpomme posts big blind 500
Dealt to P1xel7 [Ah Jc]
*** PRE-FLOP *** 
vivelefric raises 1610 to 2110
P1xel7 calls 2110
marquestaut7 folds
Bayonnedax folds
mAgA_ folds
Rizvertpomme folds
*** FLOP *** [7h 6s Js]
vivelefric bets 5330
P1xel7 calls 5330
*** TURN *** [7h 6s Js][Ks]
vivelefric bets 15990
P1xel7 raises 33226 to 49216 and is all-in
vivelefric calls 6507 and is all-in
*** RIVER *** [7h 6s Js Ks][Qs]
*** SHOW DOWN ***
vivelefric shows [Ac Jd] (One pair : Jacks)
P1xel7 shows [Ah Jc] (One pair : Jacks)
P1xel7 collected 57211 from side pot 1
vivelefric collected 30492 from main pot
*** SUMMARY ***
Total pot 87703 | No rake
Board: [7h 6s Js Ks Qs]
Seat 2: vivelefric showed [Ac Jd] and won 30492 with One pair : Jacks
Seat 3: P1xel7 showed [Ah Jc] and won 57211 with One pair : Jacks


Winamax Poker - Tournament "Kill The Fish" buyIn: 0.45€ + 0.05€ level: 6 - HandId: #3040732885884600333-58-1699727077 - Holdem no limit (60/250/500) - 2023/11/11 18:24:37 UTC
Table: 'Kill The Fish(707975795)#012' 6-max (real money) Seat #6 is the button
Seat 1: Rizvertpomme (29830, 0.22€ bounty)
Seat 2: vivelefric (30492, 0.44€ bounty)
Seat 3: P1xel7 (57211, 0.22€ bounty)
Seat 4: marquestaut7 (27982, 0.33€ bounty)
Seat 5: Bayonnedax (13495, 0.22€ bounty)
Seat 6: mAgA_ (14610, 0.22€ bounty)
*** ANTE/BLINDS ***
Rizvertpomme posts ante 60
vivelefric posts ante 60
P1xel7 posts ante 60
marquestaut7 posts ante 60
Bayonnedax posts ante 60
mAgA_ posts ante 60
Rizvertpomme posts small blind 250
vivelefric posts big blind 500
Dealt to P1xel7 [5d 6s]
*** PRE-FLOP *** 
P1xel7 folds
marquestaut7 folds
Bayonnedax folds
mAgA_ folds
Rizvertpomme calls 250
vivelefric checks
*** FLOP *** [5c 9d 2c]
Rizvertpomme bets 500
vivelefric calls 500
*** TURN *** [5c 9d 2c][5h]
Rizvertpomme bets 1250
vivelefric calls 1250
*** RIVER *** [5c 9d 2c 5h][6d]
Rizvertpomme bets 1750
vivelefric calls 1750
*** SHOW DOWN ***
vivelefric shows [4c 8c] (One pair : 5)
Rizvertpomme shows [8d Kh] (One pair : 5)
Rizvertpomme collected 8360 from pot
*** SUMMARY ***
Total pot 8360 | No rake
Board: [5c 9d 2c 5h 6d]
Seat 1: Rizvertpomme (small blind) showed [8d Kh] and won 8360 with One pair : 5
Seat 2: vivelefric (big blind) showed [4c 8c] and lost with One pair : 5


Winamax Poker - Tournament "Kill The Fish" buyIn: 0.45€ + 0.05€ level: 6 - HandId: #3040732885884600333-59-1699727131 - Holdem no limit (60/250/500) - 2023/11/11 18:25:31 UTC
Table: 'Kill The Fish(707975795)#012' 6-max (real money) Seat #1 is the button
Seat 1: Rizvertpomme (34130, 0.22€ bounty)
Seat 2: vivelefric (26432, 0.44€ bounty)
Seat 3: P1xel7 (57151, 0.22€ bounty)
Seat 4: marquestaut7 (27922, 0.33€ bounty)
Seat 5: Bayonnedax (13435, 0.22€ bounty)
Seat 6: mAgA_ (14550, 0.22€ bounty)
*** ANTE/BLINDS ***
vivelefric posts ante 60
P1xel7 posts ante 60
Rizvertpomme posts ante 60
marquestaut7 posts ante 60
Bayonnedax posts ante 60
mAgA_ posts ante 60
vivelefric posts small blind 250
P1xel7 posts big blind 500
Dealt to P1xel7 [Ah Ad]
*** PRE-FLOP *** 
marquestaut7 folds
Bayonnedax calls 500
mAgA_ calls 500
Rizvertpomme raises 750 to 1250
vivelefric calls 1000
P1xel7 raises 2500 to 3750
Bayonnedax folds
mAgA_ calls 3250
Rizvertpomme raises 30320 to 34070 and is all-in
vivelefric calls 25122 and is all-in
P1xel7 calls 30320
mAgA_ folds
*** FLOP *** [6d 8c 6s]
*** TURN *** [6d 8c 6s][Jd]
*** RIVER *** [6d 8c 6s Jd][Js]
*** SHOW DOWN ***
Rizvertpomme shows [Kc Kd] (Two pairs : Kings and Jacks)
vivelefric shows [Ks 3c] (Two pairs : Jacks and 6)
P1xel7 shows [Ah Ad] (Two pairs : Aces and Jacks)
P1xel7 collected 99122 from pot
*** SUMMARY ***
Total pot 99122 | No rake
Board: [6d 8c 6s Jd Js]
Seat 1: Rizvertpomme (button) showed [Kc Kd] and lost with Two pairs : Kings and Jacks
Seat 2: vivelefric (small blind) showed [Ks 3c] and lost with Two pairs : Jacks and 6
Seat 3: P1xel7 (big blind) showed [Ah Ad] and won 99122 with Two pairs : Aces and Jacks


Winamax Poker - Tournament "Kill The Fish" buyIn: 0.45€ + 0.05€ level: 7 - HandId: #3040732885884600333-60-1699727195 - Holdem no limit (70/300/600) - 2023/11/11 18:26:35 UTC
Table: 'Kill The Fish(707975795)#012' 6-max (real money) Seat #2 is the button
Seat 3: P1xel7 (122143, 0.55€ bounty)
Seat 4: marquestaut7 (27862, 0.33€ bounty)
Seat 5: Bayonnedax (12875, 0.22€ bounty)
Seat 6: mAgA_ (10740, 0.22€ bounty)
*** ANTE/BLINDS ***
P1xel7 posts ante 70
marquestaut7 posts ante 70
Bayonnedax posts ante 70
mAgA_ posts ante 70
P1xel7 posts small blind 300
marquestaut7 posts big blind 600
Dealt to P1xel7 [As Qh]
*** PRE-FLOP *** 
Bayonnedax calls 600
mAgA_ calls 600
P1xel7 raises 900 to 1500
marquestaut7 folds
Bayonnedax calls 900
mAgA_ calls 900
*** FLOP *** [3c 9s Td]
P1xel7 bets 1883
Bayonnedax raises 9422 to 11305 and is all-in
mAgA_ calls 9170 and is all-in
P1xel7 folds
*** TURN *** [3c 9s Td][Jd]
*** RIVER *** [3c 9s Td Jd][3d]
*** SHOW DOWN ***
Bayonnedax shows [Ac 9h] (Two pairs : 9 and 3)
mAgA_ shows [Qc Js] (Two pairs : Jacks and 3)
mAgA_ collected 25603 from main pot
Bayonnedax collected 2135 from side pot 1
*** SUMMARY ***
Total pot 27738 | No rake
Board: [3c 9s Td Jd 3d]
Seat 5: Bayonnedax showed [Ac 9h] and won 2135 with Two pairs : 9 and 3
Seat 6: mAgA_ showed [Qc Js] and won 25603 with Two pairs : Jacks and 3


Winamax Poker - Tournament "Kill The Fish" buyIn: 0.45€ + 0.05€ level: 7 - HandId: #3040732885884600333-61-1699727264 - Holdem no limit (70/300/600) - 2023/11/11 18:27:44 UTC
Table: 'Kill The Fish(707975795)#012' 6-max (real money) Seat #3 is the button
Seat 1: Gablicha (20000, 0.22€ bounty)
Seat 2: Tocororo (16845, 0.22€ bounty)
Seat 3: P1xel7 (118690, 0.55€ bounty)
Seat 4: marquestaut7 (27192, 0.33€ bounty)
Seat 5: Bayonnedax (2135, 0.22€ bounty)
Seat 6: mAgA_ (25603, 0.22€ bounty)
*** ANTE/BLINDS ***
marquestaut7 posts ante 70
Bayonnedax posts ante 70
Gablicha posts ante 70
Tocororo posts ante 70
P1xel7 posts ante 70
mAgA_ posts ante 70
marquestaut7 posts small blind 300
Bayonnedax posts big blind 600
Dealt to P1xel7 [8h 4s]
*** PRE-FLOP *** 
mAgA_ calls 600
Gablicha calls 600
Tocororo folds
P1xel7 folds
marquestaut7 folds
Bayonnedax raises 1465 to 2065 and is all-in
mAgA_ folds
Gablicha calls 1465
*** FLOP *** [8d 6d As]
*** TURN *** [8d 6d As][Qs]
*** RIVER *** [8d 6d As Qs][3d]
*** SHOW DOWN ***
Gablicha shows [Js 7s] (High card : Ace)
Bayonnedax shows [Kh Kd] (One pair : Kings)
Bayonnedax collected 5450 from pot
*** SUMMARY ***
Total pot 5450 | No rake
Board: [8d 6d As Qs 3d]
Seat 1: Gablicha showed [Js 7s] and lost with High card : Ace
Seat 5: Bayonnedax (big blind) showed [Kh Kd] and won 5450 with One pair : Kings


Winamax Poker - Tournament "Kill The Fish" buyIn: 0.45€ + 0.05€ level: 7 - HandId: #3040732885884600333-62-1699727309 - Holdem no limit (70/300/600) - 2023/11/11 18:28:29 UTC
Table: 'Kill The Fish(707975795)#012' 6-max (real money) Seat #4 is the button
Seat 1: Gablicha (17865, 0.22€ bounty)
Seat 2: Tocororo (16775, 0.22€ bounty)
Seat 3: P1xel7 (118620, 0.55€ bounty)
Seat 4: marquestaut7 (26822, 0.33€ bounty)
Seat 5: Bayonnedax (5450, 0.22€ bounty)
Seat 6: mAgA_ (24933, 0.22€ bounty)
*** ANTE/BLINDS ***
Bayonnedax posts ante 70
mAgA_ posts ante 70
Gablicha posts ante 70
Tocororo posts ante 70
P1xel7 posts ante 70
marquestaut7 posts ante 70
Bayonnedax posts small blind 300
mAgA_ posts big blind 600
Dealt to P1xel7 [Td 2h]
*** PRE-FLOP *** 
Gablicha folds
Tocororo raises 600 to 1200
P1xel7 folds
marquestaut7 folds
Bayonnedax folds
mAgA_ calls 600
*** FLOP *** [Qh Kc 7h]
mAgA_ checks
Tocororo bets 1560
mAgA_ folds
Tocororo collected 4680 from pot
*** SUMMARY ***
Total pot 4680 | No rake
Board: [Qh Kc 7h]
Seat 2: Tocororo won 4680


Winamax Poker - Tournament "Kill The Fish" buyIn: 0.45€ + 0.05€ level: 7 - HandId: #3040732885884600333-63-1699727358 - Holdem no limit (70/300/600) - 2023/11/11 18:29:18 UTC
Table: 'Kill The Fish(707975795)#012' 6-max (real money) Seat #5 is the button
Seat 1: Gablicha (17795, 0.22€ bounty)
Seat 2: Tocororo (18625, 0.22€ bounty)
Seat 3: P1xel7 (118550, 0.55€ bounty)
Seat 4: marquestaut7 (26752, 0.33€ bounty)
Seat 5: Bayonnedax (5080, 0.22€ bounty)
Seat 6: mAgA_ (23663, 0.22€ bounty)
*** ANTE/BLINDS ***
mAgA_ posts ante 70
Gablicha posts ante 70
Tocororo posts ante 70
P1xel7 posts ante 70
marquestaut7 posts ante 70
Bayonnedax posts ante 70
mAgA_ posts small blind 300
Gablicha posts big blind 600
Dealt to P1xel7 [Ad 4h]
*** PRE-FLOP *** 
Tocororo folds
P1xel7 raises 720 to 1320
marquestaut7 folds
Bayonnedax folds
mAgA_ raises 22273 to 23593 and is all-in
Gablicha folds
P1xel7 folds
mAgA_ collected 25933 from pot
*** SUMMARY ***
Total pot 25933 | No rake
Seat 6: mAgA_ (small blind) won 25933


Winamax Poker - Tournament "Kill The Fish" buyIn: 0.45€ + 0.05€ level: 7 - HandId: #3040732885884600333-64-1699727379 - Holdem no limit (70/300/600) - 2023/11/11 18:29:39 UTC
Table: 'Kill The Fish(707975795)#012' 6-max (real money) Seat #6 is the button
Seat 1: Gablicha (17125, 0.22€ bounty)
Seat 2: Tocororo (18555, 0.22€ bounty)
Seat 3: P1xel7 (117160, 0.55€ bounty)
Seat 4: marquestaut7 (26682, 0.33€ bounty)
Seat 5: Bayonnedax (5010, 0.22€ bounty)
Seat 6: mAgA_ (25933, 0.22€ bounty)
*** ANTE/BLINDS ***
Gablicha posts ante 70
Tocororo posts ante 70
P1xel7 posts ante 70
marquestaut7 posts ante 70
Bayonnedax posts ante 70
mAgA_ posts ante 70
Gablicha posts small blind 300
Tocororo posts big blind 600
Dealt to P1xel7 [6d 4c]
*** PRE-FLOP *** 
P1xel7 folds
marquestaut7 folds
Bayonnedax folds
mAgA_ calls 600
Gablicha calls 300
Tocororo checks
*** FLOP *** [Ad 8d 9d]
Gablicha checks
Tocororo checks
mAgA_ checks
*** TURN *** [Ad 8d 9d][7s]
Gablicha checks
Tocororo checks
mAgA_ checks
*** RIVER *** [Ad 8d 9d 7s][7d]
Gablicha checks
Tocororo checks
mAgA_ checks
*** SHOW DOWN ***
Tocororo shows [Qc 5c] (One pair : 7)
mAgA_ shows [7c Ks] (Trips of 7)
Gablicha shows [4d 3c] (Flush Ace high)
Gablicha collected 2220 from pot
*** SUMMARY ***
Total pot 2220 | No rake
Board: [Ad 8d 9d 7s 7d]
Seat 1: Gablicha (small blind) showed [4d 3c] and won 2220 with Flush Ace high
Seat 2: Tocororo (big blind) showed [Qc 5c] and lost with One pair : 7
Seat 6: mAgA_ (button) showed [7c Ks] and lost with Trips of 7


Winamax Poker - Tournament "Kill The Fish" buyIn: 0.45€ + 0.05€ level: 8 - HandId: #3040732885884600333-65-1699727471 - Holdem no limit (80/350/700) - 2023/11/11 18:31:11 UTC
Table: 'Kill The Fish(707975795)#012' 6-max (real money) Seat #1 is the button
Seat 1: Gablicha (18675, 0.22€ bounty)
Seat 2: Tocororo (17885, 0.22€ bounty)
Seat 3: P1xel7 (117090, 0.55€ bounty)
Seat 4: marquestaut7 (26612, 0.33€ bounty)
Seat 5: Bayonnedax (4940, 0.22€ bounty)
Seat 6: mAgA_ (25263, 0.22€ bounty)
*** ANTE/BLINDS ***
Tocororo posts ante 80
P1xel7 posts ante 80
Gablicha posts ante 80
marquestaut7 posts ante 80
Bayonnedax posts ante 80
mAgA_ posts ante 80
Tocororo posts small blind 350
P1xel7 posts big blind 700
Dealt to P1xel7 [Jd 6s]
*** PRE-FLOP *** 
marquestaut7 folds
Bayonnedax folds
mAgA_ raises 700 to 1400
Gablicha folds
Tocororo folds
P1xel7 folds
mAgA_ collected 2930 from pot
*** SUMMARY ***
Total pot 2930 | No rake
Seat 6: mAgA_ won 2930


Winamax Poker - Tournament "Kill The Fish" buyIn: 0.45€ + 0.05€ level: 8 - HandId: #3040732885884600333-66-1699727495 - Holdem no limit (80/350/700) - 2023/11/11 18:31:35 UTC
Table: 'Kill The Fish(707975795)#012' 6-max (real money) Seat #2 is the button
Seat 1: Gablicha (18595, 0.22€ bounty)
Seat 2: Tocororo (17455, 0.22€ bounty)
Seat 3: P1xel7 (116310, 0.55€ bounty)
Seat 4: marquestaut7 (26532, 0.33€ bounty)
Seat 5: Bayonnedax (4860, 0.22€ bounty)
Seat 6: mAgA_ (26713, 0.22€ bounty)
*** ANTE/BLINDS ***
P1xel7 posts ante 80
marquestaut7 posts ante 80
Gablicha posts ante 80
Tocororo posts ante 80
Bayonnedax posts ante 80
mAgA_ posts ante 80
P1xel7 posts small blind 350
marquestaut7 posts big blind 700
Dealt to P1xel7 [Kd Kh]
*** PRE-FLOP *** 
Bayonnedax folds
mAgA_ folds
Gablicha folds
Tocororo raises 700 to 1400
P1xel7 raises 2100 to 3500
marquestaut7 folds
Tocororo folds
P1xel7 collected 6080 from pot
*** SUMMARY ***
Total pot 6080 | No rake
Seat 3: P1xel7 (small blind) won 6080


Winamax Poker - Tournament "Kill The Fish" buyIn: 0.45€ + 0.05€ level: 8 - HandId: #3040732885884600333-67-1699727533 - Holdem no limit (80/350/700) - 2023/11/11 18:32:13 UTC
Table: 'Kill The Fish(707975795)#012' 6-max (real money) Seat #3 is the button
Seat 1: Gablicha (18515, 0.22€ bounty)
Seat 2: Tocororo (15975, 0.22€ bounty)
Seat 3: P1xel7 (118810, 0.55€ bounty)
Seat 4: marquestaut7 (25752, 0.33€ bounty)
Seat 5: Bayonnedax (4780, 0.22€ bounty)
Seat 6: mAgA_ (26633, 0.22€ bounty)
*** ANTE/BLINDS ***
marquestaut7 posts ante 80
Bayonnedax posts ante 80
Gablicha posts ante 80
Tocororo posts ante 80
P1xel7 posts ante 80
mAgA_ posts ante 80
marquestaut7 posts small blind 350
Bayonnedax posts big blind 700
Dealt to P1xel7 [7c 9c]
*** PRE-FLOP *** 
mAgA_ folds
Gablicha folds
Tocororo folds
P1xel7 raises 840 to 1540
marquestaut7 folds
Bayonnedax raises 3160 to 4700 and is all-in
P1xel7 calls 3160
*** FLOP *** [2d Ts 8c]
*** TURN *** [2d Ts 8c][Jc]
*** RIVER *** [2d Ts 8c Jc][Ad]
*** SHOW DOWN ***
Bayonnedax shows [Ah 2c] (Two pairs : Aces and 2)
P1xel7 shows [7c 9c] (Straight Jack high)
P1xel7 collected 10230 from pot
*** SUMMARY ***
Total pot 10230 | No rake
Board: [2d Ts 8c Jc Ad]
Seat 3: P1xel7 (button) showed [7c 9c] and won 10230 with Straight Jack high
Seat 5: Bayonnedax (big blind) showed [Ah 2c] and lost with Two pairs : Aces and 2


Winamax Poker - Tournament "Kill The Fish" buyIn: 0.45€ + 0.05€ level: 8 - HandId: #3040732885884600333-68-1699727583 - Holdem no limit (80/350/700) - 2023/11/11 18:33:03 UTC
Table: 'Kill The Fish(707975795)#012' 6-max (real money) Seat #4 is the button
Seat 1: Gablicha (18435, 0.22€ bounty)
Seat 2: Tocororo (15895, 0.22€ bounty)
Seat 3: P1xel7 (124260, 0.66€ bounty)
Seat 4: marquestaut7 (25322, 0.33€ bounty)
Seat 6: mAgA_ (26553, 0.22€ bounty)
*** ANTE/BLINDS ***
mAgA_ posts ante 80
Gablicha posts ante 80
Tocororo posts ante 80
P1xel7 posts ante 80
marquestaut7 posts ante 80
mAgA_ posts big blind 700
Dealt to P1xel7 [Td Qc]
*** PRE-FLOP *** 
Gablicha folds
Tocororo folds
P1xel7 raises 1050 to 1750
marquestaut7 folds
mAgA_ calls 1050
*** FLOP *** [5d 3h 4h]
mAgA_ checks
P1xel7 bets 1365
mAgA_ calls 1365
*** TURN *** [5d 3h 4h][As]
mAgA_ checks
P1xel7 bets 3315
mAgA_ calls 3315
*** RIVER *** [5d 3h 4h As][4s]
mAgA_ checks
P1xel7 checks
*** SHOW DOWN ***
mAgA_ shows [Th 8h] (One pair : 4)
P1xel7 shows [Td Qc] (One pair : 4)
P1xel7 collected 13260 from pot
*** SUMMARY ***
Total pot 13260 | No rake
Board: [5d 3h 4h As 4s]
Seat 3: P1xel7 showed [Td Qc] and won 13260 with One pair : 4
Seat 6: mAgA_ (big blind) showed [Th 8h] and lost with One pair : 4


Winamax Poker - Tournament "Kill The Fish" buyIn: 0.45€ + 0.05€ level: 8 - HandId: #3040732885884600333-69-1699727627 - Holdem no limit (80/350/700) - 2023/11/11 18:33:47 UTC
Table: 'Kill The Fish(707975795)#012' 6-max (real money) Seat #5 is the button
Seat 1: Gablicha (18355, 0.22€ bounty)
Seat 2: Tocororo (15815, 0.22€ bounty)
Seat 3: P1xel7 (131010, 0.66€ bounty)
Seat 4: marquestaut7 (25242, 0.33€ bounty)
Seat 6: mAgA_ (20043, 0.22€ bounty)
*** ANTE/BLINDS ***
mAgA_ posts ante 80
Gablicha posts ante 80
Tocororo posts ante 80
P1xel7 posts ante 80
marquestaut7 posts ante 80
mAgA_ posts small blind 350
Gablicha posts big blind 700
Dealt to P1xel7 [As 8d]
*** PRE-FLOP *** 
Tocororo folds
P1xel7 raises 1050 to 1750
marquestaut7 folds
mAgA_ folds
Gablicha folds
P1xel7 collected 3200 from pot
*** SUMMARY ***
Total pot 3200 | No rake
Seat 3: P1xel7 won 3200


Winamax Poker - Tournament "Kill The Fish" buyIn: 0.45€ + 0.05€ level: 8 - HandId: #3040732885884600333-70-1699727658 - Holdem no limit (80/350/700) - 2023/11/11 18:34:18 UTC
Table: 'Kill The Fish(707975795)#012' 6-max (real money) Seat #6 is the button
Seat 1: Gablicha (17575, 0.22€ bounty)
Seat 2: Tocororo (15735, 0.22€ bounty)
Seat 3: P1xel7 (132380, 0.66€ bounty)
Seat 4: marquestaut7 (25162, 0.33€ bounty)
Seat 6: mAgA_ (19613, 0.22€ bounty)
*** ANTE/BLINDS ***
Gablicha posts ante 80
Tocororo posts ante 80
P1xel7 posts ante 80
marquestaut7 posts ante 80
mAgA_ posts ante 80
Gablicha posts small blind 350
Tocororo posts big blind 700
Dealt to P1xel7 [7d 3d]
*** PRE-FLOP *** 
P1xel7 folds
marquestaut7 folds
mAgA_ folds
Gablicha folds
Tocororo collected 1450 from pot
*** SUMMARY ***
Total pot 1450 | No rake
Seat 2: Tocororo (big blind) won 1450


Winamax Poker - Tournament "Kill The Fish" buyIn: 0.45€ + 0.05€ level: 8 - HandId: #3040732885884600333-71-1699727670 - Holdem no limit (80/350/700) - 2023/11/11 18:34:30 UTC
Table: 'Kill The Fish(707975795)#012' 6-max (real money) Seat #1 is the button
Seat 1: Gablicha (17145, 0.22€ bounty)
Seat 2: Tocororo (16405, 0.22€ bounty)
Seat 3: P1xel7 (132300, 0.66€ bounty)
Seat 4: marquestaut7 (25082, 0.33€ bounty)
Seat 6: mAgA_ (19533, 0.22€ bounty)
*** ANTE/BLINDS ***
Tocororo posts ante 80
P1xel7 posts ante 80
Gablicha posts ante 80
marquestaut7 posts ante 80
mAgA_ posts ante 80
Tocororo posts small blind 350
P1xel7 posts big blind 700
Dealt to P1xel7 [6h 6d]
*** PRE-FLOP *** 
marquestaut7 folds
mAgA_ calls 700
Gablicha calls 700
Tocororo folds
P1xel7 raises 2800 to 3500
mAgA_ folds
Gablicha calls 2800
*** FLOP *** [3s 2d 9h]
P1xel7 bets 128720 and is all-in
Gablicha calls 13565 and is all-in
*** TURN *** [3s 2d 9h][Jc]
*** RIVER *** [3s 2d 9h Jc][7c]
*** SHOW DOWN ***
Gablicha shows [6s 5s] (High card : Jack)
P1xel7 shows [6h 6d] (One pair : 6)
P1xel7 collected 150735 from pot
*** SUMMARY ***
Total pot 150735 | No rake
Board: [3s 2d 9h Jc 7c]
Seat 1: Gablicha (button) showed [6s 5s] and lost with High card : Jack
Seat 3: P1xel7 (big blind) showed [6h 6d] and won 150735 with One pair : 6


Winamax Poker - Tournament "Kill The Fish" buyIn: 0.45€ + 0.05€ level: 8 - HandId: #3040732885884600333-72-1699727713 - Holdem no limit (80/350/700) - 2023/11/11 18:35:13 UTC
Table: 'Kill The Fish(707975795)#012' 6-max (real money) Seat #2 is the button
Seat 2: Tocororo (15975, 0.22€ bounty)
Seat 3: P1xel7 (150735, 0.77€ bounty)
Seat 4: marquestaut7 (25002, 0.33€ bounty)
Seat 6: mAgA_ (18753, 0.22€ bounty)
*** ANTE/BLINDS ***
P1xel7 posts ante 80
marquestaut7 posts ante 80
Tocororo posts ante 80
mAgA_ posts ante 80
P1xel7 posts small blind 350
marquestaut7 posts big blind 700
Dealt to P1xel7 [5s 3h]
*** PRE-FLOP *** 
mAgA_ folds
Tocororo raises 700 to 1400
P1xel7 folds
marquestaut7 folds
Tocororo collected 2770 from pot
*** SUMMARY ***
Total pot 2770 | No rake
Seat 2: Tocororo (button) won 2770


Winamax Poker - Tournament "Kill The Fish" buyIn: 0.45€ + 0.05€ level: 8 - HandId: #3040732885884600333-73-1699727725 - Holdem no limit (80/350/700) - 2023/11/11 18:35:25 UTC
Table: 'Kill The Fish(707975795)#012' 6-max (real money) Seat #3 is the button
Seat 2: Tocororo (17265, 0.22€ bounty)
Seat 3: P1xel7 (150305, 0.77€ bounty)
Seat 4: marquestaut7 (24222, 0.33€ bounty)
Seat 5: Tonio 7.0 (50818, 0.33€ bounty)
Seat 6: mAgA_ (18673, 0.22€ bounty)
*** ANTE/BLINDS ***
marquestaut7 posts ante 80
Tonio 7.0 posts ante 80
Tocororo posts ante 80
P1xel7 posts ante 80
mAgA_ posts ante 80
marquestaut7 posts small blind 350
Tonio 7.0 posts big blind 700
Dealt to P1xel7 [Th Qc]
*** PRE-FLOP *** 
mAgA_ folds
Tocororo folds
P1xel7 raises 840 to 1540
marquestaut7 folds
Tonio 7.0 raises 49198 to 50738 and is all-in
P1xel7 folds
Tonio 7.0 collected 53028 from pot
*** SUMMARY ***
Total pot 53028 | No rake
Seat 5: Tonio 7.0 (big blind) won 53028


Winamax Poker - Tournament "Kill The Fish" buyIn: 0.45€ + 0.05€ level: 8 - HandId: #3040732885884600333-74-1699727743 - Holdem no limit (80/350/700) - 2023/11/11 18:35:43 UTC
Table: 'Kill The Fish(707975795)#012' 6-max (real money) Seat #4 is the button
Seat 2: Tocororo (17185, 0.22€ bounty)
Seat 3: P1xel7 (148685, 0.77€ bounty)
Seat 4: marquestaut7 (23792, 0.33€ bounty)
Seat 5: Tonio 7.0 (53028, 0.33€ bounty)
Seat 6: mAgA_ (18593, 0.22€ bounty)
*** ANTE/BLINDS ***
Tonio 7.0 posts ante 80
mAgA_ posts ante 80
Tocororo posts ante 80
P1xel7 posts ante 80
marquestaut7 posts ante 80
Tonio 7.0 posts small blind 350
mAgA_ posts big blind 700
Dealt to P1xel7 [Qd 8h]
*** PRE-FLOP *** 
Tocororo folds
P1xel7 folds
marquestaut7 folds
Tonio 7.0 raises 52248 to 52948 and is all-in
mAgA_ folds
Tonio 7.0 collected 54048 from pot
*** SUMMARY ***
Total pot 54048 | No rake
Seat 5: Tonio 7.0 (small blind) won 54048


Winamax Poker - Tournament "Kill The Fish" buyIn: 0.45€ + 0.05€ level: 8 - HandId: #3040732885884600333-75-1699727759 - Holdem no limit (80/350/700) - 2023/11/11 18:35:59 UTC
Table: 'Kill The Fish(707975795)#012' 6-max (real money) Seat #5 is the button
Seat 2: Tocororo (17105, 0.22€ bounty)
Seat 3: P1xel7 (148605, 0.77€ bounty)
Seat 4: marquestaut7 (23712, 0.33€ bounty)
Seat 5: Tonio 7.0 (54048, 0.33€ bounty)
Seat 6: mAgA_ (17813, 0.22€ bounty)
*** ANTE/BLINDS ***
mAgA_ posts ante 80
Tocororo posts ante 80
P1xel7 posts ante 80
marquestaut7 posts ante 80
Tonio 7.0 posts ante 80
mAgA_ posts small blind 350
Tocororo posts big blind 700
Dealt to P1xel7 [3s 9h]
*** PRE-FLOP *** 
P1xel7 folds
marquestaut7 folds
Tonio 7.0 folds
mAgA_ raises 700 to 1400
Tocororo calls 700
*** FLOP *** [Qc Ts 5s]
mAgA_ checks
Tocororo checks
*** TURN *** [Qc Ts 5s][5c]
mAgA_ checks
Tocororo checks
*** RIVER *** [Qc Ts 5s 5c][9s]
mAgA_ checks
Tocororo checks
*** SHOW DOWN ***
mAgA_ shows [4s Kd] (One pair : 5)
Tocororo shows [Ah 8c] (One pair : 5)
Tocororo collected 3200 from pot
*** SUMMARY ***
Total pot 3200 | No rake
Board: [Qc Ts 5s 5c 9s]
Seat 2: Tocororo (big blind) showed [Ah 8c] and won 3200 with One pair : 5
Seat 6: mAgA_ (small blind) showed [4s Kd] and lost with One pair : 5


Winamax Poker - Tournament "Kill The Fish" buyIn: 0.45€ + 0.05€ level: 9 - HandId: #3040732885884600333-76-1699727820 - Holdem no limit (100/400/800) - 2023/11/11 18:37:00 UTC
Table: 'Kill The Fish(707975795)#012' 6-max (real money) Seat #6 is the button
Seat 2: Tocororo (18825, 0.22€ bounty)
Seat 3: P1xel7 (148525, 0.77€ bounty)
Seat 4: marquestaut7 (23632, 0.33€ bounty)
Seat 5: Tonio 7.0 (53968, 0.33€ bounty)
Seat 6: mAgA_ (16333, 0.22€ bounty)
*** ANTE/BLINDS ***
Tocororo posts ante 100
P1xel7 posts ante 100
marquestaut7 posts ante 100
Tonio 7.0 posts ante 100
mAgA_ posts ante 100
Tocororo posts small blind 400
P1xel7 posts big blind 800
Dealt to P1xel7 [3s 7c]
*** PRE-FLOP *** 
marquestaut7 folds
Tonio 7.0 raises 53068 to 53868 and is all-in
mAgA_ folds
Tocororo folds
P1xel7 folds
Tonio 7.0 collected 55568 from pot
*** SUMMARY ***
Total pot 55568 | No rake
Seat 5: Tonio 7.0 won 55568


Winamax Poker - Tournament "Kill The Fish" buyIn: 0.45€ + 0.05€ level: 9 - HandId: #3040732885884600333-77-1699727835 - Holdem no limit (100/400/800) - 2023/11/11 18:37:15 UTC
Table: 'Kill The Fish(707975795)#012' 6-max (real money) Seat #2 is the button
Seat 1: Asticopathe (14547, 0.33€ bounty)
Seat 2: Tocororo (18325, 0.22€ bounty)
Seat 3: P1xel7 (147625, 0.77€ bounty)
Seat 4: marquestaut7 (23532, 0.33€ bounty)
Seat 5: Tonio 7.0 (55568, 0.33€ bounty)
Seat 6: mAgA_ (16233, 0.22€ bounty)
*** ANTE/BLINDS ***
P1xel7 posts ante 100
marquestaut7 posts ante 100
Asticopathe posts ante 100
Tocororo posts ante 100
Tonio 7.0 posts ante 100
mAgA_ posts ante 100
P1xel7 posts small blind 400
marquestaut7 posts big blind 800
Dealt to P1xel7 [Td 2c]
*** PRE-FLOP *** 
Tonio 7.0 folds
mAgA_ folds
Asticopathe folds
Tocororo folds
P1xel7 raises 800 to 1600
marquestaut7 folds
P1xel7 collected 3000 from pot
*** SUMMARY ***
Total pot 3000 | No rake
Seat 3: P1xel7 (small blind) won 3000


Winamax Poker - Tournament "Kill The Fish" buyIn: 0.45€ + 0.05€ level: 9 - HandId: #3040732885884600333-78-1699727866 - Holdem no limit (100/400/800) - 2023/11/11 18:37:46 UTC
Table: 'Kill The Fish(707975795)#012' 6-max (real money) Seat #3 is the button
Seat 1: Asticopathe (14447, 0.33€ bounty)
Seat 2: Tocororo (18225, 0.22€ bounty)
Seat 3: P1xel7 (148925, 0.77€ bounty)
Seat 4: marquestaut7 (22632, 0.33€ bounty)
Seat 5: Tonio 7.0 (55468, 0.33€ bounty)
Seat 6: mAgA_ (16133, 0.22€ bounty)
*** ANTE/BLINDS ***
marquestaut7 posts ante 100
Tonio 7.0 posts ante 100
Asticopathe posts ante 100
Tocororo posts ante 100
P1xel7 posts ante 100
mAgA_ posts ante 100
marquestaut7 posts small blind 400
Tonio 7.0 posts big blind 800
Dealt to P1xel7 [Qc 4h]
*** PRE-FLOP *** 
mAgA_ folds
Asticopathe folds
Tocororo folds
P1xel7 folds
marquestaut7 folds
Tonio 7.0 collected 1800 from pot
*** SUMMARY ***
Total pot 1800 | No rake
Seat 5: Tonio 7.0 (big blind) won 1800


Winamax Poker - Tournament "Kill The Fish" buyIn: 0.45€ + 0.05€ level: 9 - HandId: #3040732885884600333-79-1699727904 - Holdem no limit (100/400/800) - 2023/11/11 18:38:24 UTC
Table: 'Kill The Fish(707975795)#012' 6-max (real money) Seat #4 is the button
Seat 1: Asticopathe (14347, 0.33€ bounty)
Seat 2: Tocororo (18125, 0.22€ bounty)
Seat 3: P1xel7 (148825, 0.77€ bounty)
Seat 4: marquestaut7 (22132, 0.33€ bounty)
Seat 5: Tonio 7.0 (56368, 0.33€ bounty)
Seat 6: mAgA_ (16033, 0.22€ bounty)
*** ANTE/BLINDS ***
Tonio 7.0 posts ante 100
mAgA_ posts ante 100
Asticopathe posts ante 100
Tocororo posts ante 100
P1xel7 posts ante 100
marquestaut7 posts ante 100
Tonio 7.0 posts small blind 400
mAgA_ posts big blind 800
Dealt to P1xel7 [7d 8s]
*** PRE-FLOP *** 
Asticopathe folds
Tocororo folds
P1xel7 folds
marquestaut7 folds
Tonio 7.0 calls 400
mAgA_ raises 1600 to 2400
Tonio 7.0 folds
mAgA_ collected 3800 from pot
*** SUMMARY ***
Total pot 3800 | No rake
Seat 6: mAgA_ (big blind) won 3800


Winamax Poker - Tournament "Kill The Fish" buyIn: 0.45€ + 0.05€ level: 9 - HandId: #3040732885884600333-80-1699727972 - Holdem no limit (100/400/800) - 2023/11/11 18:39:32 UTC
Table: 'Kill The Fish(707975795)#012' 6-max (real money) Seat #5 is the button
Seat 1: Asticopathe (14247, 0.33€ bounty)
Seat 2: Tocororo (18025, 0.22€ bounty)
Seat 3: P1xel7 (148725, 0.77€ bounty)
Seat 4: marquestaut7 (22032, 0.33€ bounty)
Seat 5: Tonio 7.0 (55468, 0.33€ bounty)
Seat 6: mAgA_ (17333, 0.22€ bounty)
*** ANTE/BLINDS ***
mAgA_ posts ante 100
Asticopathe posts ante 100
Tocororo posts ante 100
P1xel7 posts ante 100
marquestaut7 posts ante 100
Tonio 7.0 posts ante 100
mAgA_ posts small blind 400
Asticopathe posts big blind 800
Dealt to P1xel7 [6h Ac]
*** PRE-FLOP *** 
Tocororo raises 800 to 1600
P1xel7 folds
marquestaut7 folds
Tonio 7.0 folds
mAgA_ raises 15633 to 17233 and is all-in
Asticopathe folds
Tocororo calls 15633
*** FLOP *** [9c 4c 8d]
*** TURN *** [9c 4c 8d][4s]
*** RIVER *** [9c 4c 8d 4s][Qd]
*** SHOW DOWN ***
Tocororo shows [Kc Qs] (Two pairs : Queens and 4)
mAgA_ shows [9h 9d] (Full of 9 and 4)
mAgA_ collected 35866 from pot
*** SUMMARY ***
Total pot 35866 | No rake
Board: [9c 4c 8d 4s Qd]
Seat 2: Tocororo showed [Kc Qs] and lost with Two pairs : Queens and 4
Seat 6: mAgA_ (small blind) showed [9h 9d] and won 35866 with Full of 9 and 4


Winamax Poker - Tournament "Kill The Fish" buyIn: 0.45€ + 0.05€ level: 9 - HandId: #3040732885884600333-81-1699728020 - Holdem no limit (100/400/800) - 2023/11/11 18:40:20 UTC
Table: 'Kill The Fish(707975795)#012' 6-max (real money) Seat #6 is the button
Seat 1: Asticopathe (13347, 0.33€ bounty)
Seat 2: Tocororo (692, 0.22€ bounty)
Seat 3: P1xel7 (148625, 0.77€ bounty)
Seat 4: marquestaut7 (21932, 0.33€ bounty)
Seat 5: Tonio 7.0 (55368, 0.33€ bounty)
Seat 6: mAgA_ (35866, 0.22€ bounty)
*** ANTE/BLINDS ***
Asticopathe posts ante 100
Tocororo posts ante 100
P1xel7 posts ante 100
marquestaut7 posts ante 100
Tonio 7.0 posts ante 100
mAgA_ posts ante 100
Asticopathe posts small blind 400
Tocororo posts big blind 592 and is all-in
Dealt to P1xel7 [Kh Ts]
*** PRE-FLOP *** 
P1xel7 raises 2608 to 3200
marquestaut7 folds
Tonio 7.0 raises 52068 to 55268 and is all-in
mAgA_ folds
Asticopathe folds
P1xel7 folds
*** FLOP *** [5h 4s Jc]
*** TURN *** [5h 4s Jc][6c]
*** RIVER *** [5h 4s Jc 6c][3h]
*** SHOW DOWN ***
Tocororo shows [Qh Jd] (One pair : Jacks)
Tonio 7.0 shows [Qc As] (High card : Ace)
Tonio 7.0 collected 57284 from side pot 1
Tocororo collected 2776 from main pot
*** SUMMARY ***
Total pot 60060 | No rake
Board: [5h 4s Jc 6c 3h]
Seat 2: Tocororo (big blind) showed [Qh Jd] and won 2776 with One pair : Jacks
Seat 5: Tonio 7.0 showed [Qc As] and won 57284 with High card : Ace


Winamax Poker - Tournament "Kill The Fish" buyIn: 0.45€ + 0.05€ level: 9 - HandId: #3040732885884600333-82-1699728053 - Holdem no limit (100/400/800) - 2023/11/11 18:40:53 UTC
Table: 'Kill The Fish(707975795)#012' 6-max (real money) Seat #1 is the button
Seat 1: Asticopathe (12847, 0.33€ bounty)
Seat 2: Tocororo (2776, 0.22€ bounty)
Seat 3: P1xel7 (145325, 0.77€ bounty)
Seat 4: marquestaut7 (21832, 0.33€ bounty)
Seat 5: Tonio 7.0 (57284, 0.33€ bounty)
Seat 6: mAgA_ (35766, 0.22€ bounty)
*** ANTE/BLINDS ***
Tocororo posts ante 100
P1xel7 posts ante 100
Asticopathe posts ante 100
marquestaut7 posts ante 100
Tonio 7.0 posts ante 100
mAgA_ posts ante 100
Tocororo posts small blind 400
P1xel7 posts big blind 800
Dealt to P1xel7 [Kd Jh]
*** PRE-FLOP *** 
marquestaut7 folds
Tonio 7.0 calls 800
mAgA_ folds
Asticopathe folds
Tocororo raises 1876 to 2676 and is all-in
P1xel7 calls 1876
Tonio 7.0 calls 1876
*** FLOP *** [8h 3h Td]
P1xel7 checks
Tonio 7.0 bets 8628
P1xel7 folds
*** TURN *** [8h 3h Td][5s]
*** RIVER *** [8h 3h Td 5s][8c]
*** SHOW DOWN ***
Tocororo shows [6c Ad] (One pair : 8)
Tonio 7.0 shows [9d 8d] (Trips of 8)
Tonio 7.0 collected 17256 from pot
*** SUMMARY ***
Total pot 17256 | No rake
Board: [8h 3h Td 5s 8c]
Seat 2: Tocororo (small blind) showed [6c Ad] and lost with One pair : 8
Seat 5: Tonio 7.0 showed [9d 8d] and won 17256 with Trips of 8


Winamax Poker - Tournament "Kill The Fish" buyIn: 0.45€ + 0.05€ level: 10 - HandId: #3040732885884600333-83-1699728090 - Holdem no limit (120/500/1000) - 2023/11/11 18:41:30 UTC
Table: 'Kill The Fish(707975795)#012' 6-max (real money) Seat #2 is the button
Seat 1: Asticopathe (12747, 0.33€ bounty)
Seat 3: P1xel7 (142549, 0.77€ bounty)
Seat 4: marquestaut7 (21732, 0.33€ bounty)
Seat 5: Tonio 7.0 (63136, 0.44€ bounty)
Seat 6: mAgA_ (35666, 0.22€ bounty)
*** ANTE/BLINDS ***
P1xel7 posts ante 120
marquestaut7 posts ante 120
Asticopathe posts ante 120
Tonio 7.0 posts ante 120
mAgA_ posts ante 120
P1xel7 posts small blind 500
marquestaut7 posts big blind 1000
Dealt to P1xel7 [As 6h]
*** PRE-FLOP *** 
Tonio 7.0 raises 62016 to 63016 and is all-in
mAgA_ folds
Asticopathe folds
P1xel7 folds
marquestaut7 folds
Tonio 7.0 collected 65116 from pot
*** SUMMARY ***
Total pot 65116 | No rake
Seat 5: Tonio 7.0 won 65116


Winamax Poker - Tournament "Kill The Fish" buyIn: 0.45€ + 0.05€ level: 10 - HandId: #3040732885884600333-84-1699728110 - Holdem no limit (120/500/1000) - 2023/11/11 18:41:50 UTC
Table: 'Kill The Fish(707975795)#012' 6-max (real money) Seat #3 is the button
Seat 1: Asticopathe (12627, 0.33€ bounty)
Seat 3: P1xel7 (141929, 0.77€ bounty)
Seat 4: marquestaut7 (20612, 0.33€ bounty)
Seat 5: Tonio 7.0 (65116, 0.44€ bounty)
Seat 6: mAgA_ (35546, 0.22€ bounty)
*** ANTE/BLINDS ***
marquestaut7 posts ante 120
Tonio 7.0 posts ante 120
Asticopathe posts ante 120
P1xel7 posts ante 120
mAgA_ posts ante 120
marquestaut7 posts small blind 500
Tonio 7.0 posts big blind 1000
Dealt to P1xel7 [Kd Js]
*** PRE-FLOP *** 
mAgA_ folds
Asticopathe folds
P1xel7 raises 1500 to 2500
marquestaut7 folds
Tonio 7.0 folds
P1xel7 collected 4600 from pot
*** SUMMARY ***
Total pot 4600 | No rake
Seat 3: P1xel7 (button) won 4600


Winamax Poker - Tournament "Kill The Fish" buyIn: 0.45€ + 0.05€ level: 10 - HandId: #3040732885884600333-85-1699728141 - Holdem no limit (120/500/1000) - 2023/11/11 18:42:21 UTC
Table: 'Kill The Fish(707975795)#012' 6-max (real money) Seat #4 is the button
Seat 1: Asticopathe (12507, 0.33€ bounty)
Seat 3: P1xel7 (143909, 0.77€ bounty)
Seat 4: marquestaut7 (19992, 0.33€ bounty)
Seat 5: Tonio 7.0 (63996, 0.44€ bounty)
Seat 6: mAgA_ (35426, 0.22€ bounty)
*** ANTE/BLINDS ***
Tonio 7.0 posts ante 120
mAgA_ posts ante 120
Asticopathe posts ante 120
P1xel7 posts ante 120
marquestaut7 posts ante 120
Tonio 7.0 posts small blind 500
mAgA_ posts big blind 1000
Dealt to P1xel7 [As 2s]
*** PRE-FLOP *** 
Asticopathe raises 11387 to 12387 and is all-in
P1xel7 calls 12387
marquestaut7 folds
Tonio 7.0 folds
mAgA_ folds
*** FLOP *** [5c 5h 9s]
*** TURN *** [5c 5h 9s][3c]
*** RIVER *** [5c 5h 9s 3c][Qs]
*** SHOW DOWN ***
P1xel7 shows [As 2s] (One pair : 5)
Asticopathe shows [Qc Jh] (Two pairs : Queens and 5)
Asticopathe collected 26874 from pot
*** SUMMARY ***
Total pot 26874 | No rake
Board: [5c 5h 9s 3c Qs]
Seat 1: Asticopathe showed [Qc Jh] and won 26874 with Two pairs : Queens and 5
Seat 3: P1xel7 showed [As 2s] and lost with One pair : 5


Winamax Poker - Tournament "Kill The Fish" buyIn: 0.45€ + 0.05€ level: 10 - HandId: #3040732885884600333-86-1699728181 - Holdem no limit (120/500/1000) - 2023/11/11 18:43:01 UTC
Table: 'Kill The Fish(707975795)#012' 6-max (real money) Seat #5 is the button
Seat 1: Asticopathe (26874, 0.33€ bounty)
Seat 3: P1xel7 (131402, 0.77€ bounty)
Seat 4: marquestaut7 (19872, 0.33€ bounty)
Seat 5: Tonio 7.0 (63376, 0.44€ bounty)
Seat 6: mAgA_ (34306, 0.22€ bounty)
*** ANTE/BLINDS ***
mAgA_ posts ante 120
Asticopathe posts ante 120
P1xel7 posts ante 120
marquestaut7 posts ante 120
Tonio 7.0 posts ante 120
mAgA_ posts small blind 500
Asticopathe posts big blind 1000
Dealt to P1xel7 [2h 2c]
*** PRE-FLOP *** 
P1xel7 raises 1200 to 2200
marquestaut7 folds
Tonio 7.0 calls 2200
mAgA_ folds
Asticopathe calls 1200
*** FLOP *** [Qc Kh As]
Asticopathe checks
P1xel7 checks
Tonio 7.0 checks
*** TURN *** [Qc Kh As][3h]
Asticopathe checks
P1xel7 checks
Tonio 7.0 bets 2695
Asticopathe calls 2695
P1xel7 calls 2695
*** RIVER *** [Qc Kh As 3h][Tc]
Asticopathe checks
P1xel7 checks
Tonio 7.0 bets 58361 and is all-in
Asticopathe folds
P1xel7 folds
Tonio 7.0 shows [Jc 7c] (Straight Ace high)
Tonio 7.0 collected 74146 from pot
*** SUMMARY ***
Total pot 74146 | No rake
Board: [Qc Kh As 3h Tc]
Seat 5: Tonio 7.0 (button) showed [Jc 7c] and won 74146 with Straight Ace high


Winamax Poker - Tournament "Kill The Fish" buyIn: 0.45€ + 0.05€ level: 10 - HandId: #3040732885884600333-87-1699728264 - Holdem no limit (120/500/1000) - 2023/11/11 18:44:24 UTC
Table: 'Kill The Fish(707975795)#012' 6-max (real money) Seat #6 is the button
Seat 1: Asticopathe (21859, 0.33€ bounty)
Seat 2: jadou74 (20000, 0.22€ bounty)
Seat 3: P1xel7 (126387, 0.77€ bounty)
Seat 4: marquestaut7 (19752, 0.33€ bounty)
Seat 5: Tonio 7.0 (74146, 0.44€ bounty)
Seat 6: mAgA_ (33686, 0.22€ bounty)
*** ANTE/BLINDS ***
Asticopathe posts ante 120
jadou74 posts ante 120
P1xel7 posts ante 120
marquestaut7 posts ante 120
Tonio 7.0 posts ante 120
mAgA_ posts ante 120
Asticopathe posts small blind 500
jadou74 posts big blind 1000
Dealt to P1xel7 [Ts Js]
*** PRE-FLOP *** 
P1xel7 raises 1200 to 2200
marquestaut7 folds
Tonio 7.0 folds
mAgA_ folds
Asticopathe folds
jadou74 calls 1200
*** FLOP *** [7h Ad 7c]
jadou74 checks
P1xel7 bets 1405
jadou74 raises 16275 to 17680 and is all-in
P1xel7 folds
jadou74 collected 24705 from pot
*** SUMMARY ***
Total pot 24705 | No rake
Board: [7h Ad 7c]
Seat 2: jadou74 (big blind) won 24705


Winamax Poker - Tournament "Kill The Fish" buyIn: 0.45€ + 0.05€ level: 10 - HandId: #3040732885884600333-88-1699728334 - Holdem no limit (120/500/1000) - 2023/11/11 18:45:34 UTC
Table: 'Kill The Fish(707975795)#012' 6-max (real money) Seat #1 is the button
Seat 1: Asticopathe (21239, 0.33€ bounty)
Seat 2: jadou74 (24705, 0.22€ bounty)
Seat 3: P1xel7 (122662, 0.77€ bounty)
Seat 4: marquestaut7 (19632, 0.33€ bounty)
Seat 5: Tonio 7.0 (74026, 0.44€ bounty)
Seat 6: mAgA_ (33566, 0.22€ bounty)
*** ANTE/BLINDS ***
jadou74 posts ante 120
P1xel7 posts ante 120
Asticopathe posts ante 120
marquestaut7 posts ante 120
Tonio 7.0 posts ante 120
mAgA_ posts ante 120
jadou74 posts small blind 500
P1xel7 posts big blind 1000
Dealt to P1xel7 [8h 9s]
*** PRE-FLOP *** 
marquestaut7 folds
Tonio 7.0 calls 1000
mAgA_ folds
Asticopathe calls 1000
jadou74 folds
P1xel7 checks
*** FLOP *** [Ac 8s 6h]
P1xel7 bets 1477
Tonio 7.0 calls 1477
Asticopathe raises 2977 to 4454
P1xel7 folds
Tonio 7.0 folds
Asticopathe collected 11628 from pot
*** SUMMARY ***
Total pot 11628 | No rake
Board: [Ac 8s 6h]
Seat 1: Asticopathe (button) won 11628


Winamax Poker - Tournament "Kill The Fish" buyIn: 0.45€ + 0.05€ level: 11 - HandId: #3040732885884600333-89-1699728425 - Holdem no limit (140/600/1200) - 2023/11/11 18:47:05 UTC
Table: 'Kill The Fish(707975795)#012' 6-max (real money) Seat #2 is the button
Seat 1: Asticopathe (27293, 0.33€ bounty)
Seat 2: jadou74 (24085, 0.22€ bounty)
Seat 3: P1xel7 (120065, 0.77€ bounty)
Seat 4: marquestaut7 (19512, 0.33€ bounty)
Seat 5: Tonio 7.0 (71429, 0.44€ bounty)
Seat 6: mAgA_ (33446, 0.22€ bounty)
*** ANTE/BLINDS ***
P1xel7 posts ante 140
marquestaut7 posts ante 140
Asticopathe posts ante 140
jadou74 posts ante 140
Tonio 7.0 posts ante 140
mAgA_ posts ante 140
P1xel7 posts small blind 600
marquestaut7 posts big blind 1200
Dealt to P1xel7 [Qh Ad]
*** PRE-FLOP *** 
Tonio 7.0 folds
mAgA_ folds
Asticopathe calls 1200
jadou74 folds
P1xel7 raises 2400 to 3600
marquestaut7 folds
Asticopathe calls 2400
*** FLOP *** [6h 8s 2h]
P1xel7 bets 6006
Asticopathe raises 6006 to 12012
P1xel7 raises 104313 to 116325 and is all-in
Asticopathe calls 11541 and is all-in
*** TURN *** [6h 8s 2h][7d]
*** RIVER *** [6h 8s 2h 7d][Td]
*** SHOW DOWN ***
Asticopathe shows [Th 8h] (Two pairs : Tens and 8)
P1xel7 shows [Qh Ad] (High card : Ace)
P1xel7 collected 92772 from side pot 1
Asticopathe collected 56346 from main pot
*** SUMMARY ***
Total pot 149118 | No rake
Board: [6h 8s 2h 7d Td]
Seat 1: Asticopathe showed [Th 8h] and won 56346 with Two pairs : Tens and 8
Seat 3: P1xel7 (small blind) showed [Qh Ad] and won 92772 with High card : Ace


Winamax Poker - Tournament "Kill The Fish" buyIn: 0.45€ + 0.05€ level: 11 - HandId: #3040732885884600333-90-1699728496 - Holdem no limit (140/600/1200) - 2023/11/11 18:48:16 UTC
Table: 'Kill The Fish(707975795)#012' 6-max (real money) Seat #3 is the button
Seat 1: Asticopathe (56346, 0.33€ bounty)
Seat 2: jadou74 (23945, 0.22€ bounty)
Seat 3: P1xel7 (92772, 0.77€ bounty)
Seat 4: marquestaut7 (18172, 0.33€ bounty)
Seat 5: Tonio 7.0 (71289, 0.44€ bounty)
Seat 6: mAgA_ (33306, 0.22€ bounty)
*** ANTE/BLINDS ***
marquestaut7 posts ante 140
Tonio 7.0 posts ante 140
Asticopathe posts ante 140
jadou74 posts ante 140
P1xel7 posts ante 140
mAgA_ posts ante 140
marquestaut7 posts small blind 600
Tonio 7.0 posts big blind 1200
Dealt to P1xel7 [5s 8s]
*** PRE-FLOP *** 
mAgA_ folds
Asticopathe folds
jadou74 calls 1200
P1xel7 folds
marquestaut7 folds
Tonio 7.0 raises 69949 to 71149 and is all-in
jadou74 folds
Tonio 7.0 collected 73789 from pot
*** SUMMARY ***
Total pot 73789 | No rake
Seat 5: Tonio 7.0 (big blind) won 73789


Winamax Poker - Tournament "Kill The Fish" buyIn: 0.45€ + 0.05€ level: 11 - HandId: #3040732885884600333-91-1699728520 - Holdem no limit (140/600/1200) - 2023/11/11 18:48:40 UTC
Table: 'Kill The Fish(707975795)#012' 6-max (real money) Seat #4 is the button
Seat 1: Asticopathe (56206, 0.33€ bounty)
Seat 2: jadou74 (22605, 0.22€ bounty)
Seat 3: P1xel7 (92632, 0.77€ bounty)
Seat 4: marquestaut7 (17432, 0.33€ bounty)
Seat 5: Tonio 7.0 (73789, 0.44€ bounty)
Seat 6: mAgA_ (33166, 0.22€ bounty)
*** ANTE/BLINDS ***
Tonio 7.0 posts ante 140
mAgA_ posts ante 140
Asticopathe posts ante 140
jadou74 posts ante 140
P1xel7 posts ante 140
marquestaut7 posts ante 140
Tonio 7.0 posts small blind 600
mAgA_ posts big blind 1200
Dealt to P1xel7 [6s Th]
*** PRE-FLOP *** 
Asticopathe folds
jadou74 raises 21265 to 22465 and is all-in
P1xel7 folds
marquestaut7 folds
Tonio 7.0 folds
mAgA_ folds
jadou74 collected 25105 from pot
*** SUMMARY ***
Total pot 25105 | No rake
Seat 2: jadou74 won 25105


Winamax Poker - Tournament "Kill The Fish" buyIn: 0.45€ + 0.05€ level: 11 - HandId: #3040732885884600333-92-1699728557 - Holdem no limit (140/600/1200) - 2023/11/11 18:49:17 UTC
Table: 'Kill The Fish(707975795)#012' 6-max (real money) Seat #5 is the button
Seat 1: Asticopathe (56066, 0.33€ bounty)
Seat 2: jadou74 (25105, 0.22€ bounty)
Seat 3: P1xel7 (92492, 0.77€ bounty)
Seat 4: marquestaut7 (17292, 0.33€ bounty)
Seat 5: Tonio 7.0 (73049, 0.44€ bounty)
Seat 6: mAgA_ (31826, 0.22€ bounty)
*** ANTE/BLINDS ***
mAgA_ posts ante 140
Asticopathe posts ante 140
jadou74 posts ante 140
P1xel7 posts ante 140
marquestaut7 posts ante 140
Tonio 7.0 posts ante 140
mAgA_ posts small blind 600
Asticopathe posts big blind 1200
Dealt to P1xel7 [6c 5c]
*** PRE-FLOP *** 
jadou74 folds
P1xel7 calls 1200
marquestaut7 folds
Tonio 7.0 calls 1200
mAgA_ calls 600
Asticopathe checks
*** FLOP *** [2d Qc Qs]
mAgA_ checks
Asticopathe bets 1974
P1xel7 folds
Tonio 7.0 calls 1974
mAgA_ raises 28512 to 30486 and is all-in
Asticopathe folds
Tonio 7.0 calls 28512
*** TURN *** [2d Qc Qs][7h]
*** RIVER *** [2d Qc Qs 7h][Js]
*** SHOW DOWN ***
Tonio 7.0 shows [Qd 5d] (Trips of Queens)
mAgA_ shows [Qh 4h] (Trips of Queens)
mAgA_ collected 34293 from pot
Tonio 7.0 collected 34293 from pot
*** SUMMARY ***
Total pot 68586 | No rake
Board: [2d Qc Qs 7h Js]
Seat 5: Tonio 7.0 (button) showed [Qd 5d] and won 34293 with Trips of Queens
Seat 6: mAgA_ (small blind) showed [Qh 4h] and won 34293 with Trips of Queens


Winamax Poker - Tournament "Kill The Fish" buyIn: 0.45€ + 0.05€ level: 11 - HandId: #3040732885884600333-93-1699728635 - Holdem no limit (140/600/1200) - 2023/11/11 18:50:35 UTC
Table: 'Kill The Fish(707975795)#012' 6-max (real money) Seat #6 is the button
Seat 1: Asticopathe (52752, 0.33€ bounty)
Seat 2: jadou74 (24965, 0.22€ bounty)
Seat 3: P1xel7 (91152, 0.77€ bounty)
Seat 4: marquestaut7 (17152, 0.33€ bounty)
Seat 5: Tonio 7.0 (75516, 0.44€ bounty)
Seat 6: mAgA_ (34293, 0.22€ bounty)
*** ANTE/BLINDS ***
Asticopathe posts ante 140
jadou74 posts ante 140
P1xel7 posts ante 140
marquestaut7 posts ante 140
Tonio 7.0 posts ante 140
mAgA_ posts ante 140
Asticopathe posts small blind 600
jadou74 posts big blind 1200
Dealt to P1xel7 [Js Qc]
*** PRE-FLOP *** 
P1xel7 folds
marquestaut7 folds
Tonio 7.0 folds
mAgA_ raises 1200 to 2400
Asticopathe folds
jadou74 calls 1200
*** FLOP *** [Ts 6d 4s]
jadou74 checks
mAgA_ bets 3120
jadou74 folds
mAgA_ collected 9360 from pot
*** SUMMARY ***
Total pot 9360 | No rake
Board: [Ts 6d 4s]
Seat 6: mAgA_ (button) won 9360


Winamax Poker - Tournament "Kill The Fish" buyIn: 0.45€ + 0.05€ level: 12 - HandId: #3040732885884600333-94-1699728701 - Holdem no limit (160/700/1400) - 2023/11/11 18:51:41 UTC
Table: 'Kill The Fish(707975795)#012' 6-max (real money) Seat #1 is the button
Seat 1: Asticopathe (52012, 0.33€ bounty)
Seat 2: jadou74 (22425, 0.22€ bounty)
Seat 3: P1xel7 (91012, 0.77€ bounty)
Seat 4: marquestaut7 (17012, 0.33€ bounty)
Seat 5: Tonio 7.0 (75376, 0.44€ bounty)
Seat 6: mAgA_ (37993, 0.22€ bounty)
*** ANTE/BLINDS ***
jadou74 posts ante 160
P1xel7 posts ante 160
Asticopathe posts ante 160
marquestaut7 posts ante 160
Tonio 7.0 posts ante 160
mAgA_ posts ante 160
jadou74 posts small blind 700
P1xel7 posts big blind 1400
Dealt to P1xel7 [8d 7s]
*** PRE-FLOP *** 
marquestaut7 folds
Tonio 7.0 raises 73816 to 75216 and is all-in
mAgA_ folds
Asticopathe folds
jadou74 folds
P1xel7 folds
Tonio 7.0 collected 78276 from pot
*** SUMMARY ***
Total pot 78276 | No rake
Seat 5: Tonio 7.0 won 78276


Winamax Poker - Tournament "Kill The Fish" buyIn: 0.45€ + 0.05€ level: 12 - HandId: #3040732885884600333-95-1699728751 - Holdem no limit (160/700/1400) - 2023/11/11 18:52:31 UTC
Table: 'Kill The Fish(707975795)#012' 6-max (real money) Seat #2 is the button
Seat 1: Asticopathe (51852, 0.33€ bounty)
Seat 2: jadou74 (21565, 0.22€ bounty)
Seat 3: P1xel7 (89452, 0.77€ bounty)
Seat 4: marquestaut7 (16852, 0.33€ bounty)
Seat 5: Tonio 7.0 (78276, 0.44€ bounty)
Seat 6: mAgA_ (37833, 0.22€ bounty)
*** ANTE/BLINDS ***
P1xel7 posts ante 160
marquestaut7 posts ante 160
Asticopathe posts ante 160
jadou74 posts ante 160
Tonio 7.0 posts ante 160
mAgA_ posts ante 160
P1xel7 posts small blind 700
marquestaut7 posts big blind 1400
Dealt to P1xel7 [9d 6c]
*** PRE-FLOP *** 
Tonio 7.0 raises 76716 to 78116 and is all-in
mAgA_ folds
Asticopathe folds
jadou74 folds
P1xel7 folds
marquestaut7 folds
Tonio 7.0 collected 81176 from pot
*** SUMMARY ***
Total pot 81176 | No rake
Seat 5: Tonio 7.0 won 81176


Winamax Poker - Tournament "Kill The Fish" buyIn: 0.45€ + 0.05€ level: 12 - HandId: #3040732885884600333-96-1699728778 - Holdem no limit (160/700/1400) - 2023/11/11 18:52:58 UTC
Table: 'Kill The Fish(707975795)#012' 6-max (real money) Seat #3 is the button
Seat 1: Asticopathe (51692, 0.33€ bounty)
Seat 2: jadou74 (21405, 0.22€ bounty)
Seat 3: P1xel7 (88592, 0.77€ bounty)
Seat 4: marquestaut7 (15292, 0.33€ bounty)
Seat 5: Tonio 7.0 (81176, 0.44€ bounty)
Seat 6: mAgA_ (37673, 0.22€ bounty)
*** ANTE/BLINDS ***
marquestaut7 posts ante 160
Tonio 7.0 posts ante 160
Asticopathe posts ante 160
jadou74 posts ante 160
P1xel7 posts ante 160
mAgA_ posts ante 160
marquestaut7 posts small blind 700
Tonio 7.0 posts big blind 1400
Dealt to P1xel7 [Tc Kh]
*** PRE-FLOP *** 
mAgA_ folds
Asticopathe folds
jadou74 raises 19845 to 21245 and is all-in
P1xel7 calls 21245
marquestaut7 folds
Tonio 7.0 folds
*** FLOP *** [6c 2c Ac]
*** TURN *** [6c 2c Ac][Qh]
*** RIVER *** [6c 2c Ac Qh][6d]
*** SHOW DOWN ***
P1xel7 shows [Tc Kh] (One pair : 6)
jadou74 shows [8s 8h] (Two pairs : 8 and 6)
jadou74 collected 45550 from pot
*** SUMMARY ***
Total pot 45550 | No rake
Board: [6c 2c Ac Qh 6d]
Seat 2: jadou74 showed [8s 8h] and won 45550 with Two pairs : 8 and 6
Seat 3: P1xel7 (button) showed [Tc Kh] and lost with One pair : 6


Winamax Poker - Tournament "Kill The Fish" buyIn: 0.45€ + 0.05€ level: 12 - HandId: #3040732885884600333-97-1699728814 - Holdem no limit (160/700/1400) - 2023/11/11 18:53:34 UTC
Table: 'Kill The Fish(707975795)#012' 6-max (real money) Seat #4 is the button
Seat 1: Asticopathe (51532, 0.33€ bounty)
Seat 2: jadou74 (45550, 0.22€ bounty)
Seat 3: P1xel7 (67187, 0.77€ bounty)
Seat 4: marquestaut7 (14432, 0.33€ bounty)
Seat 5: Tonio 7.0 (79616, 0.44€ bounty)
Seat 6: mAgA_ (37513, 0.22€ bounty)
*** ANTE/BLINDS ***
Tonio 7.0 posts ante 160
mAgA_ posts ante 160
Asticopathe posts ante 160
jadou74 posts ante 160
P1xel7 posts ante 160
marquestaut7 posts ante 160
Tonio 7.0 posts small blind 700
mAgA_ posts big blind 1400
Dealt to P1xel7 [8h 4h]
*** PRE-FLOP *** 
Asticopathe folds
jadou74 folds
P1xel7 folds
marquestaut7 folds
Tonio 7.0 calls 700
mAgA_ checks
*** FLOP *** [Td 7s Tc]
Tonio 7.0 checks
mAgA_ bets 1400
Tonio 7.0 calls 1400
*** TURN *** [Td 7s Tc][5h]
Tonio 7.0 checks
mAgA_ bets 1400
Tonio 7.0 calls 1400
*** RIVER *** [Td 7s Tc 5h][Qd]
Tonio 7.0 bets 6084
mAgA_ calls 6084
*** SHOW DOWN ***
Tonio 7.0 shows [6d 8c] (One pair : Tens)
mAgA_ shows [7d 4c] (Two pairs : Tens and 7)
mAgA_ collected 21528 from pot
*** SUMMARY ***
Total pot 21528 | No rake
Board: [Td 7s Tc 5h Qd]
Seat 5: Tonio 7.0 (small blind) showed [6d 8c] and lost with One pair : Tens
Seat 6: mAgA_ (big blind) showed [7d 4c] and won 21528 with Two pairs : Tens and 7


Winamax Poker - Tournament "Kill The Fish" buyIn: 0.45€ + 0.05€ level: 12 - HandId: #3040732885884600333-98-1699728864 - Holdem no limit (160/700/1400) - 2023/11/11 18:54:24 UTC
Table: 'Kill The Fish(707975795)#012' 6-max (real money) Seat #5 is the button
Seat 1: Asticopathe (51372, 0.33€ bounty)
Seat 2: jadou74 (45390, 0.22€ bounty)
Seat 3: P1xel7 (67027, 0.77€ bounty)
Seat 4: marquestaut7 (14272, 0.33€ bounty)
Seat 5: Tonio 7.0 (69172, 0.44€ bounty)
Seat 6: mAgA_ (48597, 0.22€ bounty)
*** ANTE/BLINDS ***
mAgA_ posts ante 160
Asticopathe posts ante 160
jadou74 posts ante 160
P1xel7 posts ante 160
marquestaut7 posts ante 160
Tonio 7.0 posts ante 160
mAgA_ posts small blind 700
Asticopathe posts big blind 1400
Dealt to P1xel7 [Ks Kc]
*** PRE-FLOP *** 
jadou74 folds
P1xel7 raises 2100 to 3500
marquestaut7 folds
Tonio 7.0 calls 3500
mAgA_ folds
Asticopathe calls 2100
*** FLOP *** [8s 2s 6s]
Asticopathe checks
P1xel7 bets 6080
Tonio 7.0 folds
Asticopathe folds
P1xel7 collected 18240 from pot
*** SUMMARY ***
Total pot 18240 | No rake
Board: [8s 2s 6s]
Seat 3: P1xel7 won 18240


Winamax Poker - Tournament "Kill The Fish" buyIn: 0.45€ + 0.05€ level: 12 - HandId: #3040732885884600333-99-1699729261 - Holdem no limit (160/700/1400) - 2023/11/11 19:01:01 UTC
Table: 'Kill The Fish(707975795)#012' 6-max (real money) Seat #6 is the button
Seat 1: Asticopathe (47712, 0.33€ bounty)
Seat 2: jadou74 (45230, 0.22€ bounty)
Seat 3: P1xel7 (75527, 0.77€ bounty)
Seat 4: marquestaut7 (14112, 0.33€ bounty)
Seat 5: Tonio 7.0 (65512, 0.44€ bounty)
Seat 6: mAgA_ (47737, 0.22€ bounty)
*** ANTE/BLINDS ***
Asticopathe posts ante 160
jadou74 posts ante 160
P1xel7 posts ante 160
marquestaut7 posts ante 160
Tonio 7.0 posts ante 160
mAgA_ posts ante 160
Asticopathe posts small blind 700
jadou74 posts big blind 1400
Dealt to P1xel7 [6h 3s]
*** PRE-FLOP *** 
P1xel7 folds
marquestaut7 folds
Tonio 7.0 folds
mAgA_ folds
Asticopathe calls 700
jadou74 checks
*** FLOP *** [8c Tc As]
Asticopathe checks
jadou74 checks
*** TURN *** [8c Tc As][4d]
Asticopathe checks
jadou74 checks
*** RIVER *** [8c Tc As 4d][8d]
Asticopathe checks
jadou74 checks
*** SHOW DOWN ***
Asticopathe shows [5h Jc] (One pair : 8)
jadou74 shows [4h 7h] (Two pairs : 8 and 4)
jadou74 collected 3760 from pot
*** SUMMARY ***
Total pot 3760 | No rake
Board: [8c Tc As 4d 8d]
Seat 1: Asticopathe (small blind) showed [5h Jc] and lost with One pair : 8
Seat 2: jadou74 (big blind) showed [4h 7h] and won 3760 with Two pairs : 8 and 4


Winamax Poker - Tournament "Kill The Fish" buyIn: 0.45€ + 0.05€ level: 13 - HandId: #3040732885884600333-100-1699729340 - Holdem no limit (200/800/1600) - 2023/11/11 19:02:20 UTC
Table: 'Kill The Fish(707975795)#012' 6-max (real money) Seat #1 is the button
Seat 1: Asticopathe (46152, 0.33€ bounty)
Seat 2: jadou74 (47430, 0.22€ bounty)
Seat 3: P1xel7 (75367, 0.77€ bounty)
Seat 4: marquestaut7 (13952, 0.33€ bounty)
Seat 5: Tonio 7.0 (65352, 0.44€ bounty)
Seat 6: mAgA_ (47577, 0.22€ bounty)
*** ANTE/BLINDS ***
jadou74 posts ante 200
P1xel7 posts ante 200
Asticopathe posts ante 200
marquestaut7 posts ante 200
Tonio 7.0 posts ante 200
mAgA_ posts ante 200
jadou74 posts small blind 800
P1xel7 posts big blind 1600
Dealt to P1xel7 [3c 2s]
*** PRE-FLOP *** 
marquestaut7 folds
Tonio 7.0 calls 1600
mAgA_ folds
Asticopathe folds
jadou74 calls 800
P1xel7 checks
*** FLOP *** [As 9s Kd]
jadou74 checks
P1xel7 checks
Tonio 7.0 bets 3900
jadou74 folds
P1xel7 folds
Tonio 7.0 collected 9900 from pot
*** SUMMARY ***
Total pot 9900 | No rake
Board: [As 9s Kd]
Seat 5: Tonio 7.0 won 9900


Winamax Poker - Tournament "Kill The Fish" buyIn: 0.45€ + 0.05€ level: 13 - HandId: #3040732885884600333-101-1699729398 - Holdem no limit (200/800/1600) - 2023/11/11 19:03:18 UTC
Table: 'Kill The Fish(707975795)#012' 6-max (real money) Seat #2 is the button
Seat 1: Asticopathe (45952, 0.33€ bounty)
Seat 2: jadou74 (45630, 0.22€ bounty)
Seat 3: P1xel7 (73567, 0.77€ bounty)
Seat 4: marquestaut7 (13752, 0.33€ bounty)
Seat 5: Tonio 7.0 (69552, 0.44€ bounty)
Seat 6: mAgA_ (47377, 0.22€ bounty)
*** ANTE/BLINDS ***
P1xel7 posts ante 200
marquestaut7 posts ante 200
Asticopathe posts ante 200
jadou74 posts ante 200
Tonio 7.0 posts ante 200
mAgA_ posts ante 200
P1xel7 posts small blind 800
marquestaut7 posts big blind 1600
Dealt to P1xel7 [4s 7d]
*** PRE-FLOP *** 
Tonio 7.0 calls 1600
mAgA_ calls 1600
Asticopathe folds
jadou74 folds
P1xel7 folds
marquestaut7 folds
*** FLOP *** [Kh 5c 6d]
Tonio 7.0 checks
mAgA_ checks
*** TURN *** [Kh 5c 6d][4c]
Tonio 7.0 bets 4420
mAgA_ folds
Tonio 7.0 collected 11220 from pot
*** SUMMARY ***
Total pot 11220 | No rake
Board: [Kh 5c 6d 4c]
Seat 5: Tonio 7.0 won 11220


Winamax Poker - Tournament "Kill The Fish" buyIn: 0.45€ + 0.05€ level: 13 - HandId: #3040732885884600333-102-1699729452 - Holdem no limit (200/800/1600) - 2023/11/11 19:04:12 UTC
Table: 'Kill The Fish(707975795)#012' 6-max (real money) Seat #3 is the button
Seat 1: Asticopathe (45752, 0.33€ bounty)
Seat 2: jadou74 (45430, 0.22€ bounty)
Seat 3: P1xel7 (72567, 0.77€ bounty)
Seat 4: marquestaut7 (11952, 0.33€ bounty)
Seat 5: Tonio 7.0 (74552, 0.44€ bounty)
Seat 6: mAgA_ (45577, 0.22€ bounty)
*** ANTE/BLINDS ***
marquestaut7 posts ante 200
Tonio 7.0 posts ante 200
Asticopathe posts ante 200
jadou74 posts ante 200
P1xel7 posts ante 200
mAgA_ posts ante 200
marquestaut7 posts small blind 800
Tonio 7.0 posts big blind 1600
Dealt to P1xel7 [Ts 6c]
*** PRE-FLOP *** 
mAgA_ folds
Asticopathe raises 2400 to 4000
jadou74 folds
P1xel7 folds
marquestaut7 folds
Tonio 7.0 folds
Asticopathe collected 7600 from pot
*** SUMMARY ***
Total pot 7600 | No rake
Seat 1: Asticopathe won 7600


Winamax Poker - Tournament "Kill The Fish" buyIn: 0.45€ + 0.05€ level: 13 - HandId: #3040732885884600333-103-1699729484 - Holdem no limit (200/800/1600) - 2023/11/11 19:04:44 UTC
Table: 'Kill The Fish(707975795)#012' 6-max (real money) Seat #4 is the button
Seat 1: Asticopathe (49152, 0.33€ bounty)
Seat 2: jadou74 (45230, 0.22€ bounty)
Seat 3: P1xel7 (72367, 0.77€ bounty)
Seat 4: marquestaut7 (10952, 0.33€ bounty)
Seat 5: Tonio 7.0 (72752, 0.44€ bounty)
Seat 6: mAgA_ (45377, 0.22€ bounty)
*** ANTE/BLINDS ***
Tonio 7.0 posts ante 200
mAgA_ posts ante 200
Asticopathe posts ante 200
jadou74 posts ante 200
P1xel7 posts ante 200
marquestaut7 posts ante 200
Tonio 7.0 posts small blind 800
mAgA_ posts big blind 1600
Dealt to P1xel7 [9h 6c]
*** PRE-FLOP *** 
Asticopathe folds
jadou74 folds
P1xel7 folds
marquestaut7 folds
Tonio 7.0 raises 4400 to 6000
mAgA_ folds
Tonio 7.0 collected 8800 from pot
*** SUMMARY ***
Total pot 8800 | No rake
Seat 5: Tonio 7.0 (small blind) won 8800


Winamax Poker - Tournament "Kill The Fish" buyIn: 0.45€ + 0.05€ level: 13 - HandId: #3040732885884600333-104-1699729512 - Holdem no limit (200/800/1600) - 2023/11/11 19:05:12 UTC
Table: 'Kill The Fish(707975795)#012' 6-max (real money) Seat #5 is the button
Seat 1: Asticopathe (48952, 0.33€ bounty)
Seat 2: jadou74 (45030, 0.22€ bounty)
Seat 3: P1xel7 (72167, 0.77€ bounty)
Seat 4: marquestaut7 (10752, 0.33€ bounty)
Seat 5: Tonio 7.0 (75352, 0.44€ bounty)
Seat 6: mAgA_ (43577, 0.22€ bounty)
*** ANTE/BLINDS ***
mAgA_ posts ante 200
Asticopathe posts ante 200
jadou74 posts ante 200
P1xel7 posts ante 200
marquestaut7 posts ante 200
Tonio 7.0 posts ante 200
mAgA_ posts small blind 800
Asticopathe posts big blind 1600
Dealt to P1xel7 [6s Kc]
*** PRE-FLOP *** 
jadou74 calls 1600
P1xel7 folds
marquestaut7 folds
Tonio 7.0 folds
mAgA_ raises 1600 to 3200
Asticopathe calls 1600
jadou74 calls 1600
*** FLOP *** [2s 3s Kh]
mAgA_ checks
Asticopathe checks
jadou74 checks
*** TURN *** [2s 3s Kh][3h]
mAgA_ checks
Asticopathe bets 5600
jadou74 folds
mAgA_ folds
Asticopathe collected 16400 from pot
*** SUMMARY ***
Total pot 16400 | No rake
Board: [2s 3s Kh 3h]
Seat 1: Asticopathe (big blind) won 16400


Winamax Poker - Tournament "Kill The Fish" buyIn: 0.45€ + 0.05€ level: 13 - HandId: #3040732885884600333-105-1699729611 - Holdem no limit (200/800/1600) - 2023/11/11 19:06:51 UTC
Table: 'Kill The Fish(707975795)#012' 6-max (real money) Seat #6 is the button
Seat 1: Asticopathe (56352, 0.33€ bounty)
Seat 2: jadou74 (41630, 0.22€ bounty)
Seat 3: P1xel7 (71967, 0.77€ bounty)
Seat 4: marquestaut7 (10552, 0.33€ bounty)
Seat 5: Tonio 7.0 (75152, 0.44€ bounty)
Seat 6: mAgA_ (40177, 0.22€ bounty)
*** ANTE/BLINDS ***
Asticopathe posts ante 200
jadou74 posts ante 200
P1xel7 posts ante 200
marquestaut7 posts ante 200
Tonio 7.0 posts ante 200
mAgA_ posts ante 200
Asticopathe posts small blind 800
jadou74 posts big blind 1600
Dealt to P1xel7 [Kc Th]
*** PRE-FLOP *** 
P1xel7 raises 1920 to 3520
marquestaut7 folds
Tonio 7.0 folds
mAgA_ folds
Asticopathe calls 2720
jadou74 folds
*** FLOP *** [Jd 3c Ts]
Asticopathe checks
P1xel7 bets 4920
Asticopathe folds
P1xel7 collected 14760 from pot
*** SUMMARY ***
Total pot 14760 | No rake
Board: [Jd 3c Ts]
Seat 3: P1xel7 won 14760


Winamax Poker - Tournament "Kill The Fish" buyIn: 0.45€ + 0.05€ level: 14 - HandId: #3040732885884600333-106-1699729684 - Holdem no limit (250/1000/2000) - 2023/11/11 19:08:04 UTC
Table: 'Kill The Fish(707975795)#012' 6-max (real money) Seat #1 is the button
Seat 1: Asticopathe (52632, 0.33€ bounty)
Seat 2: jadou74 (39830, 0.22€ bounty)
Seat 3: P1xel7 (78087, 0.77€ bounty)
Seat 4: marquestaut7 (10352, 0.33€ bounty)
Seat 5: Tonio 7.0 (74952, 0.44€ bounty)
Seat 6: mAgA_ (39977, 0.22€ bounty)
*** ANTE/BLINDS ***
jadou74 posts ante 250
P1xel7 posts ante 250
Asticopathe posts ante 250
marquestaut7 posts ante 250
Tonio 7.0 posts ante 250
mAgA_ posts ante 250
jadou74 posts small blind 1000
P1xel7 posts big blind 2000
Dealt to P1xel7 [Jc Ts]
*** PRE-FLOP *** 
marquestaut7 folds
Tonio 7.0 folds
mAgA_ calls 2000
Asticopathe raises 3000 to 5000
jadou74 folds
P1xel7 folds
mAgA_ folds
Asticopathe collected 11500 from pot
*** SUMMARY ***
Total pot 11500 | No rake
Seat 1: Asticopathe (button) won 11500


Winamax Poker - Tournament "Kill The Fish" buyIn: 0.45€ + 0.05€ level: 14 - HandId: #3040732885884600333-107-1699729735 - Holdem no limit (250/1000/2000) - 2023/11/11 19:08:55 UTC
Table: 'Kill The Fish(707975795)#012' 6-max (real money) Seat #2 is the button
Seat 1: Asticopathe (58882, 0.33€ bounty)
Seat 2: jadou74 (38580, 0.22€ bounty)
Seat 3: P1xel7 (75837, 0.77€ bounty)
Seat 4: marquestaut7 (10102, 0.33€ bounty)
Seat 5: Tonio 7.0 (74702, 0.44€ bounty)
Seat 6: mAgA_ (37727, 0.22€ bounty)
*** ANTE/BLINDS ***
P1xel7 posts ante 250
marquestaut7 posts ante 250
Asticopathe posts ante 250
jadou74 posts ante 250
Tonio 7.0 posts ante 250
mAgA_ posts ante 250
P1xel7 posts small blind 1000
marquestaut7 posts big blind 2000
Dealt to P1xel7 [Ac Kd]
*** PRE-FLOP *** 
Tonio 7.0 raises 72452 to 74452 and is all-in
mAgA_ folds
Asticopathe folds
jadou74 folds
P1xel7 calls 73452
marquestaut7 folds
*** FLOP *** [3h 5s 4h]
*** TURN *** [3h 5s 4h][7h]
*** RIVER *** [3h 5s 4h 7h][5c]
*** SHOW DOWN ***
Tonio 7.0 shows [Ad Jd] (One pair : 5)
P1xel7 shows [Ac Kd] (One pair : 5)
P1xel7 collected 152404 from pot
*** SUMMARY ***
Total pot 152404 | No rake
Board: [3h 5s 4h 7h 5c]
Seat 3: P1xel7 (small blind) showed [Ac Kd] and won 152404 with One pair : 5
Seat 5: Tonio 7.0 showed [Ad Jd] and lost with One pair : 5


Winamax Poker - Tournament "Kill The Fish" buyIn: 0.45€ + 0.05€ level: 14 - HandId: #3040732885884600333-108-1699729763 - Holdem no limit (250/1000/2000) - 2023/11/11 19:09:23 UTC
Table: 'Kill The Fish(707975795)#012' 6-max (real money) Seat #3 is the button
Seat 1: Asticopathe (58632, 0.33€ bounty)
Seat 2: jadou74 (38330, 0.22€ bounty)
Seat 3: P1xel7 (153539, 0.99€ bounty)
Seat 4: marquestaut7 (7852, 0.33€ bounty)
Seat 6: mAgA_ (37477, 0.22€ bounty)
*** ANTE/BLINDS ***
marquestaut7 posts ante 250
mAgA_ posts ante 250
Asticopathe posts ante 250
jadou74 posts ante 250
P1xel7 posts ante 250
marquestaut7 posts small blind 1000
mAgA_ posts big blind 2000
Dealt to P1xel7 [5s 6d]
*** PRE-FLOP *** 
Asticopathe folds
jadou74 folds
P1xel7 folds
marquestaut7 folds
mAgA_ collected 4250 from pot
*** SUMMARY ***
Total pot 4250 | No rake
Seat 6: mAgA_ (big blind) won 4250


Winamax Poker - Tournament "Kill The Fish" buyIn: 0.45€ + 0.05€ level: 14 - HandId: #3040732885884600333-109-1699729773 - Holdem no limit (250/1000/2000) - 2023/11/11 19:09:33 UTC
Table: 'Kill The Fish(707975795)#012' 6-max (real money) Seat #4 is the button
Seat 1: Asticopathe (58382, 0.33€ bounty)
Seat 2: jadou74 (38080, 0.22€ bounty)
Seat 3: P1xel7 (153289, 0.99€ bounty)
Seat 4: marquestaut7 (6602, 0.33€ bounty)
Seat 6: mAgA_ (39477, 0.22€ bounty)
*** ANTE/BLINDS ***
mAgA_ posts ante 250
Asticopathe posts ante 250
jadou74 posts ante 250
P1xel7 posts ante 250
marquestaut7 posts ante 250
mAgA_ posts small blind 1000
Asticopathe posts big blind 2000
Dealt to P1xel7 [Qc Th]
*** PRE-FLOP *** 
jadou74 folds
P1xel7 raises 2400 to 4400
marquestaut7 folds
mAgA_ folds
Asticopathe folds
P1xel7 collected 8650 from pot
*** SUMMARY ***
Total pot 8650 | No rake
Seat 3: P1xel7 won 8650


Winamax Poker - Tournament "Kill The Fish" buyIn: 0.45€ + 0.05€ level: 14 - HandId: #3040732885884600333-110-1699729806 - Holdem no limit (250/1000/2000) - 2023/11/11 19:10:06 UTC
Table: 'Kill The Fish(707975795)#012' 6-max (real money) Seat #6 is the button
Seat 1: Asticopathe (56132, 0.33€ bounty)
Seat 2: jadou74 (37830, 0.22€ bounty)
Seat 3: P1xel7 (157289, 0.99€ bounty)
Seat 4: marquestaut7 (6352, 0.33€ bounty)
Seat 5: GoldDeKu (42705, 0.33€ bounty)
Seat 6: mAgA_ (38227, 0.22€ bounty)
*** ANTE/BLINDS ***
Asticopathe posts ante 250
jadou74 posts ante 250
P1xel7 posts ante 250
marquestaut7 posts ante 250
GoldDeKu posts ante 250
mAgA_ posts ante 250
Asticopathe posts small blind 1000
jadou74 posts big blind 2000
Dealt to P1xel7 [4c Ah]
*** PRE-FLOP *** 
P1xel7 folds
marquestaut7 folds
GoldDeKu folds
mAgA_ folds
Asticopathe calls 1000
jadou74 checks
*** FLOP *** [9h 7h 4s]
Asticopathe checks
jadou74 bets 2000
Asticopathe folds
jadou74 collected 7500 from pot
*** SUMMARY ***
Total pot 7500 | No rake
Board: [9h 7h 4s]
Seat 2: jadou74 (big blind) won 7500


Winamax Poker - Tournament "Kill The Fish" buyIn: 0.45€ + 0.05€ level: 14 - HandId: #3040732885884600333-111-1699729850 - Holdem no limit (250/1000/2000) - 2023/11/11 19:10:50 UTC
Table: 'Kill The Fish(707975795)#012' 6-max (real money) Seat #1 is the button
Seat 1: Asticopathe (53882, 0.33€ bounty)
Seat 2: jadou74 (41080, 0.22€ bounty)
Seat 3: P1xel7 (157039, 0.99€ bounty)
Seat 4: marquestaut7 (6102, 0.33€ bounty)
Seat 5: GoldDeKu (42455, 0.33€ bounty)
Seat 6: mAgA_ (37977, 0.22€ bounty)
*** ANTE/BLINDS ***
jadou74 posts ante 250
P1xel7 posts ante 250
Asticopathe posts ante 250
marquestaut7 posts ante 250
GoldDeKu posts ante 250
mAgA_ posts ante 250
jadou74 posts small blind 1000
P1xel7 posts big blind 2000
Dealt to P1xel7 [4d 7d]
*** PRE-FLOP *** 
marquestaut7 folds
GoldDeKu folds
mAgA_ folds
Asticopathe raises 2000 to 4000
jadou74 calls 3000
P1xel7 calls 2000
*** FLOP *** [3d Qs 6d]
jadou74 checks
P1xel7 checks
Asticopathe bets 7000
jadou74 folds
P1xel7 calls 7000
*** TURN *** [3d Qs 6d][2d]
P1xel7 checks
Asticopathe bets 16000
P1xel7 raises 129789 to 145789 and is all-in
Asticopathe calls 26632 and is all-in
*** RIVER *** [3d Qs 6d 2d][7s]
*** SHOW DOWN ***
Asticopathe shows [7h Qh] (Two pairs : Queens and 7)
P1xel7 shows [4d 7d] (Flush 7 high)
P1xel7 collected 215921 from pot
*** SUMMARY ***
Total pot 215921 | No rake
Board: [3d Qs 6d 2d 7s]
Seat 1: Asticopathe (button) showed [7h Qh] and lost with Two pairs : Queens and 7
Seat 3: P1xel7 (big blind) showed [4d 7d] and won 215921 with Flush 7 high


Winamax Poker - Tournament "Kill The Fish" buyIn: 0.45€ + 0.05€ level: 15 - HandId: #3040732885884600333-112-1699729953 - Holdem no limit (300/1250/2500) - 2023/11/11 19:12:33 UTC
Table: 'Kill The Fish(707975795)#012' 6-max (real money) Seat #2 is the button
Seat 2: jadou74 (36830, 0.22€ bounty)
Seat 3: P1xel7 (215921, 1.15€ bounty)
Seat 4: marquestaut7 (5852, 0.33€ bounty)
Seat 5: GoldDeKu (42205, 0.33€ bounty)
Seat 6: mAgA_ (37727, 0.22€ bounty)
*** ANTE/BLINDS ***
P1xel7 posts ante 300
marquestaut7 posts ante 300
jadou74 posts ante 300
GoldDeKu posts ante 300
mAgA_ posts ante 300
P1xel7 posts small blind 1250
marquestaut7 posts big blind 2500
Dealt to P1xel7 [As 7h]
*** PRE-FLOP *** 
GoldDeKu folds
mAgA_ folds
jadou74 folds
P1xel7 raises 3000 to 5500
marquestaut7 folds
P1xel7 collected 9500 from pot
*** SUMMARY ***
Total pot 9500 | No rake
Seat 3: P1xel7 (small blind) won 9500


Winamax Poker - Tournament "Kill The Fish" buyIn: 0.45€ + 0.05€ level: 15 - HandId: #3040732885884600333-113-1699729970 - Holdem no limit (300/1250/2500) - 2023/11/11 19:12:50 UTC
Table: 'Kill The Fish(707975795)#012' 6-max (real money) Seat #3 is the button
Seat 1: Valsteff (57224, 0.33€ bounty)
Seat 2: jadou74 (36530, 0.22€ bounty)
Seat 3: P1xel7 (219621, 1.15€ bounty)
Seat 4: marquestaut7 (3052, 0.33€ bounty)
Seat 5: GoldDeKu (41905, 0.33€ bounty)
Seat 6: mAgA_ (37427, 0.22€ bounty)
*** ANTE/BLINDS ***
marquestaut7 posts ante 300
GoldDeKu posts ante 300
Valsteff posts ante 300
jadou74 posts ante 300
P1xel7 posts ante 300
mAgA_ posts ante 300
marquestaut7 posts small blind 1250
GoldDeKu posts big blind 2500
Dealt to P1xel7 [5s Ts]
*** PRE-FLOP *** 
mAgA_ calls 2500
Valsteff folds
jadou74 folds
P1xel7 folds
marquestaut7 folds
GoldDeKu checks
*** FLOP *** [Jh 5c Qc]
GoldDeKu checks
mAgA_ checks
*** TURN *** [Jh 5c Qc][Js]
GoldDeKu checks
mAgA_ checks
*** RIVER *** [Jh 5c Qc Js][Qs]
GoldDeKu checks
mAgA_ checks
*** SHOW DOWN ***
mAgA_ shows [4s 4d] (Two pairs : Queens and Jacks)
GoldDeKu shows [8h As] (Two pairs : Queens and Jacks)
GoldDeKu collected 8050 from pot
*** SUMMARY ***
Total pot 8050 | No rake
Board: [Jh 5c Qc Js Qs]
Seat 5: GoldDeKu (big blind) showed [8h As] and won 8050 with Two pairs : Queens and Jacks
Seat 6: mAgA_ showed [4s 4d] and lost with Two pairs : Queens and Jacks


Winamax Poker - Tournament "Kill The Fish" buyIn: 0.45€ + 0.05€ level: 15 - HandId: #3040732885884600333-114-1699730014 - Holdem no limit (300/1250/2500) - 2023/11/11 19:13:34 UTC
Table: 'Kill The Fish(707975795)#012' 6-max (real money) Seat #4 is the button
Seat 1: Valsteff (56924, 0.33€ bounty)
Seat 2: jadou74 (36230, 0.22€ bounty)
Seat 3: P1xel7 (219321, 1.15€ bounty)
Seat 4: marquestaut7 (1502, 0.33€ bounty)
Seat 5: GoldDeKu (47155, 0.33€ bounty)
Seat 6: mAgA_ (34627, 0.22€ bounty)
*** ANTE/BLINDS ***
GoldDeKu posts ante 300
mAgA_ posts ante 300
Valsteff posts ante 300
jadou74 posts ante 300
P1xel7 posts ante 300
marquestaut7 posts ante 300
GoldDeKu posts small blind 1250
mAgA_ posts big blind 2500
Dealt to P1xel7 [8s 6d]
*** PRE-FLOP *** 
Valsteff calls 2500
jadou74 folds
P1xel7 folds
marquestaut7 folds
GoldDeKu folds
mAgA_ raises 31827 to 34327 and is all-in
Valsteff folds
mAgA_ collected 39877 from pot
*** SUMMARY ***
Total pot 39877 | No rake
Seat 6: mAgA_ (big blind) won 39877


Winamax Poker - Tournament "Kill The Fish" buyIn: 0.45€ + 0.05€ level: 15 - HandId: #3040732885884600333-115-1699730043 - Holdem no limit (300/1250/2500) - 2023/11/11 19:14:03 UTC
Table: 'Kill The Fish(707975795)#012' 6-max (real money) Seat #5 is the button
Seat 1: Valsteff (54124, 0.33€ bounty)
Seat 2: jadou74 (35930, 0.22€ bounty)
Seat 3: P1xel7 (219021, 1.15€ bounty)
Seat 4: marquestaut7 (1202, 0.33€ bounty)
Seat 5: GoldDeKu (45605, 0.33€ bounty)
Seat 6: mAgA_ (39877, 0.22€ bounty)
*** ANTE/BLINDS ***
mAgA_ posts ante 300
Valsteff posts ante 300
jadou74 posts ante 300
P1xel7 posts ante 300
marquestaut7 posts ante 300
GoldDeKu posts ante 300
mAgA_ posts small blind 1250
Valsteff posts big blind 2500
Dealt to P1xel7 [6s Qc]
*** PRE-FLOP *** 
jadou74 folds
P1xel7 folds
marquestaut7 folds
GoldDeKu folds
mAgA_ calls 1250
Valsteff checks
*** FLOP *** [8s 3d 7c]
mAgA_ bets 3750
Valsteff folds
mAgA_ collected 10550 from pot
*** SUMMARY ***
Total pot 10550 | No rake
Board: [8s 3d 7c]
Seat 6: mAgA_ (small blind) won 10550


Winamax Poker - Tournament "Kill The Fish" buyIn: 0.45€ + 0.05€ level: 15 - HandId: #3040732885884600333-116-1699730074 - Holdem no limit (300/1250/2500) - 2023/11/11 19:14:34 UTC
Table: 'Kill The Fish(707975795)#012' 6-max (real money) Seat #6 is the button
Seat 1: Valsteff (51324, 0.33€ bounty)
Seat 2: jadou74 (35630, 0.22€ bounty)
Seat 3: P1xel7 (218721, 1.15€ bounty)
Seat 4: marquestaut7 (902, 0.33€ bounty)
Seat 5: GoldDeKu (45305, 0.33€ bounty)
Seat 6: mAgA_ (43877, 0.22€ bounty)
*** ANTE/BLINDS ***
Valsteff posts ante 300
jadou74 posts ante 300
P1xel7 posts ante 300
marquestaut7 posts ante 300
GoldDeKu posts ante 300
mAgA_ posts ante 300
Valsteff posts small blind 1250
jadou74 posts big blind 2500
Dealt to P1xel7 [Qh Qs]
*** PRE-FLOP *** 
P1xel7 raises 3000 to 5500
marquestaut7 folds
GoldDeKu folds
mAgA_ folds
Valsteff folds
jadou74 folds
P1xel7 collected 11050 from pot
*** SUMMARY ***
Total pot 11050 | No rake
Seat 3: P1xel7 won 11050


Winamax Poker - Tournament "Kill The Fish" buyIn: 0.45€ + 0.05€ level: 15 - HandId: #3040732885884600333-117-1699730102 - Holdem no limit (300/1250/2500) - 2023/11/11 19:15:02 UTC
Table: 'Kill The Fish(707975795)#012' 6-max (real money) Seat #1 is the button
Seat 1: Valsteff (49774, 0.33€ bounty)
Seat 2: jadou74 (32830, 0.22€ bounty)
Seat 3: P1xel7 (223971, 1.15€ bounty)
Seat 4: marquestaut7 (602, 0.33€ bounty)
Seat 5: GoldDeKu (45005, 0.33€ bounty)
Seat 6: mAgA_ (43577, 0.22€ bounty)
*** ANTE/BLINDS ***
jadou74 posts ante 300
P1xel7 posts ante 300
Valsteff posts ante 300
marquestaut7 posts ante 300
GoldDeKu posts ante 300
mAgA_ posts ante 300
jadou74 posts small blind 1250
P1xel7 posts big blind 2500
Dealt to P1xel7 [7c Jd]
*** PRE-FLOP *** 
marquestaut7 folds
GoldDeKu folds
mAgA_ folds
Valsteff calls 2500
jadou74 calls 1250
P1xel7 checks
*** FLOP *** [3c Kh 3h]
jadou74 checks
P1xel7 checks
Valsteff bets 2500
jadou74 folds
P1xel7 folds
Valsteff collected 11800 from pot
*** SUMMARY ***
Total pot 11800 | No rake
Board: [3c Kh 3h]
Seat 1: Valsteff (button) won 11800


Winamax Poker - Tournament "Kill The Fish" buyIn: 0.45€ + 0.05€ level: 15 - HandId: #3040732885884600333-118-1699730169 - Holdem no limit (300/1250/2500) - 2023/11/11 19:16:09 UTC
Table: 'Kill The Fish(707975795)#012' 6-max (real money) Seat #2 is the button
Seat 1: Valsteff (56274, 0.33€ bounty)
Seat 2: jadou74 (30030, 0.22€ bounty)
Seat 3: P1xel7 (221171, 1.15€ bounty)
Seat 4: marquestaut7 (302, 0.33€ bounty)
Seat 5: GoldDeKu (44705, 0.33€ bounty)
Seat 6: mAgA_ (43277, 0.22€ bounty)
*** ANTE/BLINDS ***
P1xel7 posts ante 300
marquestaut7 posts ante 300
Valsteff posts ante 300
jadou74 posts ante 300
GoldDeKu posts ante 300
mAgA_ posts ante 300
P1xel7 posts small blind 1250
marquestaut7 posts big blind 2 and is all-in
Dealt to P1xel7 [Th 8s]
*** PRE-FLOP *** 
GoldDeKu raises 3750 to 5000
mAgA_ folds
Valsteff folds
jadou74 folds
P1xel7 calls 3750
*** FLOP *** [Qd 7s 5c]
P1xel7 checks
GoldDeKu checks
*** TURN *** [Qd 7s 5c][3s]
P1xel7 bets 9442
GoldDeKu calls 9442
*** RIVER *** [Qd 7s 5c 3s][7c]
P1xel7 bets 15343
GoldDeKu folds
*** SHOW DOWN ***
P1xel7 shows [Th 8s] (One pair : 7)
marquestaut7 shows [As Jd] (One pair : 7)
marquestaut7 collected 1806 from main pot
P1xel7 collected 44223 from side pot 1
*** SUMMARY ***
Total pot 46029 | No rake
Board: [Qd 7s 5c 3s 7c]
Seat 3: P1xel7 (small blind) showed [Th 8s] and won 44223 with One pair : 7
Seat 4: marquestaut7 (big blind) showed [As Jd] and won 1806 with One pair : 7


Winamax Poker - Tournament "Kill The Fish" buyIn: 0.45€ + 0.05€ level: 16 - HandId: #3040732885884600333-119-1699730225 - Holdem no limit (350/1500/3000) - 2023/11/11 19:17:05 UTC
Table: 'Kill The Fish(707975795)#012' 6-max (real money) Seat #3 is the button
Seat 1: Valsteff (55974, 0.33€ bounty)
Seat 2: jadou74 (29730, 0.22€ bounty)
Seat 3: P1xel7 (235309, 1.15€ bounty)
Seat 4: marquestaut7 (1806, 0.33€ bounty)
Seat 5: GoldDeKu (29963, 0.33€ bounty)
Seat 6: mAgA_ (42977, 0.22€ bounty)
*** ANTE/BLINDS ***
marquestaut7 posts ante 350
GoldDeKu posts ante 350
Valsteff posts ante 350
jadou74 posts ante 350
P1xel7 posts ante 350
mAgA_ posts ante 350
marquestaut7 posts small blind 1456 and is all-in
GoldDeKu posts big blind 3000
Dealt to P1xel7 [4d 6c]
*** PRE-FLOP *** 
mAgA_ folds
Valsteff calls 3000
jadou74 calls 3000
P1xel7 folds
GoldDeKu checks
*** FLOP *** [Td 3c Ac]
GoldDeKu checks
Valsteff checks
jadou74 checks
*** TURN *** [Td 3c Ac][Qs]
GoldDeKu checks
Valsteff checks
jadou74 checks
*** RIVER *** [Td 3c Ac Qs][9d]
GoldDeKu checks
Valsteff bets 4395
jadou74 folds
GoldDeKu folds
*** SHOW DOWN ***
marquestaut7 shows [2s Tc] (One pair : Tens)
Valsteff shows [9c 9s] (Trips of 9)
Valsteff collected 16951 from pot
*** SUMMARY ***
Total pot 16951 | No rake
Board: [Td 3c Ac Qs 9d]
Seat 1: Valsteff showed [9c 9s] and won 16951 with Trips of 9
Seat 4: marquestaut7 (small blind) showed [2s Tc] and lost with One pair : Tens


Winamax Poker - Tournament "Kill The Fish" buyIn: 0.45€ + 0.05€ level: 16 - HandId: #3040732885884600333-120-1699730270 - Holdem no limit (350/1500/3000) - 2023/11/11 19:17:50 UTC
Table: 'Kill The Fish(707975795)#012' 6-max (real money) Seat #4 is the button
Seat 1: Valsteff (65180, 0.49€ bounty)
Seat 2: jadou74 (26380, 0.22€ bounty)
Seat 3: P1xel7 (234959, 1.15€ bounty)
Seat 5: GoldDeKu (26613, 0.33€ bounty)
Seat 6: mAgA_ (42627, 0.22€ bounty)
*** ANTE/BLINDS ***
GoldDeKu posts ante 350
mAgA_ posts ante 350
Valsteff posts ante 350
jadou74 posts ante 350
P1xel7 posts ante 350
GoldDeKu posts small blind 1500
mAgA_ posts big blind 3000
Dealt to P1xel7 [7h 5c]
*** PRE-FLOP *** 
Valsteff folds
jadou74 calls 3000
P1xel7 folds
GoldDeKu folds
mAgA_ checks
*** FLOP *** [2s 3s 4c]
mAgA_ checks
jadou74 checks
*** TURN *** [2s 3s 4c][6h]
mAgA_ checks
jadou74 checks
*** RIVER *** [2s 3s 4c 6h][Kd]
mAgA_ bets 6013
jadou74 folds
mAgA_ collected 15263 from pot
*** SUMMARY ***
Total pot 15263 | No rake
Board: [2s 3s 4c 6h Kd]
Seat 6: mAgA_ (big blind) won 15263


Winamax Poker - Tournament "Kill The Fish" buyIn: 0.45€ + 0.05€ level: 16 - HandId: #3040732885884600333-121-1699730357 - Holdem no limit (350/1500/3000) - 2023/11/11 19:19:17 UTC
Table: 'Kill The Fish(707975795)#012' 6-max (real money) Seat #5 is the button
Seat 1: Valsteff (64830, 0.49€ bounty)
Seat 2: jadou74 (23030, 0.22€ bounty)
Seat 3: P1xel7 (234609, 1.15€ bounty)
Seat 5: GoldDeKu (24763, 0.33€ bounty)
Seat 6: mAgA_ (48527, 0.22€ bounty)
*** ANTE/BLINDS ***
mAgA_ posts ante 350
Valsteff posts ante 350
jadou74 posts ante 350
P1xel7 posts ante 350
GoldDeKu posts ante 350
mAgA_ posts small blind 1500
Valsteff posts big blind 3000
Dealt to P1xel7 [Js 5s]
*** PRE-FLOP *** 
jadou74 folds
P1xel7 folds
GoldDeKu calls 3000
mAgA_ calls 1500
Valsteff checks
*** FLOP *** [7s 4s Kh]
mAgA_ checks
Valsteff bets 3762
GoldDeKu raises 17651 to 21413 and is all-in
mAgA_ folds
Valsteff calls 17651
*** TURN *** [7s 4s Kh][7c]
*** RIVER *** [7s 4s Kh 7c][6c]
*** SHOW DOWN ***
GoldDeKu shows [Kd Qc] (Two pairs : Kings and 7)
Valsteff shows [Ks 7h] (Full of 7 and Kings)
Valsteff collected 53576 from pot
*** SUMMARY ***
Total pot 53576 | No rake
Board: [7s 4s Kh 7c 6c]
Seat 1: Valsteff (big blind) showed [Ks 7h] and won 53576 with Full of 7 and Kings
Seat 5: GoldDeKu (button) showed [Kd Qc] and lost with Two pairs : Kings and 7


Winamax Poker - Tournament "Kill The Fish" buyIn: 0.45€ + 0.05€ level: 16 - HandId: #3040732885884600333-122-1699730419 - Holdem no limit (350/1500/3000) - 2023/11/11 19:20:19 UTC
Table: 'Kill The Fish(707975795)#012' 6-max (real money) Seat #6 is the button
Seat 1: Valsteff (93643, 0.65€ bounty)
Seat 2: jadou74 (22680, 0.22€ bounty)
Seat 3: P1xel7 (234259, 1.15€ bounty)
Seat 4: LESpainDOR (57894, 0.44€ bounty)
Seat 6: mAgA_ (45177, 0.22€ bounty)
*** ANTE/BLINDS ***
Valsteff posts ante 350
jadou74 posts ante 350
P1xel7 posts ante 350
LESpainDOR posts ante 350
mAgA_ posts ante 350
Valsteff posts small blind 1500
jadou74 posts big blind 3000
Dealt to P1xel7 [5c 3d]
*** PRE-FLOP *** 
P1xel7 folds
LESpainDOR calls 3000
mAgA_ folds
Valsteff calls 1500
jadou74 checks
*** FLOP *** [7c 2d 5h]
Valsteff checks
jadou74 checks
LESpainDOR checks
*** TURN *** [7c 2d 5h][5s]
Valsteff bets 3000
jadou74 folds
LESpainDOR folds
Valsteff collected 13750 from pot
*** SUMMARY ***
Total pot 13750 | No rake
Board: [7c 2d 5h 5s]
Seat 1: Valsteff (small blind) won 13750


Winamax Poker - Tournament "Kill The Fish" buyIn: 0.45€ + 0.05€ level: 16 - HandId: #3040732885884600333-123-1699730484 - Holdem no limit (350/1500/3000) - 2023/11/11 19:21:24 UTC
Table: 'Kill The Fish(707975795)#012' 6-max (real money) Seat #1 is the button
Seat 1: Valsteff (101043, 0.65€ bounty)
Seat 2: jadou74 (19330, 0.22€ bounty)
Seat 3: P1xel7 (233909, 1.15€ bounty)
Seat 4: LESpainDOR (54544, 0.44€ bounty)
Seat 5: ChefFabrice (87574, 0.55€ bounty)
Seat 6: mAgA_ (44827, 0.22€ bounty)
*** ANTE/BLINDS ***
jadou74 posts ante 350
P1xel7 posts ante 350
Valsteff posts ante 350
LESpainDOR posts ante 350
ChefFabrice posts ante 350
mAgA_ posts ante 350
jadou74 posts small blind 1500
P1xel7 posts big blind 3000
Dealt to P1xel7 [Kc 4s]
*** PRE-FLOP *** 
LESpainDOR folds
ChefFabrice folds
mAgA_ calls 3000
Valsteff folds
jadou74 calls 1500
P1xel7 checks
*** FLOP *** [Qd 5c Ad]
jadou74 bets 5550
P1xel7 folds
mAgA_ folds
jadou74 collected 16650 from pot
*** SUMMARY ***
Total pot 16650 | No rake
Board: [Qd 5c Ad]
Seat 2: jadou74 (small blind) won 16650


Winamax Poker - Tournament "Kill The Fish" buyIn: 0.45€ + 0.05€ level: 17 - HandId: #3040732885884600333-124-1699730541 - Holdem no limit (400/1750/3500) - 2023/11/11 19:22:21 UTC
Table: 'Kill The Fish(707975795)#012' 6-max (real money) Seat #2 is the button
Seat 1: Valsteff (100693, 0.65€ bounty)
Seat 2: jadou74 (27080, 0.22€ bounty)
Seat 3: P1xel7 (230559, 1.15€ bounty)
Seat 4: LESpainDOR (54194, 0.44€ bounty)
Seat 5: ChefFabrice (87224, 0.55€ bounty)
Seat 6: mAgA_ (41477, 0.22€ bounty)
*** ANTE/BLINDS ***
P1xel7 posts ante 400
LESpainDOR posts ante 400
Valsteff posts ante 400
jadou74 posts ante 400
ChefFabrice posts ante 400
mAgA_ posts ante 400
P1xel7 posts small blind 1750
LESpainDOR posts big blind 3500
Dealt to P1xel7 [6d Jc]
*** PRE-FLOP *** 
ChefFabrice raises 7000 to 10500
mAgA_ folds
Valsteff folds
jadou74 folds
P1xel7 folds
LESpainDOR folds
ChefFabrice collected 18150 from pot
*** SUMMARY ***
Total pot 18150 | No rake
Seat 5: ChefFabrice won 18150


Winamax Poker - Tournament "Kill The Fish" buyIn: 0.45€ + 0.05€ level: 17 - HandId: #3040732885884600333-125-1699730576 - Holdem no limit (400/1750/3500) - 2023/11/11 19:22:56 UTC
Table: 'Kill The Fish(707975795)#012' 6-max (real money) Seat #3 is the button
Seat 1: Valsteff (100293, 0.65€ bounty)
Seat 2: jadou74 (26680, 0.22€ bounty)
Seat 3: P1xel7 (228409, 1.15€ bounty)
Seat 4: LESpainDOR (50294, 0.44€ bounty)
Seat 5: ChefFabrice (94474, 0.55€ bounty)
Seat 6: mAgA_ (41077, 0.22€ bounty)
*** ANTE/BLINDS ***
LESpainDOR posts ante 400
ChefFabrice posts ante 400
Valsteff posts ante 400
jadou74 posts ante 400
P1xel7 posts ante 400
mAgA_ posts ante 400
LESpainDOR posts small blind 1750
ChefFabrice posts big blind 3500
Dealt to P1xel7 [9h 3c]
*** PRE-FLOP *** 
mAgA_ folds
Valsteff folds
jadou74 calls 3500
P1xel7 folds
LESpainDOR folds
ChefFabrice checks
*** FLOP *** [3s Js Kd]
ChefFabrice checks
jadou74 bets 22780 and is all-in
ChefFabrice folds
jadou74 collected 33930 from pot
*** SUMMARY ***
Total pot 33930 | No rake
Board: [3s Js Kd]
Seat 2: jadou74 won 33930


Winamax Poker - Tournament "Kill The Fish" buyIn: 0.45€ + 0.05€ level: 17 - HandId: #3040732885884600333-126-1699730615 - Holdem no limit (400/1750/3500) - 2023/11/11 19:23:35 UTC
Table: 'Kill The Fish(707975795)#012' 6-max (real money) Seat #4 is the button
Seat 1: Valsteff (99893, 0.65€ bounty)
Seat 2: jadou74 (33930, 0.22€ bounty)
Seat 3: P1xel7 (228009, 1.15€ bounty)
Seat 4: LESpainDOR (48144, 0.44€ bounty)
Seat 5: ChefFabrice (90574, 0.55€ bounty)
Seat 6: mAgA_ (40677, 0.22€ bounty)
*** ANTE/BLINDS ***
ChefFabrice posts ante 400
mAgA_ posts ante 400
Valsteff posts ante 400
jadou74 posts ante 400
P1xel7 posts ante 400
LESpainDOR posts ante 400
ChefFabrice posts small blind 1750
mAgA_ posts big blind 3500
Dealt to P1xel7 [Tc 6s]
*** PRE-FLOP *** 
Valsteff raises 3500 to 7000
jadou74 folds
P1xel7 folds
LESpainDOR folds
ChefFabrice calls 5250
mAgA_ folds
*** FLOP *** [Jc 5s Kd]
ChefFabrice bets 6965
Valsteff raises 6965 to 13930
ChefFabrice folds
Valsteff collected 40795 from pot
*** SUMMARY ***
Total pot 40795 | No rake
Board: [Jc 5s Kd]
Seat 1: Valsteff won 40795


Winamax Poker - Tournament "Kill The Fish" buyIn: 0.45€ + 0.05€ level: 17 - HandId: #3040732885884600333-127-1699730679 - Holdem no limit (400/1750/3500) - 2023/11/11 19:24:39 UTC
Table: 'Kill The Fish(707975795)#012' 6-max (real money) Seat #5 is the button
Seat 1: Valsteff (119358, 0.65€ bounty)
Seat 2: jadou74 (33530, 0.22€ bounty)
Seat 3: P1xel7 (227609, 1.15€ bounty)
Seat 4: LESpainDOR (47744, 0.44€ bounty)
Seat 5: ChefFabrice (76209, 0.55€ bounty)
Seat 6: mAgA_ (36777, 0.22€ bounty)
*** ANTE/BLINDS ***
mAgA_ posts ante 400
Valsteff posts ante 400
jadou74 posts ante 400
P1xel7 posts ante 400
LESpainDOR posts ante 400
ChefFabrice posts ante 400
mAgA_ posts small blind 1750
Valsteff posts big blind 3500
Dealt to P1xel7 [Td Kh]
*** PRE-FLOP *** 
jadou74 folds
P1xel7 raises 5250 to 8750
LESpainDOR folds
ChefFabrice folds
mAgA_ folds
Valsteff folds
P1xel7 collected 16400 from pot
*** SUMMARY ***
Total pot 16400 | No rake
Seat 3: P1xel7 won 16400


Winamax Poker - Tournament "Kill The Fish" buyIn: 0.45€ + 0.05€ level: 17 - HandId: #3040732885884600333-128-1699730724 - Holdem no limit (400/1750/3500) - 2023/11/11 19:25:24 UTC
Table: 'Kill The Fish(707975795)#012' 6-max (real money) Seat #6 is the button
Seat 1: Valsteff (115458, 0.65€ bounty)
Seat 2: jadou74 (33130, 0.22€ bounty)
Seat 3: P1xel7 (234859, 1.15€ bounty)
Seat 4: LESpainDOR (47344, 0.44€ bounty)
Seat 5: ChefFabrice (75809, 0.55€ bounty)
Seat 6: mAgA_ (34627, 0.22€ bounty)
*** ANTE/BLINDS ***
Valsteff posts ante 400
jadou74 posts ante 400
P1xel7 posts ante 400
LESpainDOR posts ante 400
ChefFabrice posts ante 400
mAgA_ posts ante 400
Valsteff posts small blind 1750
jadou74 posts big blind 3500
Dealt to P1xel7 [Kd 6c]
*** PRE-FLOP *** 
P1xel7 folds
LESpainDOR folds
ChefFabrice raises 5250 to 8750
mAgA_ folds
Valsteff calls 7000
jadou74 folds
*** FLOP *** [Ac 3s 5s]
Valsteff checks
ChefFabrice checks
*** TURN *** [Ac 3s 5s][Th]
Valsteff bets 8190
ChefFabrice folds
Valsteff collected 31590 from pot
*** SUMMARY ***
Total pot 31590 | No rake
Board: [Ac 3s 5s Th]
Seat 1: Valsteff (small blind) won 31590


Winamax Poker - Tournament "Kill The Fish" buyIn: 0.45€ + 0.05€ level: 18 - HandId: #3040732885884600333-129-1699730867 - Holdem no limit (500/2000/4000) - 2023/11/11 19:27:47 UTC
Table: 'Kill The Fish(707975795)#012' 6-max (real money) Seat #1 is the button
Seat 1: Valsteff (129708, 0.65€ bounty)
Seat 2: jadou74 (29230, 0.22€ bounty)
Seat 3: P1xel7 (234459, 1.15€ bounty)
Seat 4: LESpainDOR (46944, 0.44€ bounty)
Seat 5: ChefFabrice (66659, 0.55€ bounty)
Seat 6: mAgA_ (34227, 0.22€ bounty)
*** ANTE/BLINDS ***
jadou74 posts ante 500
P1xel7 posts ante 500
Valsteff posts ante 500
LESpainDOR posts ante 500
ChefFabrice posts ante 500
mAgA_ posts ante 500
jadou74 posts small blind 2000
P1xel7 posts big blind 4000
Dealt to P1xel7 [5s Jc]
*** PRE-FLOP *** 
LESpainDOR raises 4000 to 8000
ChefFabrice folds
mAgA_ folds
Valsteff folds
jadou74 folds
P1xel7 folds
LESpainDOR collected 17000 from pot
*** SUMMARY ***
Total pot 17000 | No rake
Seat 4: LESpainDOR won 17000


Winamax Poker - Tournament "Kill The Fish" buyIn: 0.45€ + 0.05€ level: 18 - HandId: #3040732885884600333-130-1699730926 - Holdem no limit (500/2000/4000) - 2023/11/11 19:28:46 UTC
Table: 'Kill The Fish(707975795)#012' 6-max (real money) Seat #2 is the button
Seat 1: Valsteff (129208, 0.65€ bounty)
Seat 2: jadou74 (26730, 0.22€ bounty)
Seat 3: P1xel7 (229959, 1.15€ bounty)
Seat 4: LESpainDOR (55444, 0.44€ bounty)
Seat 5: ChefFabrice (66159, 0.55€ bounty)
Seat 6: mAgA_ (33727, 0.22€ bounty)
*** ANTE/BLINDS ***
P1xel7 posts ante 500
LESpainDOR posts ante 500
Valsteff posts ante 500
jadou74 posts ante 500
ChefFabrice posts ante 500
mAgA_ posts ante 500
P1xel7 posts small blind 2000
LESpainDOR posts big blind 4000
Dealt to P1xel7 [3c Jh]
*** PRE-FLOP *** 
ChefFabrice folds
mAgA_ folds
Valsteff calls 4000
jadou74 calls 4000
P1xel7 folds
LESpainDOR checks
*** FLOP *** [Qs 6d Td]
LESpainDOR checks
Valsteff bets 4000
jadou74 raises 18230 to 22230 and is all-in
LESpainDOR folds
Valsteff folds
jadou74 collected 43230 from pot
*** SUMMARY ***
Total pot 43230 | No rake
Board: [Qs 6d Td]
Seat 2: jadou74 (button) won 43230


Winamax Poker - Tournament "Kill The Fish" buyIn: 0.45€ + 0.05€ level: 18 - HandId: #3040732885884600333-131-1699730997 - Holdem no limit (500/2000/4000) - 2023/11/11 19:29:57 UTC
Table: 'Kill The Fish(707975795)#012' 6-max (real money) Seat #3 is the button
Seat 1: Valsteff (120708, 0.65€ bounty)
Seat 2: jadou74 (43230, 0.22€ bounty)
Seat 3: P1xel7 (227459, 1.15€ bounty)
Seat 4: LESpainDOR (50944, 0.44€ bounty)
Seat 5: ChefFabrice (65659, 0.55€ bounty)
Seat 6: mAgA_ (33227, 0.22€ bounty)
*** ANTE/BLINDS ***
LESpainDOR posts ante 500
ChefFabrice posts ante 500
Valsteff posts ante 500
jadou74 posts ante 500
P1xel7 posts ante 500
mAgA_ posts ante 500
LESpainDOR posts small blind 2000
ChefFabrice posts big blind 4000
Dealt to P1xel7 [Ac 7c]
*** PRE-FLOP *** 
mAgA_ raises 28727 to 32727 and is all-in
Valsteff folds
jadou74 folds
P1xel7 raises 194232 to 226959 and is all-in
LESpainDOR folds
ChefFabrice folds
*** FLOP *** [7d 9c 5c]
*** TURN *** [7d 9c 5c][4d]
*** RIVER *** [7d 9c 5c 4d][8d]
*** SHOW DOWN ***
mAgA_ shows [Qh Kc] (High card : King)
P1xel7 shows [Ac 7c] (One pair : 7)
P1xel7 collected 268686 from pot
*** SUMMARY ***
Total pot 268686 | No rake
Board: [7d 9c 5c 4d 8d]
Seat 3: P1xel7 (button) showed [Ac 7c] and won 268686 with One pair : 7
Seat 6: mAgA_ showed [Qh Kc] and lost with High card : King


Winamax Poker - Tournament "Kill The Fish" buyIn: 0.45€ + 0.05€ level: 18 - HandId: #3040732885884600333-132-1699731050 - Holdem no limit (500/2000/4000) - 2023/11/11 19:30:50 UTC
Table: 'Kill The Fish(707975795)#012' 6-max (real money) Seat #4 is the button
Seat 1: Valsteff (120208, 0.65€ bounty)
Seat 2: jadou74 (42730, 0.22€ bounty)
Seat 3: P1xel7 (268686, 1.26€ bounty)
Seat 4: LESpainDOR (48444, 0.44€ bounty)
Seat 5: ChefFabrice (61159, 0.55€ bounty)
*** ANTE/BLINDS ***
ChefFabrice posts ante 500
Valsteff posts ante 500
jadou74 posts ante 500
P1xel7 posts ante 500
LESpainDOR posts ante 500
ChefFabrice posts small blind 2000
Valsteff posts big blind 4000
Dealt to P1xel7 [8s 4c]
*** PRE-FLOP *** 
jadou74 folds
P1xel7 folds
LESpainDOR folds
ChefFabrice raises 10500 to 14500
Valsteff folds
ChefFabrice collected 21000 from pot
*** SUMMARY ***
Total pot 21000 | No rake
Seat 5: ChefFabrice (small blind) won 21000


Winamax Poker - Tournament "Kill The Fish" buyIn: 0.45€ + 0.05€ level: 18 - HandId: #3040732885884600333-133-1699731079 - Holdem no limit (500/2000/4000) - 2023/11/11 19:31:19 UTC
Table: 'Kill The Fish(707975795)#012' 6-max (real money) Seat #5 is the button
Seat 1: Valsteff (115708, 0.65€ bounty)
Seat 2: jadou74 (42230, 0.22€ bounty)
Seat 3: P1xel7 (268186, 1.26€ bounty)
Seat 4: LESpainDOR (47944, 0.44€ bounty)
Seat 5: ChefFabrice (67159, 0.55€ bounty)
Seat 6: BigRastaBang (162762, 1.06€ bounty)
*** ANTE/BLINDS ***
Valsteff posts ante 500
jadou74 posts ante 500
P1xel7 posts ante 500
LESpainDOR posts ante 500
ChefFabrice posts ante 500
Valsteff posts small blind 2000
jadou74 posts big blind 4000
Dealt to P1xel7 [2h 8d]
*** PRE-FLOP *** 
P1xel7 folds
LESpainDOR calls 4000
ChefFabrice calls 4000
Valsteff calls 2000
jadou74 checks
*** FLOP *** [6h 9s Kd]
Valsteff checks
jadou74 checks
LESpainDOR bets 4000
ChefFabrice raises 26500 to 30500
Valsteff folds
jadou74 folds
LESpainDOR folds
ChefFabrice collected 53000 from pot
*** SUMMARY ***
Total pot 53000 | No rake
Board: [6h 9s Kd]
Seat 5: ChefFabrice (button) won 53000


Winamax Poker - Tournament "Kill The Fish" buyIn: 0.45€ + 0.05€ level: 19 - HandId: #3040732885884600333-134-1699731151 - Holdem no limit (600/2500/5000) - 2023/11/11 19:32:31 UTC
Table: 'Kill The Fish(707975795)#012' 6-max (real money) Seat #1 is the button
Seat 1: Valsteff (111208, 0.65€ bounty)
Seat 2: jadou74 (37730, 0.22€ bounty)
Seat 3: P1xel7 (267686, 1.26€ bounty)
Seat 4: LESpainDOR (39444, 0.44€ bounty)
Seat 5: ChefFabrice (85159, 0.55€ bounty)
Seat 6: BigRastaBang (162762, 1.06€ bounty)
*** ANTE/BLINDS ***
jadou74 posts ante 600
P1xel7 posts ante 600
Valsteff posts ante 600
LESpainDOR posts ante 600
ChefFabrice posts ante 600
BigRastaBang posts ante 600
jadou74 posts small blind 2500
P1xel7 posts big blind 5000
Dealt to P1xel7 [Td 2d]
*** PRE-FLOP *** 
LESpainDOR folds
ChefFabrice calls 5000
BigRastaBang folds
Valsteff folds
jadou74 calls 2500
P1xel7 checks
*** FLOP *** [Qs 4d Kd]
jadou74 bets 32130 and is all-in
P1xel7 calls 32130
ChefFabrice folds
*** TURN *** [Qs 4d Kd][2c]
*** RIVER *** [Qs 4d Kd 2c][Ac]
*** SHOW DOWN ***
P1xel7 shows [Td 2d] (One pair : 2)
jadou74 shows [9c Ks] (One pair : Kings)
jadou74 collected 82860 from pot
*** SUMMARY ***
Total pot 82860 | No rake
Board: [Qs 4d Kd 2c Ac]
Seat 2: jadou74 (small blind) showed [9c Ks] and won 82860 with One pair : Kings
Seat 3: P1xel7 (big blind) showed [Td 2d] and lost with One pair : 2


Winamax Poker - Tournament "Kill The Fish" buyIn: 0.45€ + 0.05€ level: 19 - HandId: #3040732885884600333-135-1699731224 - Holdem no limit (600/2500/5000) - 2023/11/11 19:33:44 UTC
Table: 'Kill The Fish(707975795)#012' 6-max (real money) Seat #2 is the button
Seat 1: Valsteff (110608, 0.65€ bounty)
Seat 2: jadou74 (82860, 0.22€ bounty)
Seat 3: P1xel7 (229956, 1.26€ bounty)
Seat 4: LESpainDOR (38844, 0.44€ bounty)
Seat 5: ChefFabrice (79559, 0.55€ bounty)
Seat 6: BigRastaBang (162162, 1.06€ bounty)
*** ANTE/BLINDS ***
P1xel7 posts ante 600
LESpainDOR posts ante 600
Valsteff posts ante 600
jadou74 posts ante 600
ChefFabrice posts ante 600
BigRastaBang posts ante 600
P1xel7 posts small blind 2500
LESpainDOR posts big blind 5000
Dealt to P1xel7 [9s Kd]
*** PRE-FLOP *** 
ChefFabrice raises 5000 to 10000
BigRastaBang folds
Valsteff folds
jadou74 folds
P1xel7 calls 7500
LESpainDOR folds
*** FLOP *** [7h 6s Td]
P1xel7 checks
ChefFabrice bets 10010
P1xel7 calls 10010
*** TURN *** [7h 6s Td][Jc]
P1xel7 checks
ChefFabrice bets 58949 and is all-in
P1xel7 calls 58949
*** RIVER *** [7h 6s Td Jc][5s]
*** SHOW DOWN ***
P1xel7 shows [9s Kd] (High card : King)
ChefFabrice shows [Ac 5h] (One pair : 5)
ChefFabrice collected 166518 from pot
*** SUMMARY ***
Total pot 166518 | No rake
Board: [7h 6s Td Jc 5s]
Seat 3: P1xel7 (small blind) showed [9s Kd] and lost with High card : King
Seat 5: ChefFabrice showed [Ac 5h] and won 166518 with One pair : 5


Winamax Poker - Tournament "Kill The Fish" buyIn: 0.45€ + 0.05€ level: 19 - HandId: #3040732885884600333-136-1699731321 - Holdem no limit (600/2500/5000) - 2023/11/11 19:35:21 UTC
Table: 'Kill The Fish(707975795)#012' 6-max (real money) Seat #3 is the button
Seat 1: Valsteff (110008, 0.65€ bounty)
Seat 2: jadou74 (82260, 0.22€ bounty)
Seat 3: P1xel7 (150397, 1.26€ bounty)
Seat 4: LESpainDOR (33244, 0.44€ bounty)
Seat 5: ChefFabrice (166518, 0.55€ bounty)
Seat 6: BigRastaBang (161562, 1.06€ bounty)
*** ANTE/BLINDS ***
LESpainDOR posts ante 600
ChefFabrice posts ante 600
Valsteff posts ante 600
jadou74 posts ante 600
P1xel7 posts ante 600
BigRastaBang posts ante 600
LESpainDOR posts small blind 2500
ChefFabrice posts big blind 5000
Dealt to P1xel7 [Ah Jh]
*** PRE-FLOP *** 
BigRastaBang folds
Valsteff folds
jadou74 folds
P1xel7 raises 7500 to 12500
LESpainDOR folds
ChefFabrice folds
P1xel7 collected 23600 from pot
*** SUMMARY ***
Total pot 23600 | No rake
Seat 3: P1xel7 (button) won 23600


Winamax Poker - Tournament "Kill The Fish" buyIn: 0.45€ + 0.05€ level: 19 - HandId: #3040732885884600333-137-1699731357 - Holdem no limit (600/2500/5000) - 2023/11/11 19:35:57 UTC
Table: 'Kill The Fish(707975795)#012' 6-max (real money) Seat #4 is the button
Seat 1: Valsteff (109408, 0.65€ bounty)
Seat 2: jadou74 (81660, 0.22€ bounty)
Seat 3: P1xel7 (160897, 1.26€ bounty)
Seat 4: LESpainDOR (30144, 0.44€ bounty)
Seat 5: ChefFabrice (160918, 0.55€ bounty)
Seat 6: BigRastaBang (160962, 1.06€ bounty)
*** ANTE/BLINDS ***
ChefFabrice posts ante 600
BigRastaBang posts ante 600
Valsteff posts ante 600
jadou74 posts ante 600
P1xel7 posts ante 600
LESpainDOR posts ante 600
ChefFabrice posts small blind 2500
BigRastaBang posts big blind 5000
Dealt to P1xel7 [Qd Ah]
*** PRE-FLOP *** 
Valsteff folds
jadou74 folds
P1xel7 raises 6000 to 11000
LESpainDOR folds
ChefFabrice folds
BigRastaBang calls 6000
*** FLOP *** [3d 3s Jh]
BigRastaBang bets 18265
P1xel7 calls 18265
*** TURN *** [3d 3s Jh][6d]
BigRastaBang bets 131097 and is all-in
P1xel7 folds
BigRastaBang collected 195727 from pot
*** SUMMARY ***
Total pot 195727 | No rake
Board: [3d 3s Jh 6d]
Seat 6: BigRastaBang (big blind) won 195727


Winamax Poker - Tournament "Kill The Fish" buyIn: 0.45€ + 0.05€ level: 19 - HandId: #3040732885884600328-158-1699731421 - Holdem no limit (600/2500/5000) - 2023/11/11 19:37:01 UTC
Table: 'Kill The Fish(707975795)#007' 6-max (real money) Seat #2 is the button
Seat 1: jessi.kdo (39890, 0.49€ bounty)
Seat 2: As2lajungle (204396, 0.55€ bounty)
Seat 3: nanass25440 (150427, 0.33€ bounty)
Seat 4: P1xel7 (131032, 1.26€ bounty)
Seat 5: Hariss4 (72272, 0.38€ bounty)
Seat 6: kalou 500 (645352, 2.38€ bounty)
*** ANTE/BLINDS ***
nanass25440 posts ante 600
P1xel7 posts ante 600
jessi.kdo posts ante 600
As2lajungle posts ante 600
Hariss4 posts ante 600
kalou 500 posts ante 600
nanass25440 posts small blind 2500
P1xel7 posts big blind 5000
Dealt to P1xel7 [8d 7s]
*** PRE-FLOP *** 
Hariss4 folds
kalou 500 folds
jessi.kdo calls 5000
As2lajungle raises 5000 to 10000
nanass25440 raises 139827 to 149827 and is all-in
P1xel7 folds
jessi.kdo calls 34290 and is all-in
As2lajungle folds
*** FLOP *** [9h 2d 4s]
*** TURN *** [9h 2d 4s][Kd]
*** RIVER *** [9h 2d 4s Kd][9d]
*** SHOW DOWN ***
jessi.kdo shows [7c Ac] (One pair : 9)
nanass25440 shows [Qs As] (One pair : 9)
nanass25440 collected 207717 from pot
*** SUMMARY ***
Total pot 207717 | No rake
Board: [9h 2d 4s Kd 9d]
Seat 1: jessi.kdo showed [7c Ac] and lost with One pair : 9
Seat 3: nanass25440 (small blind) showed [Qs As] and won 207717 with One pair : 9


Winamax Poker - Tournament "Kill The Fish" buyIn: 0.45€ + 0.05€ level: 20 - HandId: #3040732885884600328-159-1699731472 - Holdem no limit (700/3000/6000) - 2023/11/11 19:37:52 UTC
Table: 'Kill The Fish(707975795)#007' 6-max (real money) Seat #3 is the button
Seat 2: As2lajungle (193796, 0.55€ bounty)
Seat 3: nanass25440 (207717, 0.57€ bounty)
Seat 4: P1xel7 (125432, 1.26€ bounty)
Seat 5: Hariss4 (71672, 0.38€ bounty)
Seat 6: kalou 500 (644752, 2.38€ bounty)
*** ANTE/BLINDS ***
P1xel7 posts ante 700
Hariss4 posts ante 700
As2lajungle posts ante 700
nanass25440 posts ante 700
kalou 500 posts ante 700
P1xel7 posts small blind 3000
Hariss4 posts big blind 6000
Dealt to P1xel7 [6d Td]
*** PRE-FLOP *** 
kalou 500 calls 6000
As2lajungle folds
nanass25440 folds
P1xel7 folds
Hariss4 checks
*** FLOP *** [Ah 4d Jc]
Hariss4 checks
kalou 500 bets 18500
Hariss4 folds
kalou 500 collected 37000 from pot
*** SUMMARY ***
Total pot 37000 | No rake
Board: [Ah 4d Jc]
Seat 6: kalou 500 won 37000


Winamax Poker - Tournament "Kill The Fish" buyIn: 0.45€ + 0.05€ level: 20 - HandId: #3040732885884600328-160-1699731540 - Holdem no limit (700/3000/6000) - 2023/11/11 19:39:00 UTC
Table: 'Kill The Fish(707975795)#007' 6-max (real money) Seat #4 is the button
Seat 1: YOYO 82 (145585, 1.04€ bounty)
Seat 2: As2lajungle (193096, 0.55€ bounty)
Seat 3: nanass25440 (207017, 0.57€ bounty)
Seat 4: P1xel7 (121732, 1.26€ bounty)
Seat 5: Hariss4 (64972, 0.38€ bounty)
Seat 6: kalou 500 (656552, 2.38€ bounty)
*** ANTE/BLINDS ***
Hariss4 posts ante 700
kalou 500 posts ante 700
YOYO 82 posts ante 700
As2lajungle posts ante 700
nanass25440 posts ante 700
P1xel7 posts ante 700
Hariss4 posts small blind 3000
kalou 500 posts big blind 6000
Dealt to P1xel7 [Jd 7d]
*** PRE-FLOP *** 
YOYO 82 raises 138885 to 144885 and is all-in
As2lajungle folds
nanass25440 folds
P1xel7 folds
Hariss4 folds
kalou 500 folds
YOYO 82 collected 158085 from pot
*** SUMMARY ***
Total pot 158085 | No rake
Seat 1: YOYO 82 won 158085


Winamax Poker - Tournament "Kill The Fish" buyIn: 0.45€ + 0.05€ level: 20 - HandId: #3040732885884600328-161-1699731559 - Holdem no limit (700/3000/6000) - 2023/11/11 19:39:19 UTC
Table: 'Kill The Fish(707975795)#007' 6-max (real money) Seat #5 is the button
Seat 1: YOYO 82 (158085, 1.04€ bounty)
Seat 2: As2lajungle (192396, 0.55€ bounty)
Seat 3: nanass25440 (206317, 0.57€ bounty)
Seat 4: P1xel7 (121032, 1.26€ bounty)
Seat 5: Hariss4 (61272, 0.38€ bounty)
Seat 6: kalou 500 (649852, 2.38€ bounty)
*** ANTE/BLINDS ***
kalou 500 posts ante 700
YOYO 82 posts ante 700
As2lajungle posts ante 700
nanass25440 posts ante 700
P1xel7 posts ante 700
Hariss4 posts ante 700
kalou 500 posts small blind 3000
YOYO 82 posts big blind 6000
Dealt to P1xel7 [Qh As]
*** PRE-FLOP *** 
As2lajungle raises 6000 to 12000
nanass25440 folds
P1xel7 raises 108332 to 120332 and is all-in
Hariss4 folds
kalou 500 folds
YOYO 82 folds
As2lajungle folds
P1xel7 collected 145532 from pot
*** SUMMARY ***
Total pot 145532 | No rake
Seat 4: P1xel7 won 145532


Winamax Poker - Tournament "Kill The Fish" buyIn: 0.45€ + 0.05€ level: 20 - HandId: #3040732885884600328-162-1699731589 - Holdem no limit (700/3000/6000) - 2023/11/11 19:39:49 UTC
Table: 'Kill The Fish(707975795)#007' 6-max (real money) Seat #6 is the button
Seat 1: YOYO 82 (151385, 1.04€ bounty)
Seat 2: As2lajungle (179696, 0.55€ bounty)
Seat 3: nanass25440 (205617, 0.57€ bounty)
Seat 4: P1xel7 (145532, 1.26€ bounty)
Seat 5: Hariss4 (60572, 0.38€ bounty)
Seat 6: kalou 500 (646152, 2.38€ bounty)
*** ANTE/BLINDS ***
YOYO 82 posts ante 700
As2lajungle posts ante 700
nanass25440 posts ante 700
P1xel7 posts ante 700
Hariss4 posts ante 700
kalou 500 posts ante 700
YOYO 82 posts small blind 3000
As2lajungle posts big blind 6000
Dealt to P1xel7 [3d 6c]
*** PRE-FLOP *** 
nanass25440 folds
P1xel7 folds
Hariss4 folds
kalou 500 calls 6000
YOYO 82 folds
As2lajungle checks
*** FLOP *** [3h 4d Kd]
As2lajungle checks
kalou 500 checks
*** TURN *** [3h 4d Kd][8h]
As2lajungle checks
kalou 500 checks
*** RIVER *** [3h 4d Kd 8h][Ks]
As2lajungle checks
kalou 500 checks
*** SHOW DOWN ***
As2lajungle shows [5s 2s] (One pair : Kings)
kalou 500 shows [Qd 7c] (One pair : Kings)
kalou 500 collected 19200 from pot
*** SUMMARY ***
Total pot 19200 | No rake
Board: [3h 4d Kd 8h Ks]
Seat 2: As2lajungle (big blind) showed [5s 2s] and lost with One pair : Kings
Seat 6: kalou 500 (button) showed [Qd 7c] and won 19200 with One pair : Kings


Winamax Poker - Tournament "Kill The Fish" buyIn: 0.45€ + 0.05€ level: 20 - HandId: #3040732885884600328-163-1699731627 - Holdem no limit (700/3000/6000) - 2023/11/11 19:40:27 UTC
Table: 'Kill The Fish(707975795)#007' 6-max (real money) Seat #1 is the button
Seat 1: YOYO 82 (147685, 1.04€ bounty)
Seat 2: As2lajungle (172996, 0.55€ bounty)
Seat 3: nanass25440 (204917, 0.57€ bounty)
Seat 4: P1xel7 (144832, 1.26€ bounty)
Seat 5: Hariss4 (59872, 0.38€ bounty)
Seat 6: kalou 500 (658652, 2.38€ bounty)
*** ANTE/BLINDS ***
As2lajungle posts ante 700
nanass25440 posts ante 700
YOYO 82 posts ante 700
P1xel7 posts ante 700
Hariss4 posts ante 700
kalou 500 posts ante 700
As2lajungle posts small blind 3000
nanass25440 posts big blind 6000
Dealt to P1xel7 [Jd 9h]
*** PRE-FLOP *** 
P1xel7 folds
Hariss4 calls 6000
kalou 500 calls 6000
YOYO 82 folds
As2lajungle raises 7200 to 13200
nanass25440 folds
Hariss4 raises 45972 to 59172 and is all-in
kalou 500 folds
As2lajungle calls 45972
*** FLOP *** [Qh Ks 4h]
*** TURN *** [Qh Ks 4h][Qc]
*** RIVER *** [Qh Ks 4h Qc][8c]
*** SHOW DOWN ***
Hariss4 shows [Ad 6d] (One pair : Queens)
As2lajungle shows [Kh Jh] (Two pairs : Kings and Queens)
As2lajungle collected 134544 from pot
*** SUMMARY ***
Total pot 134544 | No rake
Board: [Qh Ks 4h Qc 8c]
Seat 2: As2lajungle (small blind) showed [Kh Jh] and won 134544 with Two pairs : Kings and Queens
Seat 5: Hariss4 showed [Ad 6d] and lost with One pair : Queens


Winamax Poker - Tournament "Kill The Fish" buyIn: 0.45€ + 0.05€ level: 20 - HandId: #3040732885884600328-164-1699731678 - Holdem no limit (700/3000/6000) - 2023/11/11 19:41:18 UTC
Table: 'Kill The Fish(707975795)#007' 6-max (real money) Seat #2 is the button
Seat 1: YOYO 82 (146985, 1.04€ bounty)
Seat 2: As2lajungle (247668, 0.74€ bounty)
Seat 3: nanass25440 (198217, 0.57€ bounty)
Seat 4: P1xel7 (144132, 1.26€ bounty)
Seat 6: kalou 500 (651952, 2.38€ bounty)
*** ANTE/BLINDS ***
nanass25440 posts ante 700
P1xel7 posts ante 700
YOYO 82 posts ante 700
As2lajungle posts ante 700
kalou 500 posts ante 700
nanass25440 posts small blind 3000
P1xel7 posts big blind 6000
Dealt to P1xel7 [9s 4d]
*** PRE-FLOP *** 
kalou 500 folds
YOYO 82 folds
As2lajungle folds
nanass25440 folds
P1xel7 collected 12500 from pot
*** SUMMARY ***
Total pot 12500 | No rake
Seat 4: P1xel7 (big blind) won 12500


Winamax Poker - Tournament "Kill The Fish" buyIn: 0.45€ + 0.05€ level: 20 - HandId: #3040732885884600328-165-1699731700 - Holdem no limit (700/3000/6000) - 2023/11/11 19:41:40 UTC
Table: 'Kill The Fish(707975795)#007' 6-max (real money) Seat #3 is the button
Seat 1: YOYO 82 (146285, 1.04€ bounty)
Seat 2: As2lajungle (246968, 0.74€ bounty)
Seat 3: nanass25440 (194517, 0.57€ bounty)
Seat 4: P1xel7 (149932, 1.26€ bounty)
Seat 6: kalou 500 (651252, 2.38€ bounty)
*** ANTE/BLINDS ***
P1xel7 posts ante 700
kalou 500 posts ante 700
YOYO 82 posts ante 700
As2lajungle posts ante 700
nanass25440 posts ante 700
P1xel7 posts small blind 3000
kalou 500 posts big blind 6000
Dealt to P1xel7 [Qs Kd]
*** PRE-FLOP *** 
YOYO 82 folds
As2lajungle folds
nanass25440 folds
P1xel7 raises 7200 to 13200
kalou 500 folds
P1xel7 collected 22700 from pot
*** SUMMARY ***
Total pot 22700 | No rake
Seat 4: P1xel7 (small blind) won 22700


Winamax Poker - Tournament "Kill The Fish" buyIn: 0.45€ + 0.05€ level: 20 - HandId: #3040732885884600328-166-1699731714 - Holdem no limit (700/3000/6000) - 2023/11/11 19:41:54 UTC
Table: 'Kill The Fish(707975795)#007' 6-max (real money) Seat #4 is the button
Seat 1: YOYO 82 (145585, 1.04€ bounty)
Seat 2: As2lajungle (246268, 0.74€ bounty)
Seat 3: nanass25440 (193817, 0.57€ bounty)
Seat 4: P1xel7 (158732, 1.26€ bounty)
Seat 6: kalou 500 (644552, 2.38€ bounty)
*** ANTE/BLINDS ***
kalou 500 posts ante 700
YOYO 82 posts ante 700
As2lajungle posts ante 700
nanass25440 posts ante 700
P1xel7 posts ante 700
kalou 500 posts small blind 3000
YOYO 82 posts big blind 6000
Dealt to P1xel7 [Kd 8c]
*** PRE-FLOP *** 
As2lajungle folds
nanass25440 folds
P1xel7 folds
kalou 500 calls 3000
YOYO 82 checks
*** FLOP *** [Kh 2s 3c]
kalou 500 checks
YOYO 82 checks
*** TURN *** [Kh 2s 3c][9d]
kalou 500 checks
YOYO 82 checks
*** RIVER *** [Kh 2s 3c 9d][4d]
kalou 500 checks
YOYO 82 checks
*** SHOW DOWN ***
kalou 500 shows [Ac 8h] (High card : Ace)
YOYO 82 shows [Qh 9c] (One pair : 9)
YOYO 82 collected 15500 from pot
*** SUMMARY ***
Total pot 15500 | No rake
Board: [Kh 2s 3c 9d 4d]
Seat 1: YOYO 82 (big blind) showed [Qh 9c] and won 15500 with One pair : 9
Seat 6: kalou 500 (small blind) showed [Ac 8h] and lost with High card : Ace


Winamax Poker - Tournament "Kill The Fish" buyIn: 0.45€ + 0.05€ level: 21 - HandId: #3040732885884600328-167-1699731792 - Holdem no limit (800/3500/7000) - 2023/11/11 19:43:12 UTC
Table: 'Kill The Fish(707975795)#007' 6-max (real money) Seat #6 is the button
Seat 1: YOYO 82 (154385, 1.04€ bounty)
Seat 2: As2lajungle (245568, 0.74€ bounty)
Seat 3: nanass25440 (193117, 0.57€ bounty)
Seat 4: P1xel7 (158032, 1.26€ bounty)
Seat 5: HELLoROBY (88982, 0.49€ bounty)
Seat 6: kalou 500 (637852, 2.38€ bounty)
*** ANTE/BLINDS ***
YOYO 82 posts ante 800
As2lajungle posts ante 800
nanass25440 posts ante 800
P1xel7 posts ante 800
HELLoROBY posts ante 800
kalou 500 posts ante 800
YOYO 82 posts small blind 3500
As2lajungle posts big blind 7000
Dealt to P1xel7 [Td Ah]
*** PRE-FLOP *** 
nanass25440 folds
P1xel7 raises 8400 to 15400
HELLoROBY folds
kalou 500 folds
YOYO 82 raises 138185 to 153585 and is all-in
As2lajungle folds
P1xel7 calls 138185
*** FLOP *** [6h 5c 9c]
*** TURN *** [6h 5c 9c][Th]
*** RIVER *** [6h 5c 9c Th][Kd]
*** SHOW DOWN ***
YOYO 82 shows [Jh Ad] (High card : Ace)
P1xel7 shows [Td Ah] (One pair : Tens)
P1xel7 collected 318970 from pot
*** SUMMARY ***
Total pot 318970 | No rake
Board: [6h 5c 9c Th Kd]
Seat 1: YOYO 82 (small blind) showed [Jh Ad] and lost with High card : Ace
Seat 4: P1xel7 showed [Td Ah] and won 318970 with One pair : Tens


Winamax Poker - Tournament "Kill The Fish" buyIn: 0.45€ + 0.05€ level: 21 - HandId: #3040732885884600328-168-1699731831 - Holdem no limit (800/3500/7000) - 2023/11/11 19:43:51 UTC
Table: 'Kill The Fish(707975795)#007' 6-max (real money) Seat #1 is the button
Seat 2: As2lajungle (237768, 0.74€ bounty)
Seat 3: nanass25440 (192317, 0.57€ bounty)
Seat 4: P1xel7 (322617, 1.78€ bounty)
Seat 5: HELLoROBY (88182, 0.49€ bounty)
Seat 6: kalou 500 (637052, 2.38€ bounty)
*** ANTE/BLINDS ***
As2lajungle posts ante 800
nanass25440 posts ante 800
P1xel7 posts ante 800
HELLoROBY posts ante 800
kalou 500 posts ante 800
As2lajungle posts small blind 3500
nanass25440 posts big blind 7000
Dealt to P1xel7 [6d 4h]
*** PRE-FLOP *** 
P1xel7 folds
HELLoROBY folds
kalou 500 folds
As2lajungle calls 3500
nanass25440 raises 184517 to 191517 and is all-in
As2lajungle folds
nanass25440 collected 202517 from pot
*** SUMMARY ***
Total pot 202517 | No rake
Seat 3: nanass25440 (big blind) won 202517


Winamax Poker - Tournament "Kill The Fish" buyIn: 0.45€ + 0.05€ level: 21 - HandId: #3040732885884600328-169-1699731870 - Holdem no limit (800/3500/7000) - 2023/11/11 19:44:30 UTC
Table: 'Kill The Fish(707975795)#007' 6-max (real money) Seat #2 is the button
Seat 2: As2lajungle (229968, 0.74€ bounty)
Seat 3: nanass25440 (202517, 0.57€ bounty)
Seat 4: P1xel7 (321817, 1.78€ bounty)
Seat 5: HELLoROBY (87382, 0.49€ bounty)
Seat 6: kalou 500 (636252, 2.38€ bounty)
*** ANTE/BLINDS ***
nanass25440 posts ante 800
P1xel7 posts ante 800
As2lajungle posts ante 800
HELLoROBY posts ante 800
kalou 500 posts ante 800
nanass25440 posts small blind 3500
P1xel7 posts big blind 7000
Dealt to P1xel7 [Kd 8s]
*** PRE-FLOP *** 
HELLoROBY folds
kalou 500 folds
As2lajungle raises 8400 to 15400
nanass25440 folds
P1xel7 calls 8400
*** FLOP *** [6d Tc Jh]
P1xel7 checks
As2lajungle bets 19150
P1xel7 folds
As2lajungle collected 57450 from pot
*** SUMMARY ***
Total pot 57450 | No rake
Board: [6d Tc Jh]
Seat 2: As2lajungle (button) won 57450


Winamax Poker - Tournament "Kill The Fish" buyIn: 0.45€ + 0.05€ level: 21 - HandId: #3040732885884600328-170-1699731915 - Holdem no limit (800/3500/7000) - 2023/11/11 19:45:15 UTC
Table: 'Kill The Fish(707975795)#007' 6-max (real money) Seat #3 is the button
Seat 2: As2lajungle (252068, 0.74€ bounty)
Seat 3: nanass25440 (198217, 0.57€ bounty)
Seat 4: P1xel7 (305617, 1.78€ bounty)
Seat 5: HELLoROBY (86582, 0.49€ bounty)
Seat 6: kalou 500 (635452, 2.38€ bounty)
*** ANTE/BLINDS ***
P1xel7 posts ante 800
HELLoROBY posts ante 800
As2lajungle posts ante 800
nanass25440 posts ante 800
kalou 500 posts ante 800
P1xel7 posts small blind 3500
HELLoROBY posts big blind 7000
Dealt to P1xel7 [2d 3s]
*** PRE-FLOP *** 
kalou 500 folds
As2lajungle folds
nanass25440 folds
P1xel7 folds
HELLoROBY collected 14500 from pot
*** SUMMARY ***
Total pot 14500 | No rake
Seat 5: HELLoROBY (big blind) won 14500


Winamax Poker - Tournament "Kill The Fish" buyIn: 0.45€ + 0.05€ level: 21 - HandId: #3040732885884600328-171-1699731929 - Holdem no limit (800/3500/7000) - 2023/11/11 19:45:29 UTC
Table: 'Kill The Fish(707975795)#007' 6-max (real money) Seat #4 is the button
Seat 2: As2lajungle (251268, 0.74€ bounty)
Seat 3: nanass25440 (197417, 0.57€ bounty)
Seat 4: P1xel7 (301317, 1.78€ bounty)
Seat 5: HELLoROBY (93282, 0.49€ bounty)
Seat 6: kalou 500 (634652, 2.38€ bounty)
*** ANTE/BLINDS ***
HELLoROBY posts ante 800
kalou 500 posts ante 800
As2lajungle posts ante 800
nanass25440 posts ante 800
P1xel7 posts ante 800
HELLoROBY posts small blind 3500
kalou 500 posts big blind 7000
Dealt to P1xel7 [6d 9c]
*** PRE-FLOP *** 
As2lajungle folds
nanass25440 folds
P1xel7 folds
HELLoROBY raises 85482 to 92482 and is all-in
kalou 500 folds
HELLoROBY collected 103482 from pot
*** SUMMARY ***
Total pot 103482 | No rake
Seat 5: HELLoROBY (small blind) won 103482


Winamax Poker - Tournament "Kill The Fish" buyIn: 0.45€ + 0.05€ level: 21 - HandId: #3040732885884600328-172-1699731946 - Holdem no limit (800/3500/7000) - 2023/11/11 19:45:46 UTC
Table: 'Kill The Fish(707975795)#007' 6-max (real money) Seat #5 is the button
Seat 2: As2lajungle (250468, 0.74€ bounty)
Seat 3: nanass25440 (196617, 0.57€ bounty)
Seat 4: P1xel7 (300517, 1.78€ bounty)
Seat 5: HELLoROBY (103482, 0.49€ bounty)
Seat 6: kalou 500 (626852, 2.38€ bounty)
*** ANTE/BLINDS ***
kalou 500 posts ante 800
As2lajungle posts ante 800
nanass25440 posts ante 800
P1xel7 posts ante 800
HELLoROBY posts ante 800
kalou 500 posts small blind 3500
As2lajungle posts big blind 7000
Dealt to P1xel7 [8h 5d]
*** PRE-FLOP *** 
nanass25440 folds
P1xel7 folds
HELLoROBY folds
kalou 500 calls 3500
As2lajungle checks
*** FLOP *** [Qh 2c 4d]
kalou 500 checks
As2lajungle bets 11700
kalou 500 folds
As2lajungle collected 29700 from pot
*** SUMMARY ***
Total pot 29700 | No rake
Board: [Qh 2c 4d]
Seat 2: As2lajungle (big blind) won 29700


Winamax Poker - Tournament "Kill The Fish" buyIn: 0.45€ + 0.05€ level: 21 - HandId: #3040732885884600328-173-1699731973 - Holdem no limit (800/3500/7000) - 2023/11/11 19:46:13 UTC
Table: 'Kill The Fish(707975795)#007' 6-max (real money) Seat #6 is the button
Seat 2: As2lajungle (260668, 0.74€ bounty)
Seat 3: nanass25440 (195817, 0.57€ bounty)
Seat 4: P1xel7 (299717, 1.78€ bounty)
Seat 5: HELLoROBY (102682, 0.49€ bounty)
Seat 6: kalou 500 (619052, 2.38€ bounty)
*** ANTE/BLINDS ***
As2lajungle posts ante 800
nanass25440 posts ante 800
P1xel7 posts ante 800
HELLoROBY posts ante 800
kalou 500 posts ante 800
As2lajungle posts small blind 3500
nanass25440 posts big blind 7000
Dealt to P1xel7 [Tc Kd]
*** PRE-FLOP *** 
P1xel7 raises 10500 to 17500
HELLoROBY folds
kalou 500 raises 49500 to 67000
As2lajungle folds
nanass25440 folds
P1xel7 folds
kalou 500 collected 99000 from pot
*** SUMMARY ***
Total pot 99000 | No rake
Seat 6: kalou 500 (button) won 99000


Winamax Poker - Tournament "Kill The Fish" buyIn: 0.45€ + 0.05€ level: 21 - HandId: #3040732885884600328-174-1699732002 - Holdem no limit (800/3500/7000) - 2023/11/11 19:46:42 UTC
Table: 'Kill The Fish(707975795)#007' 6-max (real money) Seat #2 is the button
Seat 2: As2lajungle (256368, 0.74€ bounty)
Seat 3: nanass25440 (188017, 0.57€ bounty)
Seat 4: P1xel7 (281417, 1.78€ bounty)
Seat 5: HELLoROBY (101882, 0.49€ bounty)
Seat 6: kalou 500 (650252, 2.38€ bounty)
*** ANTE/BLINDS ***
nanass25440 posts ante 800
P1xel7 posts ante 800
As2lajungle posts ante 800
HELLoROBY posts ante 800
kalou 500 posts ante 800
nanass25440 posts small blind 3500
P1xel7 posts big blind 7000
Dealt to P1xel7 [As 8c]
*** PRE-FLOP *** 
HELLoROBY folds
kalou 500 folds
As2lajungle folds
nanass25440 folds
P1xel7 collected 14500 from pot
*** SUMMARY ***
Total pot 14500 | No rake
Seat 4: P1xel7 (big blind) won 14500


Winamax Poker - Tournament "Kill The Fish" buyIn: 0.45€ + 0.05€ level: 22 - HandId: #3040732885884600328-175-1699732030 - Holdem no limit (1000/4000/8000) - 2023/11/11 19:47:10 UTC
Table: 'Kill The Fish(707975795)#007' 6-max (real money) Seat #3 is the button
Seat 2: As2lajungle (255568, 0.74€ bounty)
Seat 3: nanass25440 (183717, 0.57€ bounty)
Seat 4: P1xel7 (288117, 1.78€ bounty)
Seat 5: HELLoROBY (101082, 0.49€ bounty)
Seat 6: kalou 500 (649452, 2.38€ bounty)
*** ANTE/BLINDS ***
P1xel7 posts ante 1000
HELLoROBY posts ante 1000
As2lajungle posts ante 1000
nanass25440 posts ante 1000
kalou 500 posts ante 1000
P1xel7 posts small blind 4000
HELLoROBY posts big blind 8000
Dealt to P1xel7 [Qs 7d]
*** PRE-FLOP *** 
kalou 500 folds
As2lajungle folds
nanass25440 folds
P1xel7 raises 16000 to 24000
HELLoROBY folds
P1xel7 collected 37000 from pot
*** SUMMARY ***
Total pot 37000 | No rake
Seat 4: P1xel7 (small blind) won 37000


Winamax Poker - Tournament "Kill The Fish" buyIn: 0.45€ + 0.05€ level: 22 - HandId: #3040732885884600328-176-1699732054 - Holdem no limit (1000/4000/8000) - 2023/11/11 19:47:34 UTC
Table: 'Kill The Fish(707975795)#007' 6-max (real money) Seat #4 is the button
Seat 1: ChefFabrice (129118, 0.55€ bounty)
Seat 2: As2lajungle (254568, 0.74€ bounty)
Seat 3: nanass25440 (182717, 0.57€ bounty)
Seat 4: P1xel7 (300117, 1.78€ bounty)
Seat 5: HELLoROBY (92082, 0.49€ bounty)
Seat 6: kalou 500 (648452, 2.38€ bounty)
*** ANTE/BLINDS ***
HELLoROBY posts ante 1000
kalou 500 posts ante 1000
ChefFabrice posts ante 1000
As2lajungle posts ante 1000
nanass25440 posts ante 1000
P1xel7 posts ante 1000
HELLoROBY posts small blind 4000
kalou 500 posts big blind 8000
Dealt to P1xel7 [Tc 7s]
*** PRE-FLOP *** 
ChefFabrice folds
As2lajungle folds
nanass25440 folds
P1xel7 folds
HELLoROBY calls 4000
kalou 500 raises 22000 to 30000
HELLoROBY folds
kalou 500 collected 44000 from pot
*** SUMMARY ***
Total pot 44000 | No rake
Seat 6: kalou 500 (big blind) won 44000


Winamax Poker - Tournament "Kill The Fish" buyIn: 0.45€ + 0.05€ level: 22 - HandId: #3040732885884600328-177-1699732080 - Holdem no limit (1000/4000/8000) - 2023/11/11 19:48:00 UTC
Table: 'Kill The Fish(707975795)#007' 6-max (real money) Seat #5 is the button
Seat 1: ChefFabrice (128118, 0.55€ bounty)
Seat 2: As2lajungle (253568, 0.74€ bounty)
Seat 3: nanass25440 (181717, 0.57€ bounty)
Seat 4: P1xel7 (299117, 1.78€ bounty)
Seat 5: HELLoROBY (83082, 0.49€ bounty)
Seat 6: kalou 500 (661452, 2.38€ bounty)
*** ANTE/BLINDS ***
kalou 500 posts ante 1000
ChefFabrice posts ante 1000
As2lajungle posts ante 1000
nanass25440 posts ante 1000
P1xel7 posts ante 1000
HELLoROBY posts ante 1000
kalou 500 posts small blind 4000
ChefFabrice posts big blind 8000
Dealt to P1xel7 [8s Qs]
*** PRE-FLOP *** 
As2lajungle folds
nanass25440 folds
P1xel7 raises 9600 to 17600
HELLoROBY folds
kalou 500 folds
ChefFabrice folds
P1xel7 collected 35600 from pot
*** SUMMARY ***
Total pot 35600 | No rake
Seat 4: P1xel7 won 35600


Winamax Poker - Tournament "Kill The Fish" buyIn: 0.45€ + 0.05€ level: 22 - HandId: #3040732885884600328-178-1699732105 - Holdem no limit (1000/4000/8000) - 2023/11/11 19:48:25 UTC
Table: 'Kill The Fish(707975795)#007' 6-max (real money) Seat #6 is the button
Seat 1: ChefFabrice (119118, 0.55€ bounty)
Seat 2: As2lajungle (252568, 0.74€ bounty)
Seat 3: nanass25440 (180717, 0.57€ bounty)
Seat 4: P1xel7 (316117, 1.78€ bounty)
Seat 5: HELLoROBY (82082, 0.49€ bounty)
Seat 6: kalou 500 (656452, 2.38€ bounty)
*** ANTE/BLINDS ***
ChefFabrice posts ante 1000
As2lajungle posts ante 1000
nanass25440 posts ante 1000
P1xel7 posts ante 1000
HELLoROBY posts ante 1000
kalou 500 posts ante 1000
ChefFabrice posts small blind 4000
As2lajungle posts big blind 8000
Dealt to P1xel7 [5c Ac]
*** PRE-FLOP *** 
nanass25440 folds
P1xel7 raises 9600 to 17600
HELLoROBY folds
kalou 500 folds
ChefFabrice folds
As2lajungle calls 9600
*** FLOP *** [5s Kc Js]
As2lajungle checks
P1xel7 checks
*** TURN *** [5s Kc Js][Jc]
As2lajungle checks
P1xel7 bets 22600
As2lajungle calls 22600
*** RIVER *** [5s Kc Js Jc][6d]
As2lajungle checks
P1xel7 checks
*** SHOW DOWN ***
As2lajungle shows [7s As] (One pair : Jacks)
P1xel7 shows [5c Ac] (Two pairs : Jacks and 5)
P1xel7 collected 90400 from pot
*** SUMMARY ***
Total pot 90400 | No rake
Board: [5s Kc Js Jc 6d]
Seat 2: As2lajungle (big blind) showed [7s As] and lost with One pair : Jacks
Seat 4: P1xel7 showed [5c Ac] and won 90400 with Two pairs : Jacks and 5


Winamax Poker - Tournament "Kill The Fish" buyIn: 0.45€ + 0.05€ level: 22 - HandId: #3040732885884600328-179-1699732155 - Holdem no limit (1000/4000/8000) - 2023/11/11 19:49:15 UTC
Table: 'Kill The Fish(707975795)#007' 6-max (real money) Seat #1 is the button
Seat 1: ChefFabrice (114118, 0.55€ bounty)
Seat 2: As2lajungle (211368, 0.74€ bounty)
Seat 3: nanass25440 (179717, 0.57€ bounty)
Seat 4: P1xel7 (365317, 1.78€ bounty)
Seat 5: HELLoROBY (81082, 0.49€ bounty)
Seat 6: kalou 500 (655452, 2.38€ bounty)
*** ANTE/BLINDS ***
As2lajungle posts ante 1000
nanass25440 posts ante 1000
ChefFabrice posts ante 1000
P1xel7 posts ante 1000
HELLoROBY posts ante 1000
kalou 500 posts ante 1000
As2lajungle posts small blind 4000
nanass25440 posts big blind 8000
Dealt to P1xel7 [As 7s]
*** PRE-FLOP *** 
P1xel7 folds
HELLoROBY folds
kalou 500 calls 8000
ChefFabrice folds
As2lajungle folds
nanass25440 raises 170717 to 178717 and is all-in
kalou 500 folds
nanass25440 collected 196717 from pot
*** SUMMARY ***
Total pot 196717 | No rake
Seat 3: nanass25440 (big blind) won 196717


Winamax Poker - Tournament "Kill The Fish" buyIn: 0.45€ + 0.05€ level: 22 - HandId: #3040732885884600328-180-1699732180 - Holdem no limit (1000/4000/8000) - 2023/11/11 19:49:40 UTC
Table: 'Kill The Fish(707975795)#007' 6-max (real money) Seat #2 is the button
Seat 1: ChefFabrice (113118, 0.55€ bounty)
Seat 2: As2lajungle (206368, 0.74€ bounty)
Seat 3: nanass25440 (196717, 0.57€ bounty)
Seat 4: P1xel7 (364317, 1.78€ bounty)
Seat 5: HELLoROBY (80082, 0.49€ bounty)
Seat 6: kalou 500 (646452, 2.38€ bounty)
*** ANTE/BLINDS ***
nanass25440 posts ante 1000
P1xel7 posts ante 1000
ChefFabrice posts ante 1000
As2lajungle posts ante 1000
HELLoROBY posts ante 1000
kalou 500 posts ante 1000
nanass25440 posts small blind 4000
P1xel7 posts big blind 8000
Dealt to P1xel7 [2d 7d]
*** PRE-FLOP *** 
HELLoROBY folds
kalou 500 folds
ChefFabrice folds
As2lajungle folds
nanass25440 folds
P1xel7 collected 18000 from pot
*** SUMMARY ***
Total pot 18000 | No rake
Seat 4: P1xel7 (big blind) won 18000


Winamax Poker - Tournament "Kill The Fish" buyIn: 0.45€ + 0.05€ level: 22 - HandId: #3040732885884600328-181-1699732188 - Holdem no limit (1000/4000/8000) - 2023/11/11 19:49:48 UTC
Table: 'Kill The Fish(707975795)#007' 6-max (real money) Seat #3 is the button
Seat 1: ChefFabrice (112118, 0.55€ bounty)
Seat 2: As2lajungle (205368, 0.74€ bounty)
Seat 3: nanass25440 (191717, 0.57€ bounty)
Seat 4: P1xel7 (373317, 1.78€ bounty)
Seat 5: HELLoROBY (79082, 0.49€ bounty)
Seat 6: kalou 500 (645452, 2.38€ bounty)
*** ANTE/BLINDS ***
P1xel7 posts ante 1000
HELLoROBY posts ante 1000
ChefFabrice posts ante 1000
As2lajungle posts ante 1000
nanass25440 posts ante 1000
kalou 500 posts ante 1000
P1xel7 posts small blind 4000
HELLoROBY posts big blind 8000
Dealt to P1xel7 [9d Td]
*** PRE-FLOP *** 
kalou 500 folds
ChefFabrice folds
As2lajungle folds
nanass25440 folds
P1xel7 raises 364317 to 372317 and is all-in
HELLoROBY folds
P1xel7 collected 386317 from pot
*** SUMMARY ***
Total pot 386317 | No rake
Seat 4: P1xel7 (small blind) won 386317


Winamax Poker - Tournament "Kill The Fish" buyIn: 0.45€ + 0.05€ level: 22 - HandId: #3040732885884600328-182-1699732225 - Holdem no limit (1000/4000/8000) - 2023/11/11 19:50:25 UTC
Table: 'Kill The Fish(707975795)#007' 6-max (real money) Seat #4 is the button
Seat 1: ChefFabrice (111118, 0.55€ bounty)
Seat 2: As2lajungle (204368, 0.74€ bounty)
Seat 3: nanass25440 (190717, 0.57€ bounty)
Seat 4: P1xel7 (386317, 1.78€ bounty)
Seat 5: HELLoROBY (70082, 0.49€ bounty)
Seat 6: kalou 500 (644452, 2.38€ bounty)
*** ANTE/BLINDS ***
HELLoROBY posts ante 1000
kalou 500 posts ante 1000
ChefFabrice posts ante 1000
As2lajungle posts ante 1000
nanass25440 posts ante 1000
P1xel7 posts ante 1000
HELLoROBY posts small blind 4000
kalou 500 posts big blind 8000
Dealt to P1xel7 [9h 3h]
*** PRE-FLOP *** 
ChefFabrice folds
As2lajungle raises 195368 to 203368 and is all-in
nanass25440 folds
P1xel7 folds
HELLoROBY folds
kalou 500 folds
As2lajungle collected 221368 from pot
*** SUMMARY ***
Total pot 221368 | No rake
Seat 2: As2lajungle won 221368


Winamax Poker - Tournament "Kill The Fish" buyIn: 0.45€ + 0.05€ level: 22 - HandId: #3040732885884600328-183-1699732239 - Holdem no limit (1000/4000/8000) - 2023/11/11 19:50:39 UTC
Table: 'Kill The Fish(707975795)#007' 6-max (real money) Seat #5 is the button
Seat 1: ChefFabrice (110118, 0.55€ bounty)
Seat 2: As2lajungle (221368, 0.74€ bounty)
Seat 3: nanass25440 (189717, 0.57€ bounty)
Seat 4: P1xel7 (385317, 1.78€ bounty)
Seat 5: HELLoROBY (65082, 0.49€ bounty)
Seat 6: kalou 500 (635452, 2.38€ bounty)
*** ANTE/BLINDS ***
kalou 500 posts ante 1000
ChefFabrice posts ante 1000
As2lajungle posts ante 1000
nanass25440 posts ante 1000
P1xel7 posts ante 1000
HELLoROBY posts ante 1000
kalou 500 posts small blind 4000
ChefFabrice posts big blind 8000
Dealt to P1xel7 [7d Ac]
*** PRE-FLOP *** 
As2lajungle raises 212368 to 220368 and is all-in
nanass25440 folds
P1xel7 folds
HELLoROBY folds
kalou 500 folds
ChefFabrice folds
As2lajungle collected 238368 from pot
*** SUMMARY ***
Total pot 238368 | No rake
Seat 2: As2lajungle won 238368


Winamax Poker - Tournament "Kill The Fish" buyIn: 0.45€ + 0.05€ level: 22 - HandId: #3040732885884600328-184-1699732252 - Holdem no limit (1000/4000/8000) - 2023/11/11 19:50:52 UTC
Table: 'Kill The Fish(707975795)#007' 6-max (real money) Seat #6 is the button
Seat 1: ChefFabrice (101118, 0.55€ bounty)
Seat 2: As2lajungle (238368, 0.74€ bounty)
Seat 4: P1xel7 (384317, 1.78€ bounty)
Seat 5: HELLoROBY (64082, 0.49€ bounty)
Seat 6: kalou 500 (630452, 2.38€ bounty)
*** ANTE/BLINDS ***
ChefFabrice posts ante 1000
As2lajungle posts ante 1000
P1xel7 posts ante 1000
HELLoROBY posts ante 1000
kalou 500 posts ante 1000
ChefFabrice posts small blind 4000
As2lajungle posts big blind 8000
Dealt to P1xel7 [5s 7h]
*** PRE-FLOP *** 
P1xel7 folds
HELLoROBY folds
kalou 500 calls 8000
ChefFabrice folds
As2lajungle checks
*** FLOP *** [5c Td Jc]
As2lajungle checks
kalou 500 bets 25000
As2lajungle folds
kalou 500 collected 50000 from pot
*** SUMMARY ***
Total pot 50000 | No rake
Board: [5c Td Jc]
Seat 6: kalou 500 (button) won 50000


Winamax Poker - Tournament "Kill The Fish" buyIn: 0.45€ + 0.05€ level: 22 - HandId: #3040732885884600328-185-1699732271 - Holdem no limit (1000/4000/8000) - 2023/11/11 19:51:11 UTC
Table: 'Kill The Fish(707975795)#007' 6-max (real money) Seat #1 is the button
Seat 1: ChefFabrice (96118, 0.55€ bounty)
Seat 2: As2lajungle (229368, 0.74€ bounty)
Seat 4: P1xel7 (383317, 1.78€ bounty)
Seat 5: HELLoROBY (63082, 0.49€ bounty)
Seat 6: kalou 500 (646452, 2.38€ bounty)
*** ANTE/BLINDS ***
As2lajungle posts ante 1000
P1xel7 posts ante 1000
ChefFabrice posts ante 1000
HELLoROBY posts ante 1000
kalou 500 posts ante 1000
As2lajungle posts small blind 4000
P1xel7 posts big blind 8000
Dealt to P1xel7 [Ac Qd]
*** PRE-FLOP *** 
HELLoROBY folds
kalou 500 folds
ChefFabrice folds
As2lajungle folds
P1xel7 collected 17000 from pot
*** SUMMARY ***
Total pot 17000 | No rake
Seat 4: P1xel7 (big blind) won 17000


Winamax Poker - Tournament "Kill The Fish" buyIn: 0.45€ + 0.05€ level: 22 - HandId: #3040732885884600328-186-1699732279 - Holdem no limit (1000/4000/8000) - 2023/11/11 19:51:19 UTC
Table: 'Kill The Fish(707975795)#007' 6-max (real money) Seat #2 is the button
Seat 1: ChefFabrice (95118, 0.55€ bounty)
Seat 2: As2lajungle (224368, 0.74€ bounty)
Seat 4: P1xel7 (391317, 1.78€ bounty)
Seat 5: HELLoROBY (62082, 0.49€ bounty)
Seat 6: kalou 500 (645452, 2.38€ bounty)
*** ANTE/BLINDS ***
P1xel7 posts ante 1000
HELLoROBY posts ante 1000
ChefFabrice posts ante 1000
As2lajungle posts ante 1000
kalou 500 posts ante 1000
P1xel7 posts small blind 4000
HELLoROBY posts big blind 8000
Dealt to P1xel7 [3d Jc]
*** PRE-FLOP *** 
kalou 500 folds
ChefFabrice folds
As2lajungle folds
P1xel7 raises 16000 to 24000
HELLoROBY folds
P1xel7 collected 37000 from pot
*** SUMMARY ***
Total pot 37000 | No rake
Seat 4: P1xel7 (small blind) won 37000


Winamax Poker - Tournament "Kill The Fish" buyIn: 0.45€ + 0.05€ level: 22 - HandId: #3040732885884600328-187-1699732292 - Holdem no limit (1000/4000/8000) - 2023/11/11 19:51:32 UTC
Table: 'Kill The Fish(707975795)#007' 6-max (real money) Seat #4 is the button
Seat 1: ChefFabrice (94118, 0.55€ bounty)
Seat 2: As2lajungle (223368, 0.74€ bounty)
Seat 4: P1xel7 (403317, 1.78€ bounty)
Seat 5: HELLoROBY (53082, 0.49€ bounty)
Seat 6: kalou 500 (644452, 2.38€ bounty)
*** ANTE/BLINDS ***
HELLoROBY posts ante 1000
kalou 500 posts ante 1000
ChefFabrice posts ante 1000
As2lajungle posts ante 1000
P1xel7 posts ante 1000
HELLoROBY posts small blind 4000
kalou 500 posts big blind 8000
Dealt to P1xel7 [3s Th]
*** PRE-FLOP *** 
ChefFabrice folds
As2lajungle folds
P1xel7 folds
HELLoROBY folds
kalou 500 collected 17000 from pot
*** SUMMARY ***
Total pot 17000 | No rake
Seat 6: kalou 500 (big blind) won 17000


Winamax Poker - Tournament "Kill The Fish" buyIn: 0.45€ + 0.05€ level: 22 - HandId: #3040732885884600328-188-1699732302 - Holdem no limit (1000/4000/8000) - 2023/11/11 19:51:42 UTC
Table: 'Kill The Fish(707975795)#007' 6-max (real money) Seat #5 is the button
Seat 1: ChefFabrice (93118, 0.55€ bounty)
Seat 2: As2lajungle (222368, 0.74€ bounty)
Seat 3: Fleur68170 (148320, 0.98€ bounty)
Seat 4: P1xel7 (402317, 1.78€ bounty)
Seat 5: HELLoROBY (48082, 0.49€ bounty)
Seat 6: kalou 500 (652452, 2.38€ bounty)
*** ANTE/BLINDS ***
kalou 500 posts ante 1000
ChefFabrice posts ante 1000
As2lajungle posts ante 1000
Fleur68170 posts ante 1000
P1xel7 posts ante 1000
HELLoROBY posts ante 1000
kalou 500 posts small blind 4000
ChefFabrice posts big blind 8000
Dealt to P1xel7 [5d 6c]
*** PRE-FLOP *** 
As2lajungle folds
Fleur68170 folds
P1xel7 folds
HELLoROBY folds
kalou 500 raises 8000 to 16000
ChefFabrice folds
kalou 500 collected 30000 from pot
*** SUMMARY ***
Total pot 30000 | No rake
Seat 6: kalou 500 (small blind) won 30000


Winamax Poker - Tournament "Kill The Fish" buyIn: 0.45€ + 0.05€ level: 22 - HandId: #3040732885884600328-189-1699732319 - Holdem no limit (1000/4000/8000) - 2023/11/11 19:51:59 UTC
Table: 'Kill The Fish(707975795)#007' 6-max (real money) Seat #6 is the button
Seat 1: ChefFabrice (84118, 0.55€ bounty)
Seat 2: As2lajungle (221368, 0.74€ bounty)
Seat 3: Fleur68170 (147320, 0.98€ bounty)
Seat 4: P1xel7 (401317, 1.78€ bounty)
Seat 5: HELLoROBY (47082, 0.49€ bounty)
Seat 6: kalou 500 (665452, 2.38€ bounty)
*** ANTE/BLINDS ***
ChefFabrice posts ante 1000
As2lajungle posts ante 1000
Fleur68170 posts ante 1000
P1xel7 posts ante 1000
HELLoROBY posts ante 1000
kalou 500 posts ante 1000
ChefFabrice posts small blind 4000
As2lajungle posts big blind 8000
Dealt to P1xel7 [Jh 2h]
*** PRE-FLOP *** 
Fleur68170 folds
P1xel7 folds
HELLoROBY folds
kalou 500 folds
ChefFabrice folds
As2lajungle collected 18000 from pot
*** SUMMARY ***
Total pot 18000 | No rake
Seat 2: As2lajungle (big blind) won 18000


Winamax Poker - Tournament "Kill The Fish" buyIn: 0.45€ + 0.05€ level: 23 - HandId: #3040732885884600328-190-1699732331 - Holdem no limit (1200/5000/10000) - 2023/11/11 19:52:11 UTC
Table: 'Kill The Fish(707975795)#007' 6-max (real money) Seat #1 is the button
Seat 1: ChefFabrice (79118, 0.55€ bounty)
Seat 2: As2lajungle (230368, 0.74€ bounty)
Seat 3: Fleur68170 (146320, 0.98€ bounty)
Seat 4: P1xel7 (400317, 1.78€ bounty)
Seat 5: HELLoROBY (46082, 0.49€ bounty)
Seat 6: kalou 500 (664452, 2.38€ bounty)
*** ANTE/BLINDS ***
As2lajungle posts ante 1200
Fleur68170 posts ante 1200
ChefFabrice posts ante 1200
P1xel7 posts ante 1200
HELLoROBY posts ante 1200
kalou 500 posts ante 1200
As2lajungle posts small blind 5000
Fleur68170 posts big blind 10000
Dealt to P1xel7 [6d 9h]
*** PRE-FLOP *** 
P1xel7 folds
HELLoROBY raises 34882 to 44882 and is all-in
kalou 500 folds
ChefFabrice folds
As2lajungle folds
Fleur68170 folds
HELLoROBY collected 67082 from pot
*** SUMMARY ***
Total pot 67082 | No rake
Seat 5: HELLoROBY won 67082


Winamax Poker - Tournament "Kill The Fish" buyIn: 0.45€ + 0.05€ level: 23 - HandId: #3040732885884600328-191-1699732356 - Holdem no limit (1200/5000/10000) - 2023/11/11 19:52:36 UTC
Table: 'Kill The Fish(707975795)#007' 6-max (real money) Seat #2 is the button
Seat 1: ChefFabrice (77918, 0.55€ bounty)
Seat 2: As2lajungle (224168, 0.74€ bounty)
Seat 3: Fleur68170 (135120, 0.98€ bounty)
Seat 4: P1xel7 (399117, 1.78€ bounty)
Seat 5: HELLoROBY (67082, 0.49€ bounty)
Seat 6: kalou 500 (663252, 2.38€ bounty)
*** ANTE/BLINDS ***
Fleur68170 posts ante 1200
P1xel7 posts ante 1200
ChefFabrice posts ante 1200
As2lajungle posts ante 1200
HELLoROBY posts ante 1200
kalou 500 posts ante 1200
Fleur68170 posts small blind 5000
P1xel7 posts big blind 10000
Dealt to P1xel7 [9c 5c]
*** PRE-FLOP *** 
HELLoROBY folds
kalou 500 folds
ChefFabrice folds
As2lajungle folds
Fleur68170 folds
P1xel7 collected 22200 from pot
*** SUMMARY ***
Total pot 22200 | No rake
Seat 4: P1xel7 (big blind) won 22200


Winamax Poker - Tournament "Kill The Fish" buyIn: 0.45€ + 0.05€ level: 23 - HandId: #3040732885884600328-192-1699732368 - Holdem no limit (1200/5000/10000) - 2023/11/11 19:52:48 UTC
Table: 'Kill The Fish(707975795)#007' 6-max (real money) Seat #3 is the button
Seat 1: ChefFabrice (76718, 0.55€ bounty)
Seat 2: As2lajungle (222968, 0.74€ bounty)
Seat 3: Fleur68170 (128920, 0.98€ bounty)
Seat 4: P1xel7 (410117, 1.78€ bounty)
Seat 5: HELLoROBY (65882, 0.49€ bounty)
Seat 6: kalou 500 (662052, 2.38€ bounty)
*** ANTE/BLINDS ***
P1xel7 posts ante 1200
HELLoROBY posts ante 1200
ChefFabrice posts ante 1200
As2lajungle posts ante 1200
Fleur68170 posts ante 1200
kalou 500 posts ante 1200
P1xel7 posts small blind 5000
HELLoROBY posts big blind 10000
Dealt to P1xel7 [9c 2h]
*** PRE-FLOP *** 
kalou 500 folds
ChefFabrice folds
As2lajungle folds
Fleur68170 folds
P1xel7 raises 398917 to 408917 and is all-in
HELLoROBY folds
P1xel7 collected 426117 from pot
*** SUMMARY ***
Total pot 426117 | No rake
Seat 4: P1xel7 (small blind) won 426117


Winamax Poker - Tournament "Kill The Fish" buyIn: 0.45€ + 0.05€ level: 23 - HandId: #3040732885884600328-193-1699732384 - Holdem no limit (1200/5000/10000) - 2023/11/11 19:53:04 UTC
Table: 'Kill The Fish(707975795)#007' 6-max (real money) Seat #4 is the button
Seat 1: ChefFabrice (75518, 0.55€ bounty)
Seat 2: As2lajungle (221768, 0.74€ bounty)
Seat 3: Fleur68170 (127720, 0.98€ bounty)
Seat 4: P1xel7 (426117, 1.78€ bounty)
Seat 5: HELLoROBY (54682, 0.49€ bounty)
Seat 6: kalou 500 (660852, 2.38€ bounty)
*** ANTE/BLINDS ***
HELLoROBY posts ante 1200
kalou 500 posts ante 1200
ChefFabrice posts ante 1200
As2lajungle posts ante 1200
Fleur68170 posts ante 1200
P1xel7 posts ante 1200
HELLoROBY posts small blind 5000
kalou 500 posts big blind 10000
Dealt to P1xel7 [3c 6d]
*** PRE-FLOP *** 
ChefFabrice folds
As2lajungle folds
Fleur68170 folds
P1xel7 folds
HELLoROBY raises 43482 to 53482 and is all-in
kalou 500 calls 43482
*** FLOP *** [Ad Jd 2s]
*** TURN *** [Ad Jd 2s][Js]
*** RIVER *** [Ad Jd 2s Js][Qc]
*** SHOW DOWN ***
kalou 500 shows [7h Qh] (Two pairs : Queens and Jacks)
HELLoROBY shows [Ts Jc] (Trips of Jacks)
HELLoROBY collected 114164 from pot
*** SUMMARY ***
Total pot 114164 | No rake
Board: [Ad Jd 2s Js Qc]
Seat 5: HELLoROBY (small blind) showed [Ts Jc] and won 114164 with Trips of Jacks
Seat 6: kalou 500 (big blind) showed [7h Qh] and lost with Two pairs : Queens and Jacks


Winamax Poker - Tournament "Kill The Fish" buyIn: 0.45€ + 0.05€ level: 23 - HandId: #3040732885884600328-194-1699732420 - Holdem no limit (1200/5000/10000) - 2023/11/11 19:53:40 UTC
Table: 'Kill The Fish(707975795)#007' 6-max (real money) Seat #5 is the button
Seat 1: ChefFabrice (74318, 0.55€ bounty)
Seat 2: As2lajungle (220568, 0.74€ bounty)
Seat 3: Fleur68170 (126520, 0.98€ bounty)
Seat 4: P1xel7 (424917, 1.78€ bounty)
Seat 5: HELLoROBY (114164, 0.49€ bounty)
Seat 6: kalou 500 (606170, 2.38€ bounty)
*** ANTE/BLINDS ***
kalou 500 posts ante 1200
ChefFabrice posts ante 1200
As2lajungle posts ante 1200
Fleur68170 posts ante 1200
P1xel7 posts ante 1200
HELLoROBY posts ante 1200
kalou 500 posts small blind 5000
ChefFabrice posts big blind 10000
Dealt to P1xel7 [3h Ks]
*** PRE-FLOP *** 
As2lajungle raises 12000 to 22000
Fleur68170 folds
P1xel7 folds
HELLoROBY folds
kalou 500 calls 17000
ChefFabrice folds
*** FLOP *** [4d 5s Qh]
kalou 500 checks
As2lajungle bets 21420
kalou 500 folds
As2lajungle collected 82620 from pot
*** SUMMARY ***
Total pot 82620 | No rake
Board: [4d 5s Qh]
Seat 2: As2lajungle won 82620


Winamax Poker - Tournament "Kill The Fish" buyIn: 0.45€ + 0.05€ level: 23 - HandId: #3040732885884600323-155-1699732861 - Holdem no limit (1200/5000/10000) - 2023/11/11 20:01:01 UTC
Table: 'Kill The Fish(707975795)#002' 6-max (real money) Seat #2 is the button
Seat 1: P1xel7 (423717, 1.78€ bounty)
Seat 2: Newayy (115803, 0.22€ bounty)
Seat 3: AFlipOnAFlop (150818, 0.33€ bounty)
Seat 4: jadou74 (93120, 0.22€ bounty)
Seat 5: russse888 (487247, 1.97€ bounty)
Seat 6: Camafe (125566, 0.63€ bounty)
*** ANTE/BLINDS ***
AFlipOnAFlop posts ante 1200
jadou74 posts ante 1200
P1xel7 posts ante 1200
Newayy posts ante 1200
russse888 posts ante 1200
Camafe posts ante 1200
AFlipOnAFlop posts small blind 5000
jadou74 posts big blind 10000
Dealt to P1xel7 [7s Qc]
*** PRE-FLOP *** 
russse888 folds
Camafe folds
P1xel7 folds
Newayy raises 104603 to 114603 and is all-in
AFlipOnAFlop folds
jadou74 folds
Newayy collected 136803 from pot
*** SUMMARY ***
Total pot 136803 | No rake
Seat 2: Newayy (button) won 136803


Winamax Poker - Tournament "Kill The Fish" buyIn: 0.45€ + 0.05€ level: 23 - HandId: #3040732885884600323-156-1699732943 - Holdem no limit (1200/5000/10000) - 2023/11/11 20:02:23 UTC
Table: 'Kill The Fish(707975795)#002' 6-max (real money) Seat #3 is the button
Seat 1: P1xel7 (422517, 1.78€ bounty)
Seat 2: Newayy (136803, 0.22€ bounty)
Seat 3: AFlipOnAFlop (144618, 0.33€ bounty)
Seat 4: jadou74 (81920, 0.22€ bounty)
Seat 5: russse888 (486047, 1.97€ bounty)
Seat 6: Camafe (124366, 0.63€ bounty)
*** ANTE/BLINDS ***
jadou74 posts ante 1200
russse888 posts ante 1200
P1xel7 posts ante 1200
Newayy posts ante 1200
AFlipOnAFlop posts ante 1200
Camafe posts ante 1200
jadou74 posts small blind 5000
russse888 posts big blind 10000
Dealt to P1xel7 [Jh 7c]
*** PRE-FLOP *** 
Camafe calls 10000
P1xel7 folds
Newayy folds
AFlipOnAFlop calls 10000
jadou74 folds
russse888 checks
*** FLOP *** [8s 9h Ks]
russse888 checks
Camafe checks
AFlipOnAFlop checks
*** TURN *** [8s 9h Ks][As]
russse888 checks
Camafe bets 14770
AFlipOnAFlop folds
russse888 calls 14770
*** RIVER *** [8s 9h Ks As][Qs]
russse888 checks
Camafe checks
*** SHOW DOWN ***
russse888 shows [9d Jd] (One pair : 9)
Camafe shows [Ah 7s] (Flush Ace high)
Camafe collected 71740 from pot
*** SUMMARY ***
Total pot 71740 | No rake
Board: [8s 9h Ks As Qs]
Seat 5: russse888 (big blind) showed [9d Jd] and lost with One pair : 9
Seat 6: Camafe showed [Ah 7s] and won 71740 with Flush Ace high


Winamax Poker - Tournament "Kill The Fish" buyIn: 0.45€ + 0.05€ level: 24 - HandId: #3040732885884600323-157-1699732995 - Holdem no limit (1400/6000/12000) - 2023/11/11 20:03:15 UTC
Table: 'Kill The Fish(707975795)#002' 6-max (real money) Seat #4 is the button
Seat 1: P1xel7 (421317, 1.78€ bounty)
Seat 2: Newayy (135603, 0.22€ bounty)
Seat 3: AFlipOnAFlop (133418, 0.33€ bounty)
Seat 4: jadou74 (75720, 0.22€ bounty)
Seat 5: russse888 (460077, 1.97€ bounty)
Seat 6: Camafe (170136, 0.63€ bounty)
*** ANTE/BLINDS ***
russse888 posts ante 1400
Camafe posts ante 1400
P1xel7 posts ante 1400
Newayy posts ante 1400
AFlipOnAFlop posts ante 1400
jadou74 posts ante 1400
russse888 posts small blind 6000
Camafe posts big blind 12000
Dealt to P1xel7 [Th Ad]
*** PRE-FLOP *** 
P1xel7 raises 24000 to 36000
Newayy folds
AFlipOnAFlop folds
jadou74 calls 36000
russse888 folds
Camafe folds
*** FLOP *** [Ts 3c Qh]
P1xel7 bets 49200
jadou74 calls 38320 and is all-in
*** TURN *** [Ts 3c Qh][9h]
*** RIVER *** [Ts 3c Qh 9h][Qd]
*** SHOW DOWN ***
P1xel7 shows [Th Ad] (Two pairs : Queens and Tens)
jadou74 shows [As Td] (Two pairs : Queens and Tens)
jadou74 collected 87520 from main pot
P1xel7 collected 98400 from side pot 1
*** SUMMARY ***
Total pot 185920 | No rake
Board: [Ts 3c Qh 9h Qd]
Seat 1: P1xel7 showed [Th Ad] and won 98400 with Two pairs : Queens and Tens
Seat 4: jadou74 (button) showed [As Td] and won 87520 with Two pairs : Queens and Tens


Winamax Poker - Tournament "Kill The Fish" buyIn: 0.45€ + 0.05€ level: 24 - HandId: #3040732885884600323-158-1699733035 - Holdem no limit (1400/6000/12000) - 2023/11/11 20:03:55 UTC
Table: 'Kill The Fish(707975795)#002' 6-max (real money) Seat #5 is the button
Seat 1: P1xel7 (433117, 1.78€ bounty)
Seat 2: Newayy (134203, 0.22€ bounty)
Seat 3: AFlipOnAFlop (132018, 0.33€ bounty)
Seat 4: jadou74 (87520, 0.22€ bounty)
Seat 5: russse888 (452677, 1.97€ bounty)
Seat 6: Camafe (156736, 0.63€ bounty)
*** ANTE/BLINDS ***
Camafe posts ante 1400
P1xel7 posts ante 1400
Newayy posts ante 1400
AFlipOnAFlop posts ante 1400
jadou74 posts ante 1400
russse888 posts ante 1400
Camafe posts small blind 6000
P1xel7 posts big blind 12000
Dealt to P1xel7 [Qh 6h]
*** PRE-FLOP *** 
Newayy folds
AFlipOnAFlop folds
jadou74 folds
russse888 folds
Camafe calls 6000
P1xel7 checks
*** FLOP *** [Td Tc 8d]
Camafe checks
P1xel7 bets 32400
Camafe calls 32400
*** TURN *** [Td Tc 8d][2c]
Camafe checks
P1xel7 checks
*** RIVER *** [Td Tc 8d 2c][8h]
Camafe bets 110936 and is all-in
P1xel7 folds
Camafe collected 208136 from pot
*** SUMMARY ***
Total pot 208136 | No rake
Board: [Td Tc 8d 2c 8h]
Seat 6: Camafe (small blind) won 208136


Winamax Poker - Tournament "Kill The Fish" buyIn: 0.45€ + 0.05€ level: 24 - HandId: #3040732885884600323-159-1699733086 - Holdem no limit (1400/6000/12000) - 2023/11/11 20:04:46 UTC
Table: 'Kill The Fish(707975795)#002' 6-max (real money) Seat #6 is the button
Seat 1: P1xel7 (387317, 1.78€ bounty)
Seat 2: Newayy (132803, 0.22€ bounty)
Seat 3: AFlipOnAFlop (130618, 0.33€ bounty)
Seat 4: jadou74 (86120, 0.22€ bounty)
Seat 5: russse888 (451277, 1.97€ bounty)
Seat 6: Camafe (208136, 0.63€ bounty)
*** ANTE/BLINDS ***
P1xel7 posts ante 1400
Newayy posts ante 1400
AFlipOnAFlop posts ante 1400
jadou74 posts ante 1400
russse888 posts ante 1400
Camafe posts ante 1400
P1xel7 posts small blind 6000
Newayy posts big blind 12000
Dealt to P1xel7 [9s 9c]
*** PRE-FLOP *** 
AFlipOnAFlop folds
jadou74 folds
russse888 folds
Camafe raises 194736 to 206736 and is all-in
P1xel7 raises 179181 to 385917 and is all-in
Newayy folds
*** FLOP *** [As 8s Td]
*** TURN *** [As 8s Td][Tc]
*** RIVER *** [As 8s Td Tc][Th]
*** SHOW DOWN ***
P1xel7 shows [9s 9c] (Full of Tens and 9)
Camafe shows [Ah Kd] (Full of Tens and Aces)
Camafe collected 433872 from main pot
P1xel7 collected 179181 from side pot 1
*** SUMMARY ***
Total pot 613053 | No rake
Board: [As 8s Td Tc Th]
Seat 1: P1xel7 (small blind) showed [9s 9c] and won 179181 with Full of Tens and 9
Seat 6: Camafe (button) showed [Ah Kd] and won 433872 with Full of Tens and Aces


Winamax Poker - Tournament "Kill The Fish" buyIn: 0.45€ + 0.05€ level: 24 - HandId: #3040732885884600323-160-1699733119 - Holdem no limit (1400/6000/12000) - 2023/11/11 20:05:19 UTC
Table: 'Kill The Fish(707975795)#002' 6-max (real money) Seat #1 is the button
Seat 1: P1xel7 (179181, 1.78€ bounty)
Seat 2: Newayy (119403, 0.22€ bounty)
Seat 3: AFlipOnAFlop (129218, 0.33€ bounty)
Seat 4: jadou74 (84720, 0.22€ bounty)
Seat 5: russse888 (449877, 1.97€ bounty)
Seat 6: Camafe (433872, 0.63€ bounty)
*** ANTE/BLINDS ***
Newayy posts ante 1400
AFlipOnAFlop posts ante 1400
P1xel7 posts ante 1400
jadou74 posts ante 1400
russse888 posts ante 1400
Camafe posts ante 1400
Newayy posts small blind 6000
AFlipOnAFlop posts big blind 12000
Dealt to P1xel7 [Tc Ac]
*** PRE-FLOP *** 
jadou74 calls 12000
russse888 folds
Camafe folds
P1xel7 raises 165781 to 177781 and is all-in
Newayy folds
AFlipOnAFlop folds
jadou74 calls 71320 and is all-in
*** FLOP *** [4h 4d Ks]
*** TURN *** [4h 4d Ks][8s]
*** RIVER *** [4h 4d Ks 8s][Jc]
*** SHOW DOWN ***
P1xel7 shows [Tc Ac] (One pair : 4)
jadou74 shows [Kh Qc] (Two pairs : Kings and 4)
jadou74 collected 193040 from main pot
P1xel7 collected 94461 from side pot 1
*** SUMMARY ***
Total pot 287501 | No rake
Board: [4h 4d Ks 8s Jc]
Seat 1: P1xel7 (button) showed [Tc Ac] and won 94461 with One pair : 4
Seat 4: jadou74 showed [Kh Qc] and won 193040 with Two pairs : Kings and 4


Winamax Poker - Tournament "Kill The Fish" buyIn: 0.45€ + 0.05€ level: 24 - HandId: #3040732885884600323-161-1699733169 - Holdem no limit (1400/6000/12000) - 2023/11/11 20:06:09 UTC
Table: 'Kill The Fish(707975795)#002' 6-max (real money) Seat #2 is the button
Seat 1: P1xel7 (94461, 1.78€ bounty)
Seat 2: Newayy (112003, 0.22€ bounty)
Seat 3: AFlipOnAFlop (115818, 0.33€ bounty)
Seat 4: jadou74 (193040, 0.22€ bounty)
Seat 5: russse888 (448477, 1.97€ bounty)
Seat 6: Camafe (432472, 0.63€ bounty)
*** ANTE/BLINDS ***
AFlipOnAFlop posts ante 1400
jadou74 posts ante 1400
P1xel7 posts ante 1400
Newayy posts ante 1400
russse888 posts ante 1400
Camafe posts ante 1400
AFlipOnAFlop posts small blind 6000
jadou74 posts big blind 12000
Dealt to P1xel7 [Qh 4d]
*** PRE-FLOP *** 
russse888 folds
Camafe folds
P1xel7 folds
Newayy folds
AFlipOnAFlop folds
jadou74 collected 26400 from pot
*** SUMMARY ***
Total pot 26400 | No rake
Seat 4: jadou74 (big blind) won 26400


Winamax Poker - Tournament "Kill The Fish" buyIn: 0.45€ + 0.05€ level: 24 - HandId: #3040732885884600323-162-1699733193 - Holdem no limit (1400/6000/12000) - 2023/11/11 20:06:33 UTC
Table: 'Kill The Fish(707975795)#002' 6-max (real money) Seat #3 is the button
Seat 1: P1xel7 (93061, 1.78€ bounty)
Seat 2: Newayy (110603, 0.22€ bounty)
Seat 3: AFlipOnAFlop (108418, 0.33€ bounty)
Seat 4: jadou74 (206040, 0.22€ bounty)
Seat 5: russse888 (447077, 1.97€ bounty)
Seat 6: Camafe (431072, 0.63€ bounty)
*** ANTE/BLINDS ***
jadou74 posts ante 1400
russse888 posts ante 1400
P1xel7 posts ante 1400
Newayy posts ante 1400
AFlipOnAFlop posts ante 1400
Camafe posts ante 1400
jadou74 posts small blind 6000
russse888 posts big blind 12000
Dealt to P1xel7 [Jd Td]
*** PRE-FLOP *** 
Camafe folds
P1xel7 folds
Newayy folds
AFlipOnAFlop folds
jadou74 folds
russse888 collected 26400 from pot
*** SUMMARY ***
Total pot 26400 | No rake
Seat 5: russse888 (big blind) won 26400


Winamax Poker - Tournament "Kill The Fish" buyIn: 0.45€ + 0.05€ level: 24 - HandId: #3040732885884600326-132-1699733277 - Holdem no limit (1400/6000/12000) - 2023/11/11 20:07:57 UTC
Table: 'Kill The Fish(707975795)#005' 6-max (real money) Seat #5 is the button
Seat 1: P1xel7 (91661, 1.78€ bounty)
Seat 2: sam va pas (1243890, 3.34€ bounty)
Seat 4: Patapin26000 (95576, 0.90€ bounty)
Seat 5: Chouandtlmc (121170, 0.60€ bounty)
Seat 6: DG Joker5667 (126605, 0.33€ bounty)
*** ANTE/BLINDS ***
DG Joker5667 posts ante 1400
P1xel7 posts ante 1400
sam va pas posts ante 1400
Patapin26000 posts ante 1400
Chouandtlmc posts ante 1400
DG Joker5667 posts small blind 6000
P1xel7 posts big blind 12000
Dealt to P1xel7 [Kd 2s]
*** PRE-FLOP *** 
sam va pas calls 12000
Patapin26000 folds
Chouandtlmc folds
DG Joker5667 calls 6000
P1xel7 checks
*** FLOP *** [4c Jc Js]
DG Joker5667 checks
P1xel7 bets 78261 and is all-in
sam va pas calls 78261
DG Joker5667 folds
*** TURN *** [4c Jc Js][4h]
*** RIVER *** [4c Jc Js 4h][Jh]
*** SHOW DOWN ***
P1xel7 shows [Kd 2s] (Full of Jacks and 4)
sam va pas shows [6c 8c] (Full of Jacks and 4)
sam va pas collected 99761 from pot
P1xel7 collected 99761 from pot
*** SUMMARY ***
Total pot 199522 | No rake
Board: [4c Jc Js 4h Jh]
Seat 1: P1xel7 (big blind) showed [Kd 2s] and won 99761 with Full of Jacks and 4
Seat 2: sam va pas showed [6c 8c] and won 99761 with Full of Jacks and 4


Winamax Poker - Tournament "Kill The Fish" buyIn: 0.45€ + 0.05€ level: 25 - HandId: #3040732885884600326-133-1699733321 - Holdem no limit (1600/7000/14000) - 2023/11/11 20:08:41 UTC
Table: 'Kill The Fish(707975795)#005' 6-max (real money) Seat #6 is the button
Seat 1: P1xel7 (99761, 1.78€ bounty)
Seat 2: sam va pas (1251990, 3.34€ bounty)
Seat 4: Patapin26000 (94176, 0.90€ bounty)
Seat 5: Chouandtlmc (119770, 0.60€ bounty)
Seat 6: DG Joker5667 (113205, 0.33€ bounty)
*** ANTE/BLINDS ***
P1xel7 posts ante 1600
sam va pas posts ante 1600
Patapin26000 posts ante 1600
Chouandtlmc posts ante 1600
DG Joker5667 posts ante 1600
P1xel7 posts small blind 7000
sam va pas posts big blind 14000
Dealt to P1xel7 [Th Ks]
*** PRE-FLOP *** 
Patapin26000 folds
Chouandtlmc folds
DG Joker5667 folds
P1xel7 raises 84161 to 98161 and is all-in
sam va pas calls 84161
*** FLOP *** [Ah 3c 9h]
*** TURN *** [Ah 3c 9h][4h]
*** RIVER *** [Ah 3c 9h 4h][Kc]
*** SHOW DOWN ***
P1xel7 shows [Th Ks] (One pair : Kings)
sam va pas shows [Kd Qc] (One pair : Kings)
sam va pas collected 204322 from pot
*** SUMMARY ***
Total pot 204322 | No rake
Board: [Ah 3c 9h 4h Kc]
Seat 1: P1xel7 (small blind) showed [Th Ks] and lost with One pair : Kings
Seat 2: sam va pas (big blind) showed [Kd Qc] and won 204322 with One pair : Kings


