Winamax Poker - Tournament "Kill The Fish" buyIn: 0.90€ + 0.10€ level: 7 - HandId: #3067533924193271827-49-1701204342 - Holdem no limit (70/300/600) - 2023/11/28 20:45:42 UTC
Table: 'Kill The Fish(714215898)#018' 6-max (real money) Seat #4 is the button
Seat 1: Bongueur77 (17682, 0.45€ bounty)
Seat 2: P1xel7 (20000, 0.45€ bounty)
Seat 3: fishatoutva (83760, 0.67€ bounty)
Seat 4: Champipotte (11190, 0.67€ bounty)
Seat 5: Thalweg (17180, 0.45€ bounty)
Seat 6: Yggdrasill56 (19163, 0.67€ bounty)
*** ANTE/BLINDS ***
Thalweg posts ante 70
Yggdrasill56 posts ante 70
Bongueur77 posts ante 70
P1xel7 posts ante 70
fishatoutva posts ante 70
Champipotte posts ante 70
Thalweg posts small blind 300
Yggdrasill56 posts big blind 600
Dealt to P1xel7 [Jc 7h]
*** PRE-FLOP *** 
Bongueur77 calls 600
P1xel7 folds
fishatoutva folds
Champipotte folds
Thalweg raises 1200 to 1800
Yggdrasill56 calls 1200
Bongueur77 calls 1200
*** FLOP *** [8c Js 9s]
Thalweg checks
Yggdrasill56 bets 17293 and is all-in
Bongueur77 calls 15812 and is all-in
Thalweg folds
*** TURN *** [8c Js 9s][Qc]
*** RIVER *** [8c Js 9s Qc][2d]
*** SHOW DOWN ***
Bongueur77 shows [Ts 8h] (Straight Queen high)
Yggdrasill56 shows [Ks Kc] (One pair : Kings)
Yggdrasill56 collected 1481 from side pot 1
Bongueur77 collected 37444 from main pot
*** SUMMARY ***
Total pot 38925 | No rake
Board: [8c Js 9s Qc 2d]
Seat 1: Bongueur77 showed [Ts 8h] and won 37444 with Straight Queen high
Seat 6: Yggdrasill56 (big blind) showed [Ks Kc] and won 1481 with One pair : Kings


Winamax Poker - Tournament "Kill The Fish" buyIn: 0.90€ + 0.10€ level: 8 - HandId: #3067533924193271827-50-1701204442 - Holdem no limit (80/350/700) - 2023/11/28 20:47:22 UTC
Table: 'Kill The Fish(714215898)#018' 6-max (real money) Seat #5 is the button
Seat 1: Bongueur77 (37444, 0.45€ bounty)
Seat 2: P1xel7 (19930, 0.45€ bounty)
Seat 3: fishatoutva (83690, 0.67€ bounty)
Seat 4: Champipotte (11120, 0.67€ bounty)
Seat 5: Thalweg (15310, 0.45€ bounty)
Seat 6: Yggdrasill56 (1481, 0.67€ bounty)
*** ANTE/BLINDS ***
Yggdrasill56 posts ante 80
Bongueur77 posts ante 80
P1xel7 posts ante 80
fishatoutva posts ante 80
Champipotte posts ante 80
Thalweg posts ante 80
Yggdrasill56 posts small blind 350
Bongueur77 posts big blind 700
Dealt to P1xel7 [Qd 6h]
*** PRE-FLOP *** 
P1xel7 folds
fishatoutva folds
Champipotte folds
Thalweg folds
Yggdrasill56 raises 701 to 1401 and is all-in
Bongueur77 calls 701
*** FLOP *** [4c 8s 9s]
*** TURN *** [4c 8s 9s][5h]
*** RIVER *** [4c 8s 9s 5h][7h]
*** SHOW DOWN ***
Yggdrasill56 shows [Th Kd] (High card : King)
Bongueur77 shows [5c 7c] (Two pairs : 7 and 5)
Bongueur77 collected 3282 from pot
*** SUMMARY ***
Total pot 3282 | No rake
Board: [4c 8s 9s 5h 7h]
Seat 1: Bongueur77 (big blind) showed [5c 7c] and won 3282 with Two pairs : 7 and 5
Seat 6: Yggdrasill56 (small blind) showed [Th Kd] and lost with High card : King


Winamax Poker - Tournament "Kill The Fish" buyIn: 0.90€ + 0.10€ level: 8 - HandId: #3067533924193271827-51-1701204460 - Holdem no limit (80/350/700) - 2023/11/28 20:47:40 UTC
Table: 'Kill The Fish(714215898)#018' 6-max (real money) Seat #6 is the button
Seat 1: Bongueur77 (39245, 0.78€ bounty)
Seat 2: P1xel7 (19850, 0.45€ bounty)
Seat 3: fishatoutva (83610, 0.67€ bounty)
Seat 4: Champipotte (11040, 0.67€ bounty)
Seat 5: Thalweg (15230, 0.45€ bounty)
*** ANTE/BLINDS ***
Bongueur77 posts ante 80
P1xel7 posts ante 80
fishatoutva posts ante 80
Champipotte posts ante 80
Thalweg posts ante 80
Bongueur77 posts small blind 350
P1xel7 posts big blind 700
Dealt to P1xel7 [3c 9s]
*** PRE-FLOP *** 
fishatoutva folds
Champipotte raises 10260 to 10960 and is all-in
Thalweg folds
Bongueur77 folds
P1xel7 folds
Champipotte collected 12410 from pot
*** SUMMARY ***
Total pot 12410 | No rake
Seat 4: Champipotte won 12410


Winamax Poker - Tournament "Kill The Fish" buyIn: 0.90€ + 0.10€ level: 8 - HandId: #3067533924193271827-52-1701204480 - Holdem no limit (80/350/700) - 2023/11/28 20:48:00 UTC
Table: 'Kill The Fish(714215898)#018' 6-max (real money) Seat #1 is the button
Seat 1: Bongueur77 (38815, 0.78€ bounty)
Seat 2: P1xel7 (19070, 0.45€ bounty)
Seat 3: fishatoutva (83530, 0.67€ bounty)
Seat 4: Champipotte (12410, 0.67€ bounty)
Seat 5: Thalweg (15150, 0.45€ bounty)
*** ANTE/BLINDS ***
P1xel7 posts ante 80
fishatoutva posts ante 80
Bongueur77 posts ante 80
Champipotte posts ante 80
Thalweg posts ante 80
P1xel7 posts small blind 350
fishatoutva posts big blind 700
Dealt to P1xel7 [Ad 2h]
*** PRE-FLOP *** 
Champipotte folds
Thalweg folds
Bongueur77 calls 700
P1xel7 folds
fishatoutva checks
*** FLOP *** [5h Jh 7c]
fishatoutva bets 1720
Bongueur77 folds
fishatoutva collected 3870 from pot
*** SUMMARY ***
Total pot 3870 | No rake
Board: [5h Jh 7c]
Seat 3: fishatoutva (big blind) won 3870


Winamax Poker - Tournament "Kill The Fish" buyIn: 0.90€ + 0.10€ level: 8 - HandId: #3067533924193271827-53-1701204504 - Holdem no limit (80/350/700) - 2023/11/28 20:48:24 UTC
Table: 'Kill The Fish(714215898)#018' 6-max (real money) Seat #2 is the button
Seat 1: Bongueur77 (38035, 0.78€ bounty)
Seat 2: P1xel7 (18640, 0.45€ bounty)
Seat 3: fishatoutva (84900, 0.67€ bounty)
Seat 4: Champipotte (12330, 0.67€ bounty)
Seat 5: Thalweg (15070, 0.45€ bounty)
*** ANTE/BLINDS ***
fishatoutva posts ante 80
Champipotte posts ante 80
Bongueur77 posts ante 80
P1xel7 posts ante 80
Thalweg posts ante 80
fishatoutva posts small blind 350
Champipotte posts big blind 700
Dealt to P1xel7 [7d Ac]
*** PRE-FLOP *** 
Thalweg folds
Bongueur77 calls 700
P1xel7 folds
fishatoutva raises 1225 to 1925
Champipotte raises 10325 to 12250 and is all-in
Bongueur77 folds
fishatoutva calls 10325
*** FLOP *** [Ad 8d Qh]
*** TURN *** [Ad 8d Qh][9s]
*** RIVER *** [Ad 8d Qh 9s][8h]
*** SHOW DOWN ***
Champipotte shows [9c Kc] (Two pairs : 9 and 8)
fishatoutva shows [Kh As] (Two pairs : Aces and 8)
fishatoutva collected 25600 from pot
*** SUMMARY ***
Total pot 25600 | No rake
Board: [Ad 8d Qh 9s 8h]
Seat 3: fishatoutva (small blind) showed [Kh As] and won 25600 with Two pairs : Aces and 8
Seat 4: Champipotte (big blind) showed [9c Kc] and lost with Two pairs : 9 and 8


Winamax Poker - Tournament "Kill The Fish" buyIn: 0.90€ + 0.10€ level: 8 - HandId: #3067533924193271827-54-1701204551 - Holdem no limit (80/350/700) - 2023/11/28 20:49:11 UTC
Table: 'Kill The Fish(714215898)#018' 6-max (real money) Seat #3 is the button
Seat 1: Bongueur77 (37255, 0.78€ bounty)
Seat 2: P1xel7 (18560, 0.45€ bounty)
Seat 3: fishatoutva (98170, 1€ bounty)
Seat 5: Thalweg (14990, 0.45€ bounty)
Seat 6: MolloCaira (20000, 0.45€ bounty)
*** ANTE/BLINDS ***
Thalweg posts ante 80
Bongueur77 posts ante 80
P1xel7 posts ante 80
fishatoutva posts ante 80
MolloCaira posts ante 80
Thalweg posts big blind 700
Dealt to P1xel7 [7d 5c]
*** PRE-FLOP *** 
MolloCaira folds
Bongueur77 calls 700
P1xel7 folds
fishatoutva folds
Thalweg checks
*** FLOP *** [9c 4d Ks]
Thalweg checks
Bongueur77 bets 1800
Thalweg folds
Bongueur77 collected 3600 from pot
*** SUMMARY ***
Total pot 3600 | No rake
Board: [9c 4d Ks]
Seat 1: Bongueur77 won 3600


Winamax Poker - Tournament "Kill The Fish" buyIn: 0.90€ + 0.10€ level: 8 - HandId: #3067533924193271827-55-1701204569 - Holdem no limit (80/350/700) - 2023/11/28 20:49:29 UTC
Table: 'Kill The Fish(714215898)#018' 6-max (real money) Seat #4 is the button
Seat 1: Bongueur77 (38275, 0.78€ bounty)
Seat 2: P1xel7 (18480, 0.45€ bounty)
Seat 3: fishatoutva (98090, 1€ bounty)
Seat 5: Thalweg (14210, 0.45€ bounty)
Seat 6: MolloCaira (19920, 0.45€ bounty)
*** ANTE/BLINDS ***
Thalweg posts ante 80
MolloCaira posts ante 80
Bongueur77 posts ante 80
P1xel7 posts ante 80
fishatoutva posts ante 80
Thalweg posts small blind 350
MolloCaira posts big blind 700
Dealt to P1xel7 [Jc 9h]
*** PRE-FLOP *** 
Bongueur77 calls 700
P1xel7 folds
fishatoutva raises 1225 to 1925
Thalweg folds
MolloCaira calls 1225
Bongueur77 calls 1225
*** FLOP *** [Js 4h Qh]
MolloCaira checks
Bongueur77 checks
fishatoutva bets 4241
MolloCaira folds
Bongueur77 folds
fishatoutva collected 10766 from pot
*** SUMMARY ***
Total pot 10766 | No rake
Board: [Js 4h Qh]
Seat 3: fishatoutva won 10766


Winamax Poker - Tournament "Kill The Fish" buyIn: 0.90€ + 0.10€ level: 8 - HandId: #3067533924193271827-56-1701204638 - Holdem no limit (80/350/700) - 2023/11/28 20:50:38 UTC
Table: 'Kill The Fish(714215898)#018' 6-max (real money) Seat #5 is the button
Seat 1: Bongueur77 (36270, 0.78€ bounty)
Seat 2: P1xel7 (18400, 0.45€ bounty)
Seat 3: fishatoutva (102610, 1€ bounty)
Seat 5: Thalweg (13780, 0.45€ bounty)
Seat 6: MolloCaira (17915, 0.45€ bounty)
*** ANTE/BLINDS ***
MolloCaira posts ante 80
Bongueur77 posts ante 80
P1xel7 posts ante 80
fishatoutva posts ante 80
Thalweg posts ante 80
MolloCaira posts small blind 350
Bongueur77 posts big blind 700
Dealt to P1xel7 [8c Jc]
*** PRE-FLOP *** 
P1xel7 folds
fishatoutva folds
Thalweg raises 700 to 1400
MolloCaira folds
Bongueur77 calls 700
*** FLOP *** [7d Jh 7h]
Bongueur77 bets 1243
Thalweg calls 1243
*** TURN *** [7d Jh 7h][Ts]
Bongueur77 bets 1354
Thalweg calls 1354
*** RIVER *** [7d Jh 7h Ts][9d]
Bongueur77 bets 1339
Thalweg calls 1339
*** SHOW DOWN ***
Bongueur77 shows [Kd Ad] (One pair : 7)
Thalweg shows [Kc Ks] (Two pairs : Kings and 7)
Thalweg collected 11422 from pot
*** SUMMARY ***
Total pot 11422 | No rake
Board: [7d Jh 7h Ts 9d]
Seat 1: Bongueur77 (big blind) showed [Kd Ad] and lost with One pair : 7
Seat 5: Thalweg (button) showed [Kc Ks] and won 11422 with Two pairs : Kings and 7


Winamax Poker - Tournament "Kill The Fish" buyIn: 0.90€ + 0.10€ level: 9 - HandId: #3067533924193271827-57-1701204716 - Holdem no limit (100/400/800) - 2023/11/28 20:51:56 UTC
Table: 'Kill The Fish(714215898)#018' 6-max (real money) Seat #6 is the button
Seat 1: Bongueur77 (30854, 0.78€ bounty)
Seat 2: P1xel7 (18320, 0.45€ bounty)
Seat 3: fishatoutva (102530, 1€ bounty)
Seat 5: Thalweg (19786, 0.45€ bounty)
Seat 6: MolloCaira (17485, 0.45€ bounty)
*** ANTE/BLINDS ***
Bongueur77 posts ante 100
P1xel7 posts ante 100
fishatoutva posts ante 100
Thalweg posts ante 100
MolloCaira posts ante 100
Bongueur77 posts small blind 400
P1xel7 posts big blind 800
Dealt to P1xel7 [3c Th]
*** PRE-FLOP *** 
fishatoutva folds
Thalweg folds
MolloCaira raises 800 to 1600
Bongueur77 calls 1200
P1xel7 folds
*** FLOP *** [8h Qc 4c]
Bongueur77 checks
MolloCaira bets 1575
Bongueur77 raises 1575 to 3150
MolloCaira folds
Bongueur77 collected 9225 from pot
*** SUMMARY ***
Total pot 9225 | No rake
Board: [8h Qc 4c]
Seat 1: Bongueur77 (small blind) won 9225


Winamax Poker - Tournament "Kill The Fish" buyIn: 0.90€ + 0.10€ level: 9 - HandId: #3067533924193271827-58-1701204737 - Holdem no limit (100/400/800) - 2023/11/28 20:52:17 UTC
Table: 'Kill The Fish(714215898)#018' 6-max (real money) Seat #1 is the button
Seat 1: Bongueur77 (35229, 0.78€ bounty)
Seat 2: P1xel7 (17420, 0.45€ bounty)
Seat 3: fishatoutva (102430, 1€ bounty)
Seat 5: Thalweg (19686, 0.45€ bounty)
Seat 6: MolloCaira (14210, 0.45€ bounty)
*** ANTE/BLINDS ***
P1xel7 posts ante 100
fishatoutva posts ante 100
Bongueur77 posts ante 100
Thalweg posts ante 100
MolloCaira posts ante 100
P1xel7 posts small blind 400
fishatoutva posts big blind 800
Dealt to P1xel7 [6d Td]
*** PRE-FLOP *** 
Thalweg folds
MolloCaira raises 13310 to 14110 and is all-in
Bongueur77 calls 14110
P1xel7 folds
fishatoutva folds
*** FLOP *** [Jd 2h 9d]
*** TURN *** [Jd 2h 9d][9h]
*** RIVER *** [Jd 2h 9d 9h][Qh]
*** SHOW DOWN ***
Bongueur77 shows [Jc Ac] (Two pairs : Jacks and 9)
MolloCaira shows [Ah Qc] (Two pairs : Queens and 9)
MolloCaira collected 29920 from pot
*** SUMMARY ***
Total pot 29920 | No rake
Board: [Jd 2h 9d 9h Qh]
Seat 1: Bongueur77 (button) showed [Jc Ac] and lost with Two pairs : Jacks and 9
Seat 6: MolloCaira showed [Ah Qc] and won 29920 with Two pairs : Queens and 9


Winamax Poker - Tournament "Kill The Fish" buyIn: 0.90€ + 0.10€ level: 9 - HandId: #3067533924193271827-59-1701204760 - Holdem no limit (100/400/800) - 2023/11/28 20:52:40 UTC
Table: 'Kill The Fish(714215898)#018' 6-max (real money) Seat #2 is the button
Seat 1: Bongueur77 (21019, 0.78€ bounty)
Seat 2: P1xel7 (16920, 0.45€ bounty)
Seat 3: fishatoutva (101530, 1€ bounty)
Seat 4: Fifou LeFou (20000, 0.45€ bounty)
Seat 5: Thalweg (19586, 0.45€ bounty)
Seat 6: MolloCaira (29920, 0.45€ bounty)
*** ANTE/BLINDS ***
fishatoutva posts ante 100
Fifou LeFou posts ante 100
Bongueur77 posts ante 100
P1xel7 posts ante 100
Thalweg posts ante 100
MolloCaira posts ante 100
fishatoutva posts small blind 400
Fifou LeFou posts big blind 800
Dealt to P1xel7 [6s 5h]
*** PRE-FLOP *** 
Thalweg folds
MolloCaira folds
Bongueur77 calls 800
P1xel7 folds
fishatoutva calls 400
Fifou LeFou checks
*** FLOP *** [Ac 2h 8d]
fishatoutva checks
Fifou LeFou checks
Bongueur77 bets 3000
fishatoutva folds
Fifou LeFou folds
Bongueur77 collected 6000 from pot
*** SUMMARY ***
Total pot 6000 | No rake
Board: [Ac 2h 8d]
Seat 1: Bongueur77 won 6000


Winamax Poker - Tournament "Kill The Fish" buyIn: 0.90€ + 0.10€ level: 9 - HandId: #3067533924193271827-60-1701204806 - Holdem no limit (100/400/800) - 2023/11/28 20:53:26 UTC
Table: 'Kill The Fish(714215898)#018' 6-max (real money) Seat #3 is the button
Seat 1: Bongueur77 (23119, 0.78€ bounty)
Seat 2: P1xel7 (16820, 0.45€ bounty)
Seat 3: fishatoutva (100630, 1€ bounty)
Seat 4: Fifou LeFou (19100, 0.45€ bounty)
Seat 5: Thalweg (19486, 0.45€ bounty)
Seat 6: MolloCaira (29820, 0.45€ bounty)
*** ANTE/BLINDS ***
Fifou LeFou posts ante 100
Thalweg posts ante 100
Bongueur77 posts ante 100
P1xel7 posts ante 100
fishatoutva posts ante 100
MolloCaira posts ante 100
Fifou LeFou posts small blind 400
Thalweg posts big blind 800
Dealt to P1xel7 [6s Th]
*** PRE-FLOP *** 
MolloCaira folds
Bongueur77 calls 800
P1xel7 folds
fishatoutva folds
Fifou LeFou calls 400
Thalweg checks
*** FLOP *** [Kd Kh Js]
Fifou LeFou checks
Thalweg checks
Bongueur77 checks
*** TURN *** [Kd Kh Js][6d]
Fifou LeFou checks
Thalweg checks
Bongueur77 checks
*** RIVER *** [Kd Kh Js 6d][2s]
Fifou LeFou checks
Thalweg checks
Bongueur77 checks
*** SHOW DOWN ***
Fifou LeFou shows [9h Qh] (One pair : Kings)
Thalweg shows [3d 9s] (One pair : Kings)
Bongueur77 shows [Ac 5h] (One pair : Kings)
Bongueur77 collected 3000 from pot
*** SUMMARY ***
Total pot 3000 | No rake
Board: [Kd Kh Js 6d 2s]
Seat 1: Bongueur77 showed [Ac 5h] and won 3000 with One pair : Kings
Seat 4: Fifou LeFou (small blind) showed [9h Qh] and lost with One pair : Kings
Seat 5: Thalweg (big blind) showed [3d 9s] and lost with One pair : Kings


Winamax Poker - Tournament "Kill The Fish" buyIn: 0.90€ + 0.10€ level: 9 - HandId: #3067533924193271827-61-1701205261 - Holdem no limit (100/400/800) - 2023/11/28 21:01:01 UTC
Table: 'Kill The Fish(714215898)#018' 6-max (real money) Seat #4 is the button
Seat 1: Bongueur77 (25219, 0.78€ bounty)
Seat 2: P1xel7 (16720, 0.45€ bounty)
Seat 3: fishatoutva (100530, 1€ bounty)
Seat 4: Fifou LeFou (18200, 0.45€ bounty)
Seat 5: Thalweg (18586, 0.45€ bounty)
Seat 6: MolloCaira (29720, 0.45€ bounty)
*** ANTE/BLINDS ***
Thalweg posts ante 100
MolloCaira posts ante 100
Bongueur77 posts ante 100
P1xel7 posts ante 100
fishatoutva posts ante 100
Fifou LeFou posts ante 100
Thalweg posts small blind 400
MolloCaira posts big blind 800
Dealt to P1xel7 [Kd 6h]
*** PRE-FLOP *** 
Bongueur77 folds
P1xel7 folds
fishatoutva folds
Fifou LeFou folds
Thalweg raises 1600 to 2400
MolloCaira raises 27220 to 29620 and is all-in
Thalweg folds
MolloCaira collected 32620 from pot
*** SUMMARY ***
Total pot 32620 | No rake
Seat 6: MolloCaira (big blind) won 32620


Winamax Poker - Tournament "Kill The Fish" buyIn: 0.90€ + 0.10€ level: 10 - HandId: #3067533924193271827-62-1701205341 - Holdem no limit (120/500/1000) - 2023/11/28 21:02:21 UTC
Table: 'Kill The Fish(714215898)#018' 6-max (real money) Seat #5 is the button
Seat 1: Bongueur77 (25119, 0.78€ bounty)
Seat 2: P1xel7 (16620, 0.45€ bounty)
Seat 3: fishatoutva (100430, 1€ bounty)
Seat 4: Fifou LeFou (18100, 0.45€ bounty)
Seat 5: Thalweg (16086, 0.45€ bounty)
Seat 6: MolloCaira (32620, 0.45€ bounty)
*** ANTE/BLINDS ***
MolloCaira posts ante 120
Bongueur77 posts ante 120
P1xel7 posts ante 120
fishatoutva posts ante 120
Fifou LeFou posts ante 120
Thalweg posts ante 120
MolloCaira posts small blind 500
Bongueur77 posts big blind 1000
Dealt to P1xel7 [2c 2s]
*** PRE-FLOP *** 
P1xel7 folds
fishatoutva raises 1200 to 2200
Fifou LeFou calls 2200
Thalweg folds
MolloCaira calls 1700
Bongueur77 calls 1200
*** FLOP *** [5s 7s 5c]
MolloCaira bets 9520
Bongueur77 folds
fishatoutva folds
Fifou LeFou folds
MolloCaira collected 19040 from pot
*** SUMMARY ***
Total pot 19040 | No rake
Board: [5s 7s 5c]
Seat 6: MolloCaira (small blind) won 19040


Winamax Poker - Tournament "Kill The Fish" buyIn: 0.90€ + 0.10€ level: 10 - HandId: #3067533924193271827-63-1701205423 - Holdem no limit (120/500/1000) - 2023/11/28 21:03:43 UTC
Table: 'Kill The Fish(714215898)#018' 6-max (real money) Seat #6 is the button
Seat 1: Bongueur77 (22799, 0.78€ bounty)
Seat 2: P1xel7 (16500, 0.45€ bounty)
Seat 3: fishatoutva (98110, 1€ bounty)
Seat 4: Fifou LeFou (15780, 0.45€ bounty)
Seat 5: Thalweg (15966, 0.45€ bounty)
Seat 6: MolloCaira (39820, 0.45€ bounty)
*** ANTE/BLINDS ***
Bongueur77 posts ante 120
P1xel7 posts ante 120
fishatoutva posts ante 120
Fifou LeFou posts ante 120
Thalweg posts ante 120
MolloCaira posts ante 120
Bongueur77 posts small blind 500
P1xel7 posts big blind 1000
Dealt to P1xel7 [8s 5c]
*** PRE-FLOP *** 
fishatoutva folds
Fifou LeFou folds
Thalweg folds
MolloCaira folds
Bongueur77 folds
P1xel7 collected 2220 from pot
*** SUMMARY ***
Total pot 2220 | No rake
Seat 2: P1xel7 (big blind) won 2220


Winamax Poker - Tournament "Kill The Fish" buyIn: 0.90€ + 0.10€ level: 10 - HandId: #3067533924193271827-64-1701205462 - Holdem no limit (120/500/1000) - 2023/11/28 21:04:22 UTC
Table: 'Kill The Fish(714215898)#018' 6-max (real money) Seat #1 is the button
Seat 1: Bongueur77 (22179, 0.78€ bounty)
Seat 2: P1xel7 (17600, 0.45€ bounty)
Seat 3: fishatoutva (97990, 1€ bounty)
Seat 4: Fifou LeFou (15660, 0.45€ bounty)
Seat 5: Thalweg (15846, 0.45€ bounty)
Seat 6: MolloCaira (39700, 0.45€ bounty)
*** ANTE/BLINDS ***
P1xel7 posts ante 120
fishatoutva posts ante 120
Bongueur77 posts ante 120
Fifou LeFou posts ante 120
Thalweg posts ante 120
MolloCaira posts ante 120
P1xel7 posts small blind 500
fishatoutva posts big blind 1000
Dealt to P1xel7 [Th 2d]
*** PRE-FLOP *** 
Fifou LeFou folds
Thalweg folds
MolloCaira raises 1000 to 2000
Bongueur77 calls 2000
P1xel7 folds
fishatoutva calls 1000
*** FLOP *** [5s 3s Ts]
fishatoutva checks
MolloCaira bets 37580 and is all-in
Bongueur77 folds
fishatoutva folds
MolloCaira collected 44800 from pot
*** SUMMARY ***
Total pot 44800 | No rake
Board: [5s 3s Ts]
Seat 6: MolloCaira won 44800


Winamax Poker - Tournament "Kill The Fish" buyIn: 0.90€ + 0.10€ level: 10 - HandId: #3067533924193271827-65-1701205533 - Holdem no limit (120/500/1000) - 2023/11/28 21:05:33 UTC
Table: 'Kill The Fish(714215898)#018' 6-max (real money) Seat #2 is the button
Seat 1: Bongueur77 (20059, 0.78€ bounty)
Seat 2: P1xel7 (16980, 0.45€ bounty)
Seat 3: fishatoutva (95870, 1€ bounty)
Seat 4: Fifou LeFou (15540, 0.45€ bounty)
Seat 5: Thalweg (15726, 0.45€ bounty)
Seat 6: MolloCaira (44800, 0.45€ bounty)
*** ANTE/BLINDS ***
fishatoutva posts ante 120
Fifou LeFou posts ante 120
Bongueur77 posts ante 120
P1xel7 posts ante 120
Thalweg posts ante 120
MolloCaira posts ante 120
fishatoutva posts small blind 500
Fifou LeFou posts big blind 1000
Dealt to P1xel7 [8s 9c]
*** PRE-FLOP *** 
Thalweg raises 14606 to 15606 and is all-in
MolloCaira folds
Bongueur77 folds
P1xel7 folds
fishatoutva folds
Fifou LeFou folds
Thalweg collected 17826 from pot
*** SUMMARY ***
Total pot 17826 | No rake
Seat 5: Thalweg won 17826


Winamax Poker - Tournament "Kill The Fish" buyIn: 0.90€ + 0.10€ level: 10 - HandId: #3067533924193271827-66-1701205565 - Holdem no limit (120/500/1000) - 2023/11/28 21:06:05 UTC
Table: 'Kill The Fish(714215898)#018' 6-max (real money) Seat #3 is the button
Seat 1: Bongueur77 (19939, 0.78€ bounty)
Seat 2: P1xel7 (16860, 0.45€ bounty)
Seat 3: fishatoutva (95250, 1€ bounty)
Seat 4: Fifou LeFou (14420, 0.45€ bounty)
Seat 5: Thalweg (17826, 0.45€ bounty)
Seat 6: MolloCaira (44680, 0.45€ bounty)
*** ANTE/BLINDS ***
Fifou LeFou posts ante 120
Thalweg posts ante 120
Bongueur77 posts ante 120
P1xel7 posts ante 120
fishatoutva posts ante 120
MolloCaira posts ante 120
Fifou LeFou posts small blind 500
Thalweg posts big blind 1000
Dealt to P1xel7 [4s 7d]
*** PRE-FLOP *** 
MolloCaira folds
Bongueur77 folds
P1xel7 folds
fishatoutva folds
Fifou LeFou calls 500
Thalweg checks
*** FLOP *** [5s 2d 3s]
Fifou LeFou checks
Thalweg checks
*** TURN *** [5s 2d 3s][7s]
Fifou LeFou bets 1000
Thalweg folds
Fifou LeFou collected 3720 from pot
*** SUMMARY ***
Total pot 3720 | No rake
Board: [5s 2d 3s 7s]
Seat 4: Fifou LeFou (small blind) won 3720


Winamax Poker - Tournament "Kill The Fish" buyIn: 0.90€ + 0.10€ level: 11 - HandId: #3067533924193271827-67-1701205644 - Holdem no limit (140/600/1200) - 2023/11/28 21:07:24 UTC
Table: 'Kill The Fish(714215898)#018' 6-max (real money) Seat #4 is the button
Seat 1: Bongueur77 (19819, 0.78€ bounty)
Seat 2: P1xel7 (16740, 0.45€ bounty)
Seat 3: fishatoutva (95130, 1€ bounty)
Seat 4: Fifou LeFou (16020, 0.45€ bounty)
Seat 5: Thalweg (16706, 0.45€ bounty)
Seat 6: MolloCaira (44560, 0.45€ bounty)
*** ANTE/BLINDS ***
Thalweg posts ante 140
MolloCaira posts ante 140
Bongueur77 posts ante 140
P1xel7 posts ante 140
fishatoutva posts ante 140
Fifou LeFou posts ante 140
Thalweg posts small blind 600
MolloCaira posts big blind 1200
Dealt to P1xel7 [2h Kc]
*** PRE-FLOP *** 
Bongueur77 calls 1200
P1xel7 folds
fishatoutva calls 1200
Fifou LeFou raises 14680 to 15880 and is all-in
Thalweg folds
MolloCaira folds
Bongueur77 folds
fishatoutva calls 14680
*** FLOP *** [3s 8s 8h]
*** TURN *** [3s 8s 8h][7d]
*** RIVER *** [3s 8s 8h 7d][Js]
*** SHOW DOWN ***
Fifou LeFou shows [Ad Kh] (One pair : 8)
fishatoutva shows [7s 7c] (Full of 7 and 8)
fishatoutva collected 35600 from pot
*** SUMMARY ***
Total pot 35600 | No rake
Board: [3s 8s 8h 7d Js]
Seat 3: fishatoutva showed [7s 7c] and won 35600 with Full of 7 and 8
Seat 4: Fifou LeFou (button) showed [Ad Kh] and lost with One pair : 8


Winamax Poker - Tournament "Kill The Fish" buyIn: 0.90€ + 0.10€ level: 11 - HandId: #3067533924193271827-68-1701205691 - Holdem no limit (140/600/1200) - 2023/11/28 21:08:11 UTC
Table: 'Kill The Fish(714215898)#018' 6-max (real money) Seat #5 is the button
Seat 1: Bongueur77 (18479, 0.78€ bounty)
Seat 2: P1xel7 (16600, 0.45€ bounty)
Seat 3: fishatoutva (114710, 1.22€ bounty)
Seat 5: Thalweg (15966, 0.45€ bounty)
Seat 6: MolloCaira (43220, 0.45€ bounty)
*** ANTE/BLINDS ***
MolloCaira posts ante 140
Bongueur77 posts ante 140
P1xel7 posts ante 140
fishatoutva posts ante 140
Thalweg posts ante 140
MolloCaira posts small blind 600
Bongueur77 posts big blind 1200
Dealt to P1xel7 [Tc 9d]
*** PRE-FLOP *** 
P1xel7 folds
fishatoutva raises 1200 to 2400
Thalweg folds
MolloCaira folds
Bongueur77 folds
fishatoutva collected 4900 from pot
*** SUMMARY ***
Total pot 4900 | No rake
Seat 3: fishatoutva won 4900


Winamax Poker - Tournament "Kill The Fish" buyIn: 0.90€ + 0.10€ level: 11 - HandId: #3067533924193271827-69-1701205718 - Holdem no limit (140/600/1200) - 2023/11/28 21:08:38 UTC
Table: 'Kill The Fish(714215898)#018' 6-max (real money) Seat #6 is the button
Seat 1: Bongueur77 (17139, 0.78€ bounty)
Seat 2: P1xel7 (16460, 0.45€ bounty)
Seat 3: fishatoutva (117070, 1.22€ bounty)
Seat 4: arlix (19774, 0.67€ bounty)
Seat 5: Thalweg (15826, 0.45€ bounty)
Seat 6: MolloCaira (42480, 0.45€ bounty)
*** ANTE/BLINDS ***
Bongueur77 posts ante 140
P1xel7 posts ante 140
fishatoutva posts ante 140
arlix posts ante 140
Thalweg posts ante 140
MolloCaira posts ante 140
Bongueur77 posts small blind 600
P1xel7 posts big blind 1200
Dealt to P1xel7 [3h 6d]
*** PRE-FLOP *** 
fishatoutva folds
arlix calls 1200
Thalweg folds
MolloCaira raises 3000 to 4200
Bongueur77 folds
P1xel7 folds
arlix folds
MolloCaira collected 8040 from pot
*** SUMMARY ***
Total pot 8040 | No rake
Seat 6: MolloCaira (button) won 8040


Winamax Poker - Tournament "Kill The Fish" buyIn: 0.90€ + 0.10€ level: 11 - HandId: #3067533924193271827-70-1701205781 - Holdem no limit (140/600/1200) - 2023/11/28 21:09:41 UTC
Table: 'Kill The Fish(714215898)#018' 6-max (real money) Seat #1 is the button
Seat 1: Bongueur77 (16399, 0.78€ bounty)
Seat 2: P1xel7 (15120, 0.45€ bounty)
Seat 3: fishatoutva (116930, 1.22€ bounty)
Seat 4: arlix (18434, 0.67€ bounty)
Seat 5: Thalweg (15686, 0.45€ bounty)
Seat 6: MolloCaira (46180, 0.45€ bounty)
*** ANTE/BLINDS ***
P1xel7 posts ante 140
fishatoutva posts ante 140
Bongueur77 posts ante 140
arlix posts ante 140
Thalweg posts ante 140
MolloCaira posts ante 140
P1xel7 posts small blind 600
fishatoutva posts big blind 1200
Dealt to P1xel7 [3d Jh]
*** PRE-FLOP *** 
arlix calls 1200
Thalweg folds
MolloCaira raises 3000 to 4200
Bongueur77 folds
P1xel7 folds
fishatoutva folds
arlix folds
MolloCaira collected 8040 from pot
*** SUMMARY ***
Total pot 8040 | No rake
Seat 6: MolloCaira won 8040


Winamax Poker - Tournament "Kill The Fish" buyIn: 0.90€ + 0.10€ level: 11 - HandId: #3067533924193271827-71-1701205816 - Holdem no limit (140/600/1200) - 2023/11/28 21:10:16 UTC
Table: 'Kill The Fish(714215898)#018' 6-max (real money) Seat #2 is the button
Seat 1: Bongueur77 (16259, 0.78€ bounty)
Seat 2: P1xel7 (14380, 0.45€ bounty)
Seat 3: fishatoutva (115590, 1.22€ bounty)
Seat 4: arlix (17094, 0.67€ bounty)
Seat 5: Thalweg (15546, 0.45€ bounty)
Seat 6: MolloCaira (49880, 0.45€ bounty)
*** ANTE/BLINDS ***
fishatoutva posts ante 140
arlix posts ante 140
Bongueur77 posts ante 140
P1xel7 posts ante 140
Thalweg posts ante 140
MolloCaira posts ante 140
fishatoutva posts small blind 600
arlix posts big blind 1200
Dealt to P1xel7 [2d 8c]
*** PRE-FLOP *** 
Thalweg folds
MolloCaira folds
Bongueur77 calls 1200
P1xel7 folds
fishatoutva folds
arlix checks
*** FLOP *** [6d 9h 5h]
arlix checks
Bongueur77 bets 3840
arlix raises 11914 to 15754 and is all-in
Bongueur77 folds
arlix collected 23434 from pot
*** SUMMARY ***
Total pot 23434 | No rake
Board: [6d 9h 5h]
Seat 4: arlix (big blind) won 23434


Winamax Poker - Tournament "Kill The Fish" buyIn: 0.90€ + 0.10€ level: 11 - HandId: #3067533924193271827-72-1701205863 - Holdem no limit (140/600/1200) - 2023/11/28 21:11:03 UTC
Table: 'Kill The Fish(714215898)#018' 6-max (real money) Seat #3 is the button
Seat 1: Bongueur77 (11079, 0.78€ bounty)
Seat 2: P1xel7 (14240, 0.45€ bounty)
Seat 3: fishatoutva (114850, 1.22€ bounty)
Seat 4: arlix (23434, 0.67€ bounty)
Seat 5: Thalweg (15406, 0.45€ bounty)
Seat 6: MolloCaira (49740, 0.45€ bounty)
*** ANTE/BLINDS ***
arlix posts ante 140
Thalweg posts ante 140
Bongueur77 posts ante 140
P1xel7 posts ante 140
fishatoutva posts ante 140
MolloCaira posts ante 140
arlix posts small blind 600
Thalweg posts big blind 1200
Dealt to P1xel7 [As Qs]
*** PRE-FLOP *** 
MolloCaira raises 1440 to 2640
Bongueur77 folds
P1xel7 raises 11460 to 14100 and is all-in
fishatoutva folds
arlix folds
Thalweg folds
MolloCaira calls 11460
*** FLOP *** [8h 5h Kc]
*** TURN *** [8h 5h Kc][Ts]
*** RIVER *** [8h 5h Kc Ts][Kd]
*** SHOW DOWN ***
P1xel7 shows [As Qs] (One pair : Kings)
MolloCaira shows [8c 8s] (Full of 8 and Kings)
MolloCaira collected 30840 from pot
*** SUMMARY ***
Total pot 30840 | No rake
Board: [8h 5h Kc Ts Kd]
Seat 2: P1xel7 showed [As Qs] and lost with One pair : Kings
Seat 6: MolloCaira showed [8c 8s] and won 30840 with Full of 8 and Kings


