Winamax Poker - Tournament "MYSTERY KO" buyIn: 0.90€ + 0.10€ level: 7 - HandId: #3047856029015474228-74-1700080322 - Holdem no limit (70/300/600) - 2023/11/15 20:32:02 UTC
Table: 'MYSTERY KO(709634281)#0051' 6-max (real money) Seat #6 is the button
Seat 1: Backy-le-sdf (19195)
Seat 2: Captaing13 (68240)
Seat 3: EV-MAX (19953)
Seat 4: P1xel7 (20000)
Seat 5: juanKing880 (35406)
Seat 6: Nesta627 (26151)
*** ANTE/BLINDS ***
Backy-le-sdf posts ante 70
Captaing13 posts ante 70
EV-MAX posts ante 70
P1xel7 posts ante 70
juanKing880 posts ante 70
Nesta627 posts ante 70
Backy-le-sdf posts small blind 300
Captaing13 posts big blind 600
Dealt to P1xel7 [Qs 4d]
*** PRE-FLOP *** 
EV-MAX raises 900 to 1500
P1xel7 folds
juanKing880 folds
Nesta627 folds
Backy-le-sdf folds
Captaing13 folds
EV-MAX collected 2820 from pot
*** SUMMARY ***
Total pot 2820 | No rake
Seat 3: EV-MAX won 2820


Winamax Poker - Tournament "MYSTERY KO" buyIn: 0.90€ + 0.10€ level: 7 - HandId: #3047856029015474228-75-1700080348 - Holdem no limit (70/300/600) - 2023/11/15 20:32:28 UTC
Table: 'MYSTERY KO(709634281)#0051' 6-max (real money) Seat #1 is the button
Seat 1: Backy-le-sdf (18825)
Seat 2: Captaing13 (67570)
Seat 3: EV-MAX (21203)
Seat 4: P1xel7 (19930)
Seat 5: juanKing880 (35336)
Seat 6: Nesta627 (26081)
*** ANTE/BLINDS ***
Captaing13 posts ante 70
EV-MAX posts ante 70
Backy-le-sdf posts ante 70
P1xel7 posts ante 70
juanKing880 posts ante 70
Nesta627 posts ante 70
Captaing13 posts small blind 300
EV-MAX posts big blind 600
Dealt to P1xel7 [5c Qh]
*** PRE-FLOP *** 
P1xel7 folds
juanKing880 folds
Nesta627 raises 660 to 1260
Backy-le-sdf folds
Captaing13 folds
EV-MAX folds
Nesta627 collected 2580 from pot
*** SUMMARY ***
Total pot 2580 | No rake
Seat 6: Nesta627 won 2580


Winamax Poker - Tournament "MYSTERY KO" buyIn: 0.90€ + 0.10€ level: 7 - HandId: #3047856029015474228-76-1700080431 - Holdem no limit (70/300/600) - 2023/11/15 20:33:51 UTC
Table: 'MYSTERY KO(709634281)#0051' 6-max (real money) Seat #2 is the button
Seat 1: Backy-le-sdf (18755)
Seat 2: Captaing13 (67200)
Seat 3: EV-MAX (20533)
Seat 4: P1xel7 (19860)
Seat 5: juanKing880 (35266)
Seat 6: Nesta627 (27331)
*** ANTE/BLINDS ***
EV-MAX posts ante 70
P1xel7 posts ante 70
Backy-le-sdf posts ante 70
Captaing13 posts ante 70
juanKing880 posts ante 70
Nesta627 posts ante 70
EV-MAX posts small blind 300
P1xel7 posts big blind 600
Dealt to P1xel7 [Td 8h]
*** PRE-FLOP *** 
juanKing880 folds
Nesta627 folds
Backy-le-sdf folds
Captaing13 folds
EV-MAX folds
P1xel7 collected 1320 from pot
*** SUMMARY ***
Total pot 1320 | No rake
Seat 4: P1xel7 (big blind) won 1320


Winamax Poker - Tournament "MYSTERY KO" buyIn: 0.90€ + 0.10€ level: 7 - HandId: #3047856029015474228-77-1700080452 - Holdem no limit (70/300/600) - 2023/11/15 20:34:12 UTC
Table: 'MYSTERY KO(709634281)#0051' 6-max (real money) Seat #3 is the button
Seat 1: Backy-le-sdf (18685)
Seat 2: Captaing13 (67130)
Seat 3: EV-MAX (20163)
Seat 4: P1xel7 (20510)
Seat 5: juanKing880 (35196)
Seat 6: Nesta627 (27261)
*** ANTE/BLINDS ***
P1xel7 posts ante 70
juanKing880 posts ante 70
Backy-le-sdf posts ante 70
Captaing13 posts ante 70
EV-MAX posts ante 70
Nesta627 posts ante 70
P1xel7 posts small blind 300
juanKing880 posts big blind 600
Dealt to P1xel7 [Ts Tc]
*** PRE-FLOP *** 
Nesta627 folds
Backy-le-sdf folds
Captaing13 folds
EV-MAX raises 600 to 1200
P1xel7 raises 3300 to 4500
juanKing880 folds
EV-MAX folds
P1xel7 collected 6720 from pot
*** SUMMARY ***
Total pot 6720 | No rake
Seat 4: P1xel7 (small blind) won 6720


Winamax Poker - Tournament "MYSTERY KO" buyIn: 0.90€ + 0.10€ level: 7 - HandId: #3047856029015474228-78-1700080500 - Holdem no limit (70/300/600) - 2023/11/15 20:35:00 UTC
Table: 'MYSTERY KO(709634281)#0051' 6-max (real money) Seat #4 is the button
Seat 1: Backy-le-sdf (18615)
Seat 2: Captaing13 (67060)
Seat 3: EV-MAX (18893)
Seat 4: P1xel7 (22660)
Seat 5: juanKing880 (34526)
Seat 6: Nesta627 (27191)
*** ANTE/BLINDS ***
juanKing880 posts ante 70
Nesta627 posts ante 70
Backy-le-sdf posts ante 70
Captaing13 posts ante 70
EV-MAX posts ante 70
P1xel7 posts ante 70
juanKing880 posts small blind 300
Nesta627 posts big blind 600
Dealt to P1xel7 [Ts Ac]
*** PRE-FLOP *** 
Backy-le-sdf folds
Captaing13 folds
EV-MAX raises 900 to 1500
P1xel7 raises 3000 to 4500
juanKing880 folds
Nesta627 folds
EV-MAX calls 3000
*** FLOP *** [8c 6c 4c]
EV-MAX checks
P1xel7 bets 5160
EV-MAX calls 5160
*** TURN *** [8c 6c 4c][2d]
EV-MAX checks
P1xel7 bets 12930 and is all-in
EV-MAX calls 9163 and is all-in
*** RIVER *** [8c 6c 4c 2d][As]
*** SHOW DOWN ***
EV-MAX shows [Ks Qc] (High card : Ace)
P1xel7 shows [Ts Ac] (One pair : Aces)
P1xel7 collected 42733 from pot
*** SUMMARY ***
Total pot 42733 | No rake
Board: [8c 6c 4c 2d As]
Seat 3: EV-MAX showed [Ks Qc] and lost with High card : Ace
Seat 4: P1xel7 (button) showed [Ts Ac] and won 42733 with One pair : Aces


Winamax Poker - Tournament "MYSTERY KO" buyIn: 0.90€ + 0.10€ level: 7 - HandId: #3047856029015474228-79-1700080543 - Holdem no limit (70/300/600) - 2023/11/15 20:35:43 UTC
Table: 'MYSTERY KO(709634281)#0051' 6-max (real money) Seat #5 is the button
Seat 1: Backy-le-sdf (18545)
Seat 2: Captaing13 (66990)
Seat 4: P1xel7 (42733)
Seat 5: juanKing880 (34156)
Seat 6: Nesta627 (26521)
*** ANTE/BLINDS ***
Nesta627 posts ante 70
Backy-le-sdf posts ante 70
Captaing13 posts ante 70
P1xel7 posts ante 70
juanKing880 posts ante 70
Nesta627 posts small blind 300
Backy-le-sdf posts big blind 600
Dealt to P1xel7 [5h 4s]
*** PRE-FLOP *** 
Captaing13 folds
P1xel7 folds
juanKing880 folds
Nesta627 folds
Backy-le-sdf collected 1250 from pot
*** SUMMARY ***
Total pot 1250 | No rake
Seat 1: Backy-le-sdf (big blind) won 1250


Winamax Poker - Tournament "MYSTERY KO" buyIn: 0.90€ + 0.10€ level: 7 - HandId: #3047856029015474228-80-1700080573 - Holdem no limit (70/300/600) - 2023/11/15 20:36:13 UTC
Table: 'MYSTERY KO(709634281)#0051' 6-max (real money) Seat #6 is the button
Seat 1: Backy-le-sdf (19125)
Seat 2: Captaing13 (66920)
Seat 4: P1xel7 (42663)
Seat 5: juanKing880 (34086)
Seat 6: Nesta627 (26151)
*** ANTE/BLINDS ***
Backy-le-sdf posts ante 70
Captaing13 posts ante 70
P1xel7 posts ante 70
juanKing880 posts ante 70
Nesta627 posts ante 70
Backy-le-sdf posts small blind 300
Captaing13 posts big blind 600
Dealt to P1xel7 [7d Th]
*** PRE-FLOP *** 
P1xel7 folds
juanKing880 folds
Nesta627 folds
Backy-le-sdf calls 300
Captaing13 checks
*** FLOP *** [Qd 9s 2c]
Backy-le-sdf checks
Captaing13 checks
*** TURN *** [Qd 9s 2c][2d]
Backy-le-sdf checks
Captaing13 checks
*** RIVER *** [Qd 9s 2c 2d][Ts]
Backy-le-sdf checks
Captaing13 checks
*** SHOW DOWN ***
Captaing13 shows [6d 3s] (One pair : 2)
Backy-le-sdf shows [8d As] (One pair : 2)
Backy-le-sdf collected 1550 from pot
*** SUMMARY ***
Total pot 1550 | No rake
Board: [Qd 9s 2c 2d Ts]
Seat 1: Backy-le-sdf (small blind) showed [8d As] and won 1550 with One pair : 2
Seat 2: Captaing13 (big blind) showed [6d 3s] and lost with One pair : 2


Winamax Poker - Tournament "MYSTERY KO" buyIn: 0.90€ + 0.10€ level: 7 - HandId: #3047856029015474228-81-1700080637 - Holdem no limit (70/300/600) - 2023/11/15 20:37:17 UTC
Table: 'MYSTERY KO(709634281)#0051' 6-max (real money) Seat #1 is the button
Seat 1: Backy-le-sdf (20005)
Seat 2: Captaing13 (66250)
Seat 4: P1xel7 (42593)
Seat 5: juanKing880 (34016)
Seat 6: Nesta627 (26081)
*** ANTE/BLINDS ***
Captaing13 posts ante 70
P1xel7 posts ante 70
Backy-le-sdf posts ante 70
juanKing880 posts ante 70
Nesta627 posts ante 70
Captaing13 posts small blind 300
P1xel7 posts big blind 600
Dealt to P1xel7 [4s 9d]
*** PRE-FLOP *** 
juanKing880 raises 33346 to 33946 and is all-in
Nesta627 folds
Backy-le-sdf folds
Captaing13 folds
P1xel7 folds
juanKing880 collected 35196 from pot
*** SUMMARY ***
Total pot 35196 | No rake
Seat 5: juanKing880 won 35196


Winamax Poker - Tournament "MYSTERY KO" buyIn: 0.90€ + 0.10€ level: 7 - HandId: #3047856029015474228-82-1700080659 - Holdem no limit (70/300/600) - 2023/11/15 20:37:39 UTC
Table: 'MYSTERY KO(709634281)#0051' 6-max (real money) Seat #2 is the button
Seat 1: Backy-le-sdf (19935)
Seat 2: Captaing13 (65880)
Seat 4: P1xel7 (41923)
Seat 5: juanKing880 (35196)
Seat 6: Nesta627 (26011)
*** ANTE/BLINDS ***
P1xel7 posts ante 70
juanKing880 posts ante 70
Backy-le-sdf posts ante 70
Captaing13 posts ante 70
Nesta627 posts ante 70
P1xel7 posts small blind 300
juanKing880 posts big blind 600
Dealt to P1xel7 [Qs 7d]
*** PRE-FLOP *** 
Nesta627 folds
Backy-le-sdf folds
Captaing13 folds
P1xel7 folds
juanKing880 collected 1250 from pot
*** SUMMARY ***
Total pot 1250 | No rake
Seat 5: juanKing880 (big blind) won 1250


Winamax Poker - Tournament "MYSTERY KO" buyIn: 0.90€ + 0.10€ level: 8 - HandId: #3047856029015474228-83-1700080687 - Holdem no limit (80/350/700) - 2023/11/15 20:38:07 UTC
Table: 'MYSTERY KO(709634281)#0051' 6-max (real money) Seat #4 is the button
Seat 1: Backy-le-sdf (19865)
Seat 2: Captaing13 (65810)
Seat 4: P1xel7 (41553)
Seat 5: juanKing880 (35776)
Seat 6: Nesta627 (25941)
*** ANTE/BLINDS ***
juanKing880 posts ante 80
Nesta627 posts ante 80
Backy-le-sdf posts ante 80
Captaing13 posts ante 80
P1xel7 posts ante 80
juanKing880 posts small blind 350
Nesta627 posts big blind 700
Dealt to P1xel7 [Th Jc]
*** PRE-FLOP *** 
Backy-le-sdf raises 700 to 1400
Captaing13 folds
P1xel7 folds
juanKing880 raises 34296 to 35696 and is all-in
Nesta627 folds
Backy-le-sdf folds
juanKing880 collected 38196 from pot
*** SUMMARY ***
Total pot 38196 | No rake
Seat 5: juanKing880 (small blind) won 38196


Winamax Poker - Tournament "MYSTERY KO" buyIn: 0.90€ + 0.10€ level: 8 - HandId: #3047856029015474228-84-1700080721 - Holdem no limit (80/350/700) - 2023/11/15 20:38:41 UTC
Table: 'MYSTERY KO(709634281)#0051' 6-max (real money) Seat #5 is the button
Seat 1: Backy-le-sdf (18385)
Seat 2: Captaing13 (65730)
Seat 3: ChavalBrutal (20000)
Seat 4: P1xel7 (41473)
Seat 5: juanKing880 (38196)
Seat 6: Nesta627 (25161)
*** ANTE/BLINDS ***
Nesta627 posts ante 80
Backy-le-sdf posts ante 80
Captaing13 posts ante 80
ChavalBrutal posts ante 80
P1xel7 posts ante 80
juanKing880 posts ante 80
Nesta627 posts small blind 350
Backy-le-sdf posts big blind 700
Dealt to P1xel7 [7d 4s]
*** PRE-FLOP *** 
Captaing13 raises 1400 to 2100
ChavalBrutal folds
P1xel7 folds
juanKing880 folds
Nesta627 folds
Backy-le-sdf folds
Captaing13 collected 3630 from pot
*** SUMMARY ***
Total pot 3630 | No rake
Seat 2: Captaing13 won 3630


Winamax Poker - Tournament "MYSTERY KO" buyIn: 0.90€ + 0.10€ level: 8 - HandId: #3047856029015474228-85-1700080751 - Holdem no limit (80/350/700) - 2023/11/15 20:39:11 UTC
Table: 'MYSTERY KO(709634281)#0051' 6-max (real money) Seat #6 is the button
Seat 1: Backy-le-sdf (17605)
Seat 2: Captaing13 (67180)
Seat 3: ChavalBrutal (19920)
Seat 4: P1xel7 (41393)
Seat 5: juanKing880 (38116)
Seat 6: Nesta627 (24731)
*** ANTE/BLINDS ***
Backy-le-sdf posts ante 80
Captaing13 posts ante 80
ChavalBrutal posts ante 80
P1xel7 posts ante 80
juanKing880 posts ante 80
Nesta627 posts ante 80
Backy-le-sdf posts small blind 350
Captaing13 posts big blind 700
Dealt to P1xel7 [8s Qd]
*** PRE-FLOP *** 
ChavalBrutal folds
P1xel7 folds
juanKing880 folds
Nesta627 folds
Backy-le-sdf folds
Captaing13 collected 1530 from pot
*** SUMMARY ***
Total pot 1530 | No rake
Seat 2: Captaing13 (big blind) won 1530


Winamax Poker - Tournament "MYSTERY KO" buyIn: 0.90€ + 0.10€ level: 8 - HandId: #3047856029015474228-86-1700080789 - Holdem no limit (80/350/700) - 2023/11/15 20:39:49 UTC
Table: 'MYSTERY KO(709634281)#0051' 6-max (real money) Seat #1 is the button
Seat 1: Backy-le-sdf (17175)
Seat 2: Captaing13 (67930)
Seat 3: ChavalBrutal (19840)
Seat 4: P1xel7 (41313)
Seat 5: juanKing880 (38036)
Seat 6: Nesta627 (24651)
*** ANTE/BLINDS ***
Captaing13 posts ante 80
ChavalBrutal posts ante 80
Backy-le-sdf posts ante 80
P1xel7 posts ante 80
juanKing880 posts ante 80
Nesta627 posts ante 80
Captaing13 posts small blind 350
ChavalBrutal posts big blind 700
Dealt to P1xel7 [8s Ac]
*** PRE-FLOP *** 
P1xel7 folds
juanKing880 folds
Nesta627 raises 770 to 1470
Backy-le-sdf folds
Captaing13 folds
ChavalBrutal raises 18290 to 19760 and is all-in
Nesta627 calls 18290
*** FLOP *** [8c Th 6d]
*** TURN *** [8c Th 6d][6s]
*** RIVER *** [8c Th 6d 6s][Ah]
*** SHOW DOWN ***
ChavalBrutal shows [9c 9s] (Two pairs : 9 and 6)
Nesta627 shows [Qs Ad] (Two pairs : Aces and 6)
Nesta627 collected 40350 from pot
*** SUMMARY ***
Total pot 40350 | No rake
Board: [8c Th 6d 6s Ah]
Seat 3: ChavalBrutal (big blind) showed [9c 9s] and lost with Two pairs : 9 and 6
Seat 6: Nesta627 showed [Qs Ad] and won 40350 with Two pairs : Aces and 6


Winamax Poker - Tournament "MYSTERY KO" buyIn: 0.90€ + 0.10€ level: 8 - HandId: #3047856029015474228-87-1700080881 - Holdem no limit (80/350/700) - 2023/11/15 20:41:21 UTC
Table: 'MYSTERY KO(709634281)#0051' 6-max (real money) Seat #2 is the button
Seat 1: Backy-le-sdf (17095)
Seat 2: Captaing13 (67500)
Seat 4: P1xel7 (41233)
Seat 5: juanKing880 (37956)
Seat 6: Nesta627 (45161)
*** ANTE/BLINDS ***
P1xel7 posts ante 80
Backy-le-sdf posts ante 80
Captaing13 posts ante 80
juanKing880 posts ante 80
Nesta627 posts ante 80
P1xel7 posts big blind 700
Dealt to P1xel7 [Ah 3s]
*** PRE-FLOP *** 
juanKing880 calls 700
Nesta627 folds
Backy-le-sdf folds
Captaing13 raises 700 to 1400
P1xel7 calls 700
juanKing880 calls 700
*** FLOP *** [5s 8s Ts]
P1xel7 checks
juanKing880 bets 700
Captaing13 folds
P1xel7 calls 700
*** TURN *** [5s 8s Ts][Qh]
P1xel7 checks
juanKing880 checks
*** RIVER *** [5s 8s Ts Qh][9h]
P1xel7 bets 3000
juanKing880 folds
P1xel7 collected 9000 from pot
*** SUMMARY ***
Total pot 9000 | No rake
Board: [5s 8s Ts Qh 9h]
Seat 4: P1xel7 (big blind) won 9000


Winamax Poker - Tournament "MYSTERY KO" buyIn: 0.90€ + 0.10€ level: 8 - HandId: #3047856029015474228-88-1700080972 - Holdem no limit (80/350/700) - 2023/11/15 20:42:52 UTC
Table: 'MYSTERY KO(709634281)#0051' 6-max (real money) Seat #3 is the button
Seat 1: Backy-le-sdf (17015)
Seat 2: Captaing13 (66020)
Seat 3: Valadetom17 (20000)
Seat 4: P1xel7 (45053)
Seat 5: juanKing880 (35776)
Seat 6: Nesta627 (45081)
*** ANTE/BLINDS ***
P1xel7 posts ante 80
juanKing880 posts ante 80
Backy-le-sdf posts ante 80
Captaing13 posts ante 80
Nesta627 posts ante 80
P1xel7 posts small blind 350
juanKing880 posts big blind 700
Dealt to P1xel7 [5s 3h]
*** PRE-FLOP *** 
Nesta627 raises 770 to 1470
Backy-le-sdf folds
Captaing13 folds
P1xel7 folds
juanKing880 calls 770
*** FLOP *** [Th Kh 3c]
juanKing880 checks
Nesta627 checks
*** TURN *** [Th Kh 3c][As]
juanKing880 checks
Nesta627 checks
*** RIVER *** [Th Kh 3c As][Ac]
juanKing880 checks
Nesta627 bets 2435
juanKing880 folds
Nesta627 collected 6125 from pot
*** SUMMARY ***
Total pot 6125 | No rake
Board: [Th Kh 3c As Ac]
Seat 6: Nesta627 won 6125


Winamax Poker - Tournament "MYSTERY KO" buyIn: 0.90€ + 0.10€ level: 8 - HandId: #3047856029015474228-89-1700081051 - Holdem no limit (80/350/700) - 2023/11/15 20:44:11 UTC
Table: 'MYSTERY KO(709634281)#0051' 6-max (real money) Seat #4 is the button
Seat 1: Backy-le-sdf (16935)
Seat 2: Captaing13 (65940)
Seat 3: Valadetom17 (20000)
Seat 4: P1xel7 (44623)
Seat 5: juanKing880 (34226)
Seat 6: Nesta627 (47221)
*** ANTE/BLINDS ***
juanKing880 posts ante 80
Nesta627 posts ante 80
Backy-le-sdf posts ante 80
Captaing13 posts ante 80
Valadetom17 posts ante 80
P1xel7 posts ante 80
juanKing880 posts small blind 350
Nesta627 posts big blind 700
Dealt to P1xel7 [3d 9d]
*** PRE-FLOP *** 
Backy-le-sdf raises 700 to 1400
Captaing13 calls 1400
Valadetom17 folds
P1xel7 folds
juanKing880 calls 1050
Nesta627 folds
*** FLOP *** [Js 6d 7d]
juanKing880 checks
Backy-le-sdf bets 3497
Captaing13 folds
juanKing880 folds
Backy-le-sdf collected 8877 from pot
*** SUMMARY ***
Total pot 8877 | No rake
Board: [Js 6d 7d]
Seat 1: Backy-le-sdf won 8877


Winamax Poker - Tournament "MYSTERY KO" buyIn: 0.90€ + 0.10€ level: 8 - HandId: #3047856029015474228-90-1700081094 - Holdem no limit (80/350/700) - 2023/11/15 20:44:54 UTC
Table: 'MYSTERY KO(709634281)#0051' 6-max (real money) Seat #5 is the button
Seat 1: Backy-le-sdf (20835)
Seat 2: Captaing13 (64460)
Seat 3: Valadetom17 (19920)
Seat 4: P1xel7 (44543)
Seat 5: juanKing880 (32746)
Seat 6: Nesta627 (46441)
*** ANTE/BLINDS ***
Nesta627 posts ante 80
Backy-le-sdf posts ante 80
Captaing13 posts ante 80
Valadetom17 posts ante 80
P1xel7 posts ante 80
juanKing880 posts ante 80
Nesta627 posts small blind 350
Backy-le-sdf posts big blind 700
Dealt to P1xel7 [2c 2d]
*** PRE-FLOP *** 
Captaing13 folds
Valadetom17 folds
P1xel7 raises 1400 to 2100
juanKing880 calls 2100
Nesta627 calls 1750
Backy-le-sdf calls 1400
*** FLOP *** [6s 4d 3s]
Nesta627 bets 2930
Backy-le-sdf calls 2930
P1xel7 calls 2930
juanKing880 folds
*** TURN *** [6s 4d 3s][7c]
Nesta627 bets 4418
Backy-le-sdf raises 11307 to 15725 and is all-in
P1xel7 folds
Nesta627 calls 11307
*** RIVER *** [6s 4d 3s 7c][8h]
*** SHOW DOWN ***
Backy-le-sdf shows [9d 9h] (One pair : 9)
Nesta627 shows [8s 7s] (Two pairs : 8 and 7)
Nesta627 collected 49120 from pot
*** SUMMARY ***
Total pot 49120 | No rake
Board: [6s 4d 3s 7c 8h]
Seat 1: Backy-le-sdf (big blind) showed [9d 9h] and lost with One pair : 9
Seat 6: Nesta627 (small blind) showed [8s 7s] and won 49120 with Two pairs : 8 and 7


Winamax Poker - Tournament "MYSTERY KO" buyIn: 0.90€ + 0.10€ level: 9 - HandId: #3047856029015474228-91-1700081182 - Holdem no limit (100/400/800) - 2023/11/15 20:46:22 UTC
Table: 'MYSTERY KO(709634281)#0051' 6-max (real money) Seat #6 is the button
Seat 2: Captaing13 (64380)
Seat 3: Valadetom17 (19840)
Seat 4: P1xel7 (39433)
Seat 5: juanKing880 (30566)
Seat 6: Nesta627 (74726)
*** ANTE/BLINDS ***
Captaing13 posts ante 100
Valadetom17 posts ante 100
P1xel7 posts ante 100
juanKing880 posts ante 100
Nesta627 posts ante 100
Captaing13 posts big blind 800
Dealt to P1xel7 [3h Kh]
*** PRE-FLOP *** 
Valadetom17 folds
P1xel7 folds
juanKing880 folds
Nesta627 raises 880 to 1680
Captaing13 folds
Nesta627 collected 2980 from pot
*** SUMMARY ***
Total pot 2980 | No rake
Seat 6: Nesta627 (button) won 2980


Winamax Poker - Tournament "MYSTERY KO" buyIn: 0.90€ + 0.10€ level: 9 - HandId: #3047856029015474228-92-1700081198 - Holdem no limit (100/400/800) - 2023/11/15 20:46:38 UTC
Table: 'MYSTERY KO(709634281)#0051' 6-max (real money) Seat #1 is the button
Seat 1: Kyrios. (20000)
Seat 2: Captaing13 (63480)
Seat 3: Valadetom17 (19740)
Seat 4: P1xel7 (39333)
Seat 5: juanKing880 (30466)
Seat 6: Nesta627 (75926)
*** ANTE/BLINDS ***
Captaing13 posts ante 100
Valadetom17 posts ante 100
P1xel7 posts ante 100
juanKing880 posts ante 100
Nesta627 posts ante 100
Captaing13 posts small blind 400
Valadetom17 posts big blind 800
Dealt to P1xel7 [Jh 3d]
*** PRE-FLOP *** 
P1xel7 folds
juanKing880 folds
Nesta627 raises 880 to 1680
Captaing13 folds
Valadetom17 calls 880
*** FLOP *** [2s 6h Ks]
Valadetom17 checks
Nesta627 checks
*** TURN *** [2s 6h Ks][5h]
Valadetom17 bets 1491
Nesta627 calls 1491
*** RIVER *** [2s 6h Ks 5h][7s]
Valadetom17 checks
Nesta627 bets 4780
Valadetom17 folds
Nesta627 collected 12022 from pot
*** SUMMARY ***
Total pot 12022 | No rake
Board: [2s 6h Ks 5h 7s]
Seat 6: Nesta627 won 12022


Winamax Poker - Tournament "MYSTERY KO" buyIn: 0.90€ + 0.10€ level: 9 - HandId: #3047856029015474228-93-1700081270 - Holdem no limit (100/400/800) - 2023/11/15 20:47:50 UTC
Table: 'MYSTERY KO(709634281)#0051' 6-max (real money) Seat #2 is the button
Seat 1: Kyrios. (20000)
Seat 2: Captaing13 (62980)
Seat 3: Valadetom17 (16469)
Seat 4: P1xel7 (39233)
Seat 5: juanKing880 (30366)
Seat 6: Nesta627 (79897)
*** ANTE/BLINDS ***
Valadetom17 posts ante 100
P1xel7 posts ante 100
Kyrios. posts ante 100
Captaing13 posts ante 100
juanKing880 posts ante 100
Nesta627 posts ante 100
Valadetom17 posts small blind 400
P1xel7 posts big blind 800
Dealt to P1xel7 [9s 2s]
*** PRE-FLOP *** 
juanKing880 raises 29466 to 30266 and is all-in
Nesta627 folds
Kyrios. folds
Captaing13 folds
Valadetom17 calls 15969 and is all-in
P1xel7 folds
*** FLOP *** [3c 7c 5c]
*** TURN *** [3c 7c 5c][3s]
*** RIVER *** [3c 7c 5c 3s][8d]
*** SHOW DOWN ***
Valadetom17 shows [Th 9h] (One pair : 3)
juanKing880 shows [Kh Kd] (Two pairs : Kings and 3)
juanKing880 collected 48035 from pot
*** SUMMARY ***
Total pot 48035 | No rake
Board: [3c 7c 5c 3s 8d]
Seat 3: Valadetom17 (small blind) showed [Th 9h] and lost with One pair : 3
Seat 5: juanKing880 showed [Kh Kd] and won 48035 with Two pairs : Kings and 3


Winamax Poker - Tournament "MYSTERY KO" buyIn: 0.90€ + 0.10€ level: 9 - HandId: #3047856029015474228-94-1700081312 - Holdem no limit (100/400/800) - 2023/11/15 20:48:32 UTC
Table: 'MYSTERY KO(709634281)#0051' 6-max (real money) Seat #3 is the button
Seat 1: Kyrios. (19900)
Seat 2: Captaing13 (62880)
Seat 4: P1xel7 (38333)
Seat 5: juanKing880 (48035)
Seat 6: Nesta627 (79797)
*** ANTE/BLINDS ***
P1xel7 posts ante 100
juanKing880 posts ante 100
Kyrios. posts ante 100
Captaing13 posts ante 100
Nesta627 posts ante 100
P1xel7 posts small blind 400
juanKing880 posts big blind 800
Dealt to P1xel7 [Jc Kd]
*** PRE-FLOP *** 
Nesta627 folds
Kyrios. folds
Captaing13 folds
P1xel7 raises 1600 to 2400
juanKing880 folds
P1xel7 collected 3700 from pot
*** SUMMARY ***
Total pot 3700 | No rake
Seat 4: P1xel7 (small blind) won 3700


Winamax Poker - Tournament "MYSTERY KO" buyIn: 0.90€ + 0.10€ level: 9 - HandId: #3047856029015474228-95-1700081341 - Holdem no limit (100/400/800) - 2023/11/15 20:49:01 UTC
Table: 'MYSTERY KO(709634281)#0051' 6-max (real money) Seat #4 is the button
Seat 1: Kyrios. (19800)
Seat 2: Captaing13 (62780)
Seat 4: P1xel7 (39533)
Seat 5: juanKing880 (47135)
Seat 6: Nesta627 (79697)
*** ANTE/BLINDS ***
juanKing880 posts ante 100
Nesta627 posts ante 100
Kyrios. posts ante 100
Captaing13 posts ante 100
P1xel7 posts ante 100
juanKing880 posts small blind 400
Nesta627 posts big blind 800
Dealt to P1xel7 [2h 4h]
*** PRE-FLOP *** 
Kyrios. folds
Captaing13 folds
P1xel7 folds
juanKing880 folds
Nesta627 collected 1700 from pot
*** SUMMARY ***
Total pot 1700 | No rake
Seat 6: Nesta627 (big blind) won 1700


Winamax Poker - Tournament "MYSTERY KO" buyIn: 0.90€ + 0.10€ level: 9 - HandId: #3047856029015474228-96-1700081356 - Holdem no limit (100/400/800) - 2023/11/15 20:49:16 UTC
Table: 'MYSTERY KO(709634281)#0051' 6-max (real money) Seat #5 is the button
Seat 1: Kyrios. (19700)
Seat 2: Captaing13 (62680)
Seat 4: P1xel7 (39433)
Seat 5: juanKing880 (46635)
Seat 6: Nesta627 (80497)
*** ANTE/BLINDS ***
Nesta627 posts ante 100
Kyrios. posts ante 100
Captaing13 posts ante 100
P1xel7 posts ante 100
juanKing880 posts ante 100
Nesta627 posts small blind 400
Kyrios. posts big blind 800
Dealt to P1xel7 [6d 9h]
*** PRE-FLOP *** 
Captaing13 folds
P1xel7 folds
juanKing880 raises 45735 to 46535 and is all-in
Nesta627 folds
Kyrios. folds
juanKing880 collected 48235 from pot
*** SUMMARY ***
Total pot 48235 | No rake
Seat 5: juanKing880 (button) won 48235


Winamax Poker - Tournament "MYSTERY KO" buyIn: 0.90€ + 0.10€ level: 9 - HandId: #3047856029015474228-97-1700081385 - Holdem no limit (100/400/800) - 2023/11/15 20:49:45 UTC
Table: 'MYSTERY KO(709634281)#0051' 6-max (real money) Seat #6 is the button
Seat 1: Kyrios. (18800)
Seat 2: Captaing13 (62580)
Seat 4: P1xel7 (39333)
Seat 5: juanKing880 (48235)
Seat 6: Nesta627 (79997)
*** ANTE/BLINDS ***
Kyrios. posts ante 100
Captaing13 posts ante 100
P1xel7 posts ante 100
juanKing880 posts ante 100
Nesta627 posts ante 100
Kyrios. posts small blind 400
Captaing13 posts big blind 800
Dealt to P1xel7 [Ks 3h]
*** PRE-FLOP *** 
P1xel7 folds
juanKing880 folds
Nesta627 raises 880 to 1680
Kyrios. folds
Captaing13 folds
Nesta627 collected 3380 from pot
*** SUMMARY ***
Total pot 3380 | No rake
Seat 6: Nesta627 (button) won 3380


Winamax Poker - Tournament "MYSTERY KO" buyIn: 0.90€ + 0.10€ level: 9 - HandId: #3047856029015474228-98-1700081408 - Holdem no limit (100/400/800) - 2023/11/15 20:50:08 UTC
Table: 'MYSTERY KO(709634281)#0051' 6-max (real money) Seat #1 is the button
Seat 1: Kyrios. (18300)
Seat 2: Captaing13 (61680)
Seat 3: Macgyver422 (20000)
Seat 4: P1xel7 (39233)
Seat 5: juanKing880 (48135)
Seat 6: Nesta627 (81597)
*** ANTE/BLINDS ***
Captaing13 posts ante 100
Macgyver422 posts ante 100
Kyrios. posts ante 100
P1xel7 posts ante 100
juanKing880 posts ante 100
Nesta627 posts ante 100
Captaing13 posts small blind 400
Macgyver422 posts big blind 800
Dealt to P1xel7 [Kh 2h]
*** PRE-FLOP *** 
P1xel7 folds
juanKing880 folds
Nesta627 folds
Kyrios. folds
Captaing13 raises 800 to 1600
Macgyver422 folds
Captaing13 collected 3000 from pot
*** SUMMARY ***
Total pot 3000 | No rake
Seat 2: Captaing13 (small blind) won 3000


Winamax Poker - Tournament "MYSTERY KO" buyIn: 0.90€ + 0.10€ level: 9 - HandId: #3047856029015474228-99-1700081431 - Holdem no limit (100/400/800) - 2023/11/15 20:50:31 UTC
Table: 'MYSTERY KO(709634281)#0051' 6-max (real money) Seat #2 is the button
Seat 1: Kyrios. (18200)
Seat 2: Captaing13 (62980)
Seat 3: Macgyver422 (19100)
Seat 4: P1xel7 (39133)
Seat 5: juanKing880 (48035)
Seat 6: Nesta627 (81497)
*** ANTE/BLINDS ***
Macgyver422 posts ante 100
P1xel7 posts ante 100
Kyrios. posts ante 100
Captaing13 posts ante 100
juanKing880 posts ante 100
Nesta627 posts ante 100
Macgyver422 posts small blind 400
P1xel7 posts big blind 800
Dealt to P1xel7 [2d Kh]
*** PRE-FLOP *** 
juanKing880 folds
Nesta627 folds
Kyrios. folds
Captaing13 folds
Macgyver422 folds
P1xel7 collected 1800 from pot
*** SUMMARY ***
Total pot 1800 | No rake
Seat 4: P1xel7 (big blind) won 1800


Winamax Poker - Tournament "MYSTERY KO" buyIn: 0.90€ + 0.10€ level: 9 - HandId: #3047856029015474228-100-1700081443 - Holdem no limit (100/400/800) - 2023/11/15 20:50:43 UTC
Table: 'MYSTERY KO(709634281)#0051' 6-max (real money) Seat #3 is the button
Seat 1: Kyrios. (18100)
Seat 2: Captaing13 (62880)
Seat 3: Macgyver422 (18600)
Seat 4: P1xel7 (40033)
Seat 5: juanKing880 (47935)
Seat 6: Nesta627 (81397)
*** ANTE/BLINDS ***
P1xel7 posts ante 100
juanKing880 posts ante 100
Kyrios. posts ante 100
Captaing13 posts ante 100
Macgyver422 posts ante 100
Nesta627 posts ante 100
P1xel7 posts small blind 400
juanKing880 posts big blind 800
Dealt to P1xel7 [2c 4c]
*** PRE-FLOP *** 
Nesta627 folds
Kyrios. raises 880 to 1680
Captaing13 raises 3360 to 5040
Macgyver422 folds
P1xel7 folds
juanKing880 folds
Kyrios. raises 12960 to 18000 and is all-in
Captaing13 calls 12960
*** FLOP *** [3h 6s 9s]
*** TURN *** [3h 6s 9s][9h]
*** RIVER *** [3h 6s 9s 9h][Kc]
*** SHOW DOWN ***
Kyrios. shows [Ad 5h] (One pair : 9)
Captaing13 shows [Js Jd] (Two pairs : Jacks and 9)
Captaing13 collected 37800 from pot
*** SUMMARY ***
Total pot 37800 | No rake
Board: [3h 6s 9s 9h Kc]
Seat 1: Kyrios. showed [Ad 5h] and lost with One pair : 9
Seat 2: Captaing13 showed [Js Jd] and won 37800 with Two pairs : Jacks and 9


Winamax Poker - Tournament "MYSTERY KO" buyIn: 0.90€ + 0.10€ level: 9 - HandId: #3047856029015474228-101-1700081496 - Holdem no limit (100/400/800) - 2023/11/15 20:51:36 UTC
Table: 'MYSTERY KO(709634281)#0051' 6-max (real money) Seat #4 is the button
Seat 2: Captaing13 (82580)
Seat 3: Macgyver422 (18500)
Seat 4: P1xel7 (39533)
Seat 5: juanKing880 (47035)
Seat 6: Nesta627 (81297)
*** ANTE/BLINDS ***
juanKing880 posts ante 100
Nesta627 posts ante 100
Captaing13 posts ante 100
Macgyver422 posts ante 100
P1xel7 posts ante 100
juanKing880 posts small blind 400
Nesta627 posts big blind 800
Dealt to P1xel7 [Qc Jc]
*** PRE-FLOP *** 
Captaing13 folds
Macgyver422 folds
P1xel7 raises 2000 to 2800
juanKing880 calls 2400
Nesta627 folds
*** FLOP *** [5s 9s 7s]
juanKing880 bets 800
P1xel7 calls 800
*** TURN *** [5s 9s 7s][Ah]
juanKing880 bets 5525
P1xel7 folds
juanKing880 collected 14025 from pot
*** SUMMARY ***
Total pot 14025 | No rake
Board: [5s 9s 7s Ah]
Seat 5: juanKing880 (small blind) won 14025


Winamax Poker - Tournament "MYSTERY KO" buyIn: 0.90€ + 0.10€ level: 10 - HandId: #3047856029015474228-102-1700081560 - Holdem no limit (120/500/1000) - 2023/11/15 20:52:40 UTC
Table: 'MYSTERY KO(709634281)#0051' 6-max (real money) Seat #5 is the button
Seat 1: -Kaneki- (25371)
Seat 2: Captaing13 (82480)
Seat 3: Macgyver422 (18400)
Seat 4: P1xel7 (35833)
Seat 5: juanKing880 (51835)
Seat 6: Nesta627 (80397)
*** ANTE/BLINDS ***
Nesta627 posts ante 120
-Kaneki- posts ante 120
Captaing13 posts ante 120
Macgyver422 posts ante 120
P1xel7 posts ante 120
juanKing880 posts ante 120
Nesta627 posts small blind 500
-Kaneki- posts big blind 1000
Dealt to P1xel7 [7s 8d]
*** PRE-FLOP *** 
Captaing13 raises 1000 to 2000
Macgyver422 folds
P1xel7 folds
juanKing880 folds
Nesta627 folds
-Kaneki- calls 1000
*** FLOP *** [As Kc Kd]
-Kaneki- checks
Captaing13 checks
*** TURN *** [As Kc Kd][7c]
-Kaneki- checks
Captaing13 bets 2610
-Kaneki- folds
Captaing13 collected 7830 from pot
*** SUMMARY ***
Total pot 7830 | No rake
Board: [As Kc Kd 7c]
Seat 2: Captaing13 won 7830


Winamax Poker - Tournament "MYSTERY KO" buyIn: 0.90€ + 0.10€ level: 10 - HandId: #3047856029015474228-103-1700081607 - Holdem no limit (120/500/1000) - 2023/11/15 20:53:27 UTC
Table: 'MYSTERY KO(709634281)#0051' 6-max (real money) Seat #6 is the button
Seat 1: -Kaneki- (23251)
Seat 2: Captaing13 (85580)
Seat 3: Macgyver422 (18280)
Seat 4: P1xel7 (35713)
Seat 5: juanKing880 (51715)
Seat 6: Nesta627 (79777)
*** ANTE/BLINDS ***
-Kaneki- posts ante 120
Captaing13 posts ante 120
Macgyver422 posts ante 120
P1xel7 posts ante 120
juanKing880 posts ante 120
Nesta627 posts ante 120
-Kaneki- posts small blind 500
Captaing13 posts big blind 1000
Dealt to P1xel7 [8d Ah]
*** PRE-FLOP *** 
Macgyver422 folds
P1xel7 folds
juanKing880 folds
Nesta627 raises 1100 to 2100
-Kaneki- folds
Captaing13 folds
Nesta627 collected 4320 from pot
*** SUMMARY ***
Total pot 4320 | No rake
Seat 6: Nesta627 (button) won 4320


Winamax Poker - Tournament "MYSTERY KO" buyIn: 0.90€ + 0.10€ level: 10 - HandId: #3047856029015474228-104-1700081654 - Holdem no limit (120/500/1000) - 2023/11/15 20:54:14 UTC
Table: 'MYSTERY KO(709634281)#0051' 6-max (real money) Seat #1 is the button
Seat 1: -Kaneki- (22631)
Seat 2: Captaing13 (84460)
Seat 3: Macgyver422 (18160)
Seat 4: P1xel7 (35593)
Seat 5: juanKing880 (51595)
Seat 6: Nesta627 (81877)
*** ANTE/BLINDS ***
Captaing13 posts ante 120
Macgyver422 posts ante 120
-Kaneki- posts ante 120
P1xel7 posts ante 120
juanKing880 posts ante 120
Nesta627 posts ante 120
Captaing13 posts small blind 500
Macgyver422 posts big blind 1000
Dealt to P1xel7 [5s 7h]
*** PRE-FLOP *** 
P1xel7 folds
juanKing880 folds
Nesta627 folds
-Kaneki- raises 1250 to 2250
Captaing13 folds
Macgyver422 folds
-Kaneki- collected 4470 from pot
*** SUMMARY ***
Total pot 4470 | No rake
Seat 1: -Kaneki- (button) won 4470


Winamax Poker - Tournament "MYSTERY KO" buyIn: 0.90€ + 0.10€ level: 10 - HandId: #3047856029015474228-105-1700081683 - Holdem no limit (120/500/1000) - 2023/11/15 20:54:43 UTC
Table: 'MYSTERY KO(709634281)#0051' 6-max (real money) Seat #2 is the button
Seat 1: -Kaneki- (24731)
Seat 2: Captaing13 (83840)
Seat 3: Macgyver422 (17040)
Seat 4: P1xel7 (35473)
Seat 5: juanKing880 (51475)
Seat 6: Nesta627 (81757)
*** ANTE/BLINDS ***
Macgyver422 posts ante 120
P1xel7 posts ante 120
-Kaneki- posts ante 120
Captaing13 posts ante 120
juanKing880 posts ante 120
Nesta627 posts ante 120
Macgyver422 posts small blind 500
P1xel7 posts big blind 1000
Dealt to P1xel7 [4h 6s]
*** PRE-FLOP *** 
juanKing880 calls 1000
Nesta627 folds
-Kaneki- raises 1250 to 2250
Captaing13 raises 4500 to 6750
Macgyver422 folds
P1xel7 folds
juanKing880 calls 5750
-Kaneki- folds
*** FLOP *** [Kd Qs 3s]
juanKing880 checks
Captaing13 checks
*** TURN *** [Kd Qs 3s][8h]
juanKing880 bets 1000
Captaing13 raises 6340 to 7340
juanKing880 raises 37265 to 44605 and is all-in
Captaing13 folds
juanKing880 collected 69915 from pot
*** SUMMARY ***
Total pot 69915 | No rake
Board: [Kd Qs 3s 8h]
Seat 5: juanKing880 won 69915


Winamax Poker - Tournament "MYSTERY KO" buyIn: 0.90€ + 0.10€ level: 10 - HandId: #3047856029015474228-106-1700082061 - Holdem no limit (120/500/1000) - 2023/11/15 21:01:01 UTC
Table: 'MYSTERY KO(709634281)#0051' 6-max (real money) Seat #3 is the button
Seat 1: -Kaneki- (22361)
Seat 2: Captaing13 (69630)
Seat 3: Macgyver422 (16420)
Seat 4: P1xel7 (34353)
Seat 5: juanKing880 (69915)
Seat 6: Nesta627 (81637)
*** ANTE/BLINDS ***
P1xel7 posts ante 120
juanKing880 posts ante 120
-Kaneki- posts ante 120
Captaing13 posts ante 120
Macgyver422 posts ante 120
Nesta627 posts ante 120
P1xel7 posts small blind 500
juanKing880 posts big blind 1000
Dealt to P1xel7 [5c 8h]
*** PRE-FLOP *** 
Nesta627 raises 1100 to 2100
-Kaneki- folds
Captaing13 calls 2100
Macgyver422 folds
P1xel7 folds
juanKing880 calls 1100
*** FLOP *** [9h Js 6h]
juanKing880 checks
Nesta627 checks
Captaing13 checks
*** TURN *** [9h Js 6h][Qc]
juanKing880 checks
Nesta627 checks
Captaing13 checks
*** RIVER *** [9h Js 6h Qc][3h]
juanKing880 checks
Nesta627 checks
Captaing13 checks
*** SHOW DOWN ***
Captaing13 shows [Kd Ad] (High card : Ace)
juanKing880 shows [2d 5d] (High card : Queen)
Nesta627 shows [As 3c] (One pair : 3)
Nesta627 collected 7520 from pot
*** SUMMARY ***
Total pot 7520 | No rake
Board: [9h Js 6h Qc 3h]
Seat 2: Captaing13 showed [Kd Ad] and lost with High card : Ace
Seat 5: juanKing880 (big blind) showed [2d 5d] and lost with High card : Queen
Seat 6: Nesta627 showed [As 3c] and won 7520 with One pair : 3


Winamax Poker - Tournament "MYSTERY KO" buyIn: 0.90€ + 0.10€ level: 10 - HandId: #3047856029015474228-107-1700082241 - Holdem no limit (120/500/1000) - 2023/11/15 21:04:01 UTC
Table: 'MYSTERY KO(709634281)#0051' 6-max (real money) Seat #4 is the button
Seat 1: -Kaneki- (22241)
Seat 2: Captaing13 (67410)
Seat 3: Macgyver422 (16300)
Seat 4: P1xel7 (33733)
Seat 5: juanKing880 (67695)
Seat 6: Nesta627 (86937)
*** ANTE/BLINDS ***
juanKing880 posts ante 120
Nesta627 posts ante 120
-Kaneki- posts ante 120
Captaing13 posts ante 120
Macgyver422 posts ante 120
P1xel7 posts ante 120
juanKing880 posts small blind 500
Nesta627 posts big blind 1000
Dealt to P1xel7 [Qh 9c]
*** PRE-FLOP *** 
-Kaneki- folds
Captaing13 folds
Macgyver422 folds
P1xel7 raises 1500 to 2500
juanKing880 folds
Nesta627 calls 1500
*** FLOP *** [Ts 5h Tc]
Nesta627 checks
P1xel7 bets 4043
Nesta627 folds
P1xel7 collected 10263 from pot
*** SUMMARY ***
Total pot 10263 | No rake
Board: [Ts 5h Tc]
Seat 4: P1xel7 (button) won 10263


Winamax Poker - Tournament "MYSTERY KO" buyIn: 0.90€ + 0.10€ level: 11 - HandId: #3047856029015474228-108-1700082315 - Holdem no limit (140/600/1200) - 2023/11/15 21:05:15 UTC
Table: 'MYSTERY KO(709634281)#0051' 6-max (real money) Seat #5 is the button
Seat 1: -Kaneki- (22121)
Seat 2: Captaing13 (67290)
Seat 3: Macgyver422 (16180)
Seat 4: P1xel7 (37333)
Seat 5: juanKing880 (67075)
Seat 6: Nesta627 (84317)
*** ANTE/BLINDS ***
Nesta627 posts ante 140
-Kaneki- posts ante 140
Captaing13 posts ante 140
Macgyver422 posts ante 140
P1xel7 posts ante 140
juanKing880 posts ante 140
Nesta627 posts small blind 600
-Kaneki- posts big blind 1200
Dealt to P1xel7 [2c 3s]
*** PRE-FLOP *** 
Captaing13 raises 2400 to 3600
Macgyver422 folds
P1xel7 folds
juanKing880 folds
Nesta627 raises 10800 to 14400
-Kaneki- folds
Captaing13 folds
Nesta627 collected 20040 from pot
*** SUMMARY ***
Total pot 20040 | No rake
Seat 6: Nesta627 (small blind) won 20040


Winamax Poker - Tournament "MYSTERY KO" buyIn: 0.90€ + 0.10€ level: 11 - HandId: #3047856029015474228-109-1700082344 - Holdem no limit (140/600/1200) - 2023/11/15 21:05:44 UTC
Table: 'MYSTERY KO(709634281)#0051' 6-max (real money) Seat #6 is the button
Seat 1: -Kaneki- (20781)
Seat 2: Captaing13 (63550)
Seat 3: Macgyver422 (16040)
Seat 4: P1xel7 (37193)
Seat 5: juanKing880 (66935)
Seat 6: Nesta627 (89817)
*** ANTE/BLINDS ***
-Kaneki- posts ante 140
Captaing13 posts ante 140
Macgyver422 posts ante 140
P1xel7 posts ante 140
juanKing880 posts ante 140
Nesta627 posts ante 140
-Kaneki- posts small blind 600
Captaing13 posts big blind 1200
Dealt to P1xel7 [3c Js]
*** PRE-FLOP *** 
Macgyver422 folds
P1xel7 folds
juanKing880 folds
Nesta627 raises 1320 to 2520
-Kaneki- calls 1920
Captaing13 folds
*** FLOP *** [Tc 9s 6c]
-Kaneki- checks
Nesta627 bets 2336
-Kaneki- calls 2336
*** TURN *** [Tc 9s 6c][5d]
-Kaneki- checks
Nesta627 bets 3878
-Kaneki- folds
Nesta627 collected 15630 from pot
*** SUMMARY ***
Total pot 15630 | No rake
Board: [Tc 9s 6c 5d]
Seat 6: Nesta627 (button) won 15630


Winamax Poker - Tournament "MYSTERY KO" buyIn: 0.90€ + 0.10€ level: 11 - HandId: #3047856029015474228-110-1700082403 - Holdem no limit (140/600/1200) - 2023/11/15 21:06:43 UTC
Table: 'MYSTERY KO(709634281)#0051' 6-max (real money) Seat #1 is the button
Seat 1: -Kaneki- (15785)
Seat 2: Captaing13 (62210)
Seat 3: Macgyver422 (15900)
Seat 4: P1xel7 (37053)
Seat 5: juanKing880 (66795)
Seat 6: Nesta627 (96573)
*** ANTE/BLINDS ***
Captaing13 posts ante 140
Macgyver422 posts ante 140
-Kaneki- posts ante 140
P1xel7 posts ante 140
juanKing880 posts ante 140
Nesta627 posts ante 140
Captaing13 posts small blind 600
Macgyver422 posts big blind 1200
Dealt to P1xel7 [5h 4s]
*** PRE-FLOP *** 
P1xel7 folds
juanKing880 calls 1200
Nesta627 raises 4800 to 6000
-Kaneki- folds
Captaing13 folds
Macgyver422 folds
juanKing880 folds
Nesta627 collected 9840 from pot
*** SUMMARY ***
Total pot 9840 | No rake
Seat 6: Nesta627 won 9840


Winamax Poker - Tournament "MYSTERY KO" buyIn: 0.90€ + 0.10€ level: 11 - HandId: #3047856029015474228-111-1700082465 - Holdem no limit (140/600/1200) - 2023/11/15 21:07:45 UTC
Table: 'MYSTERY KO(709634281)#0051' 6-max (real money) Seat #2 is the button
Seat 1: -Kaneki- (15645)
Seat 2: Captaing13 (61470)
Seat 3: Macgyver422 (14560)
Seat 4: P1xel7 (36913)
Seat 5: juanKing880 (65455)
Seat 6: Nesta627 (100273)
*** ANTE/BLINDS ***
Macgyver422 posts ante 140
P1xel7 posts ante 140
-Kaneki- posts ante 140
Captaing13 posts ante 140
juanKing880 posts ante 140
Nesta627 posts ante 140
Macgyver422 posts small blind 600
P1xel7 posts big blind 1200
Dealt to P1xel7 [Ac Jc]
*** PRE-FLOP *** 
juanKing880 calls 1200
Nesta627 raises 3600 to 4800
-Kaneki- raises 10705 to 15505 and is all-in
Captaing13 folds
Macgyver422 folds
P1xel7 calls 14305
juanKing880 folds
Nesta627 folds
*** FLOP *** [As Qs Ts]
*** TURN *** [As Qs Ts][Th]
*** RIVER *** [As Qs Ts Th][9h]
*** SHOW DOWN ***
-Kaneki- shows [Js Jh] (Two pairs : Jacks and Tens)
P1xel7 shows [Ac Jc] (Two pairs : Aces and Tens)
P1xel7 collected 38450 from pot
*** SUMMARY ***
Total pot 38450 | No rake
Board: [As Qs Ts Th 9h]
Seat 1: -Kaneki- showed [Js Jh] and lost with Two pairs : Jacks and Tens
Seat 4: P1xel7 (big blind) showed [Ac Jc] and won 38450 with Two pairs : Aces and Tens


Winamax Poker - Tournament "MYSTERY KO" buyIn: 0.90€ + 0.10€ level: 11 - HandId: #3047856029015474228-112-1700082529 - Holdem no limit (140/600/1200) - 2023/11/15 21:08:49 UTC
Table: 'MYSTERY KO(709634281)#0051' 6-max (real money) Seat #3 is the button
Seat 2: Captaing13 (61330)
Seat 3: Macgyver422 (13820)
Seat 4: P1xel7 (59718)
Seat 5: juanKing880 (64115)
Seat 6: Nesta627 (95333)
*** ANTE/BLINDS ***
P1xel7 posts ante 140
juanKing880 posts ante 140
Captaing13 posts ante 140
Macgyver422 posts ante 140
Nesta627 posts ante 140
P1xel7 posts small blind 600
juanKing880 posts big blind 1200
Dealt to P1xel7 [Kc Kd]
*** PRE-FLOP *** 
Nesta627 folds
Captaing13 folds
Macgyver422 raises 12480 to 13680 and is all-in
P1xel7 calls 13080
juanKing880 folds
*** FLOP *** [4h 9d 6d]
*** TURN *** [4h 9d 6d][Tc]
*** RIVER *** [4h 9d 6d Tc][2d]
*** SHOW DOWN ***
P1xel7 shows [Kc Kd] (One pair : Kings)
Macgyver422 shows [Qd 8d] (Flush Queen high)
Macgyver422 collected 29260 from pot
*** SUMMARY ***
Total pot 29260 | No rake
Board: [4h 9d 6d Tc 2d]
Seat 3: Macgyver422 (button) showed [Qd 8d] and won 29260 with Flush Queen high
Seat 4: P1xel7 (small blind) showed [Kc Kd] and lost with One pair : Kings


Winamax Poker - Tournament "MYSTERY KO" buyIn: 0.90€ + 0.10€ level: 11 - HandId: #3047856029015474228-113-1700082567 - Holdem no limit (140/600/1200) - 2023/11/15 21:09:27 UTC
Table: 'MYSTERY KO(709634281)#0051' 6-max (real money) Seat #4 is the button
Seat 1: Prune.261256 (52274)
Seat 2: Captaing13 (61190)
Seat 3: Macgyver422 (29260)
Seat 4: P1xel7 (45898)
Seat 5: juanKing880 (62775)
Seat 6: Nesta627 (95193)
*** ANTE/BLINDS ***
juanKing880 posts ante 140
Nesta627 posts ante 140
Prune.261256 posts ante 140
Captaing13 posts ante 140
Macgyver422 posts ante 140
P1xel7 posts ante 140
juanKing880 posts small blind 600
Nesta627 posts big blind 1200
Dealt to P1xel7 [9h Th]
*** PRE-FLOP *** 
Prune.261256 calls 1200
Captaing13 folds
Macgyver422 folds
P1xel7 folds
juanKing880 folds
Nesta627 raises 3000 to 4200
Prune.261256 calls 3000
*** FLOP *** [5s Kc Jd]
Nesta627 bets 3247
Prune.261256 calls 3247
*** TURN *** [5s Kc Jd][4s]
Nesta627 bets 10780
Prune.261256 folds
Nesta627 collected 27114 from pot
*** SUMMARY ***
Total pot 27114 | No rake
Board: [5s Kc Jd 4s]
Seat 6: Nesta627 (big blind) won 27114


Winamax Poker - Tournament "MYSTERY KO" buyIn: 0.90€ + 0.10€ level: 11 - HandId: #3047856029015474228-114-1700082632 - Holdem no limit (140/600/1200) - 2023/11/15 21:10:32 UTC
Table: 'MYSTERY KO(709634281)#0051' 6-max (real money) Seat #5 is the button
Seat 1: Prune.261256 (44687)
Seat 2: Captaing13 (61050)
Seat 3: Macgyver422 (29120)
Seat 4: P1xel7 (45758)
Seat 5: juanKing880 (62035)
Seat 6: Nesta627 (103940)
*** ANTE/BLINDS ***
Nesta627 posts ante 140
Prune.261256 posts ante 140
Captaing13 posts ante 140
Macgyver422 posts ante 140
P1xel7 posts ante 140
juanKing880 posts ante 140
Nesta627 posts small blind 600
Prune.261256 posts big blind 1200
Dealt to P1xel7 [9d 6c]
*** PRE-FLOP *** 
Captaing13 folds
Macgyver422 folds
P1xel7 folds
juanKing880 folds
Nesta627 raises 3000 to 4200
Prune.261256 calls 3000
*** FLOP *** [Tc Td Kc]
Nesta627 bets 3600
Prune.261256 raises 3600 to 7200
Nesta627 calls 3600
*** TURN *** [Tc Td Kc][Qd]
Nesta627 checks
Prune.261256 bets 33147 and is all-in
Nesta627 calls 33147
*** RIVER *** [Tc Td Kc Qd][Js]
*** SHOW DOWN ***
Prune.261256 shows [5h 8h] (One pair : Tens)
Nesta627 shows [Ah Qh] (Straight Ace high)
Nesta627 collected 89934 from pot
*** SUMMARY ***
Total pot 89934 | No rake
Board: [Tc Td Kc Qd Js]
Seat 1: Prune.261256 (big blind) showed [5h 8h] and lost with One pair : Tens
Seat 6: Nesta627 (small blind) showed [Ah Qh] and won 89934 with Straight Ace high


Winamax Poker - Tournament "MYSTERY KO" buyIn: 0.90€ + 0.10€ level: 11 - HandId: #3047856029015474228-115-1700082688 - Holdem no limit (140/600/1200) - 2023/11/15 21:11:28 UTC
Table: 'MYSTERY KO(709634281)#0051' 6-max (real money) Seat #6 is the button
Seat 2: Captaing13 (60910)
Seat 3: Macgyver422 (28980)
Seat 4: P1xel7 (45618)
Seat 5: juanKing880 (61895)
Seat 6: Nesta627 (149187)
*** ANTE/BLINDS ***
Captaing13 posts ante 140
Macgyver422 posts ante 140
P1xel7 posts ante 140
juanKing880 posts ante 140
Nesta627 posts ante 140
Captaing13 posts big blind 1200
Dealt to P1xel7 [3s 8d]
*** PRE-FLOP *** 
Macgyver422 folds
P1xel7 folds
juanKing880 calls 1200
Nesta627 raises 4800 to 6000
Captaing13 calls 4800
juanKing880 calls 4800
*** FLOP *** [Ah Tc Kh]
Captaing13 checks
juanKing880 bets 6545
Nesta627 calls 6545
Captaing13 calls 6545
*** TURN *** [Ah Tc Kh][9h]
Captaing13 checks
juanKing880 bets 1200
Nesta627 raises 12639 to 13839
Captaing13 folds
juanKing880 folds
Nesta627 collected 53374 from pot
*** SUMMARY ***
Total pot 53374 | No rake
Board: [Ah Tc Kh 9h]
Seat 6: Nesta627 (button) won 53374


Winamax Poker - Tournament "MYSTERY KO" buyIn: 0.90€ + 0.10€ level: 12 - HandId: #3047856029015474228-116-1700082787 - Holdem no limit (160/700/1400) - 2023/11/15 21:13:07 UTC
Table: 'MYSTERY KO(709634281)#0051' 6-max (real money) Seat #1 is the button
Seat 1: Kourah (61662)
Seat 2: Captaing13 (48225)
Seat 3: Macgyver422 (28840)
Seat 4: P1xel7 (45478)
Seat 5: juanKing880 (48010)
Seat 6: Nesta627 (176037)
*** ANTE/BLINDS ***
Captaing13 posts ante 160
Macgyver422 posts ante 160
P1xel7 posts ante 160
juanKing880 posts ante 160
Nesta627 posts ante 160
Captaing13 posts small blind 700
Macgyver422 posts big blind 1400
Dealt to P1xel7 [Kh 3d]
*** PRE-FLOP *** 
P1xel7 folds
juanKing880 folds
Nesta627 folds
Captaing13 folds
Macgyver422 collected 2900 from pot
*** SUMMARY ***
Total pot 2900 | No rake
Seat 3: Macgyver422 (big blind) won 2900


Winamax Poker - Tournament "MYSTERY KO" buyIn: 0.90€ + 0.10€ level: 12 - HandId: #3047856029015474228-117-1700082808 - Holdem no limit (160/700/1400) - 2023/11/15 21:13:28 UTC
Table: 'MYSTERY KO(709634281)#0051' 6-max (real money) Seat #2 is the button
Seat 1: Kourah (61662)
Seat 2: Captaing13 (47365)
Seat 3: Macgyver422 (30180)
Seat 4: P1xel7 (45318)
Seat 5: juanKing880 (47850)
Seat 6: Nesta627 (175877)
*** ANTE/BLINDS ***
Macgyver422 posts ante 160
P1xel7 posts ante 160
Kourah posts ante 160
Captaing13 posts ante 160
juanKing880 posts ante 160
Nesta627 posts ante 160
Macgyver422 posts small blind 700
P1xel7 posts big blind 1400
Dealt to P1xel7 [5h Jd]
*** PRE-FLOP *** 
juanKing880 calls 1400
Nesta627 folds
Kourah raises 2800 to 4200
Captaing13 folds
Macgyver422 folds
P1xel7 folds
juanKing880 folds
Kourah collected 8660 from pot
*** SUMMARY ***
Total pot 8660 | No rake
Seat 1: Kourah won 8660


Winamax Poker - Tournament "MYSTERY KO" buyIn: 0.90€ + 0.10€ level: 12 - HandId: #3047856029015474228-118-1700082836 - Holdem no limit (160/700/1400) - 2023/11/15 21:13:56 UTC
Table: 'MYSTERY KO(709634281)#0051' 6-max (real money) Seat #3 is the button
Seat 1: Kourah (65962)
Seat 2: Captaing13 (47205)
Seat 3: Macgyver422 (29320)
Seat 4: P1xel7 (43758)
Seat 5: juanKing880 (46290)
Seat 6: Nesta627 (175717)
*** ANTE/BLINDS ***
P1xel7 posts ante 160
juanKing880 posts ante 160
Kourah posts ante 160
Captaing13 posts ante 160
Macgyver422 posts ante 160
Nesta627 posts ante 160
P1xel7 posts small blind 700
juanKing880 posts big blind 1400
Dealt to P1xel7 [Th 7h]
*** PRE-FLOP *** 
Nesta627 folds
Kourah raises 1400 to 2800
Captaing13 folds
Macgyver422 folds
P1xel7 folds
juanKing880 folds
Kourah collected 5860 from pot
*** SUMMARY ***
Total pot 5860 | No rake
Seat 1: Kourah won 5860


Winamax Poker - Tournament "MYSTERY KO" buyIn: 0.90€ + 0.10€ level: 12 - HandId: #3047856029015474228-119-1700082866 - Holdem no limit (160/700/1400) - 2023/11/15 21:14:26 UTC
Table: 'MYSTERY KO(709634281)#0051' 6-max (real money) Seat #4 is the button
Seat 1: Kourah (68862)
Seat 2: Captaing13 (47045)
Seat 3: Macgyver422 (29160)
Seat 4: P1xel7 (42898)
Seat 5: juanKing880 (44730)
Seat 6: Nesta627 (175557)
*** ANTE/BLINDS ***
juanKing880 posts ante 160
Nesta627 posts ante 160
Kourah posts ante 160
Captaing13 posts ante 160
Macgyver422 posts ante 160
P1xel7 posts ante 160
juanKing880 posts small blind 700
Nesta627 posts big blind 1400
Dealt to P1xel7 [Tc Qc]
*** PRE-FLOP *** 
Kourah folds
Captaing13 folds
Macgyver422 folds
P1xel7 raises 2100 to 3500
juanKing880 raises 41070 to 44570 and is all-in
Nesta627 raises 130827 to 175397 and is all-in
P1xel7 folds
*** FLOP *** [Js 8s 7s]
*** TURN *** [Js 8s 7s][Ac]
*** RIVER *** [Js 8s 7s Ac][6s]
*** SHOW DOWN ***
juanKing880 shows [Qd As] (Flush Ace high)
Nesta627 shows [9s 9h] (Flush Jack high)
Nesta627 collected 130827 from side pot 1
juanKing880 collected 93600 from main pot
*** SUMMARY ***
Total pot 224427 | No rake
Board: [Js 8s 7s Ac 6s]
Seat 5: juanKing880 (small blind) showed [Qd As] and won 93600 with Flush Ace high
Seat 6: Nesta627 (big blind) showed [9s 9h] and won 130827 with Flush Jack high


Winamax Poker - Tournament "MYSTERY KO" buyIn: 0.90€ + 0.10€ level: 12 - HandId: #3047856029015474228-120-1700082902 - Holdem no limit (160/700/1400) - 2023/11/15 21:15:02 UTC
Table: 'MYSTERY KO(709634281)#0051' 6-max (real money) Seat #5 is the button
Seat 1: Kourah (68702)
Seat 2: Captaing13 (46885)
Seat 3: Macgyver422 (29000)
Seat 4: P1xel7 (39238)
Seat 5: juanKing880 (93600)
Seat 6: Nesta627 (130827)
*** ANTE/BLINDS ***
Nesta627 posts ante 160
Kourah posts ante 160
Captaing13 posts ante 160
Macgyver422 posts ante 160
P1xel7 posts ante 160
juanKing880 posts ante 160
Nesta627 posts small blind 700
Kourah posts big blind 1400
Dealt to P1xel7 [6s 5d]
*** PRE-FLOP *** 
Captaing13 raises 2100 to 3500
Macgyver422 folds
P1xel7 folds
juanKing880 folds
Nesta627 raises 7000 to 10500
Kourah folds
Captaing13 calls 7000
*** FLOP *** [4s Ts Ah]
Nesta627 bets 5840
Captaing13 raises 30385 to 36225 and is all-in
Nesta627 folds
Captaing13 collected 65425 from pot
*** SUMMARY ***
Total pot 65425 | No rake
Board: [4s Ts Ah]
Seat 2: Captaing13 won 65425


Winamax Poker - Tournament "MYSTERY KO" buyIn: 0.90€ + 0.10€ level: 12 - HandId: #3047856029015474228-121-1700082951 - Holdem no limit (160/700/1400) - 2023/11/15 21:15:51 UTC
Table: 'MYSTERY KO(709634281)#0051' 6-max (real money) Seat #6 is the button
Seat 1: Kourah (67142)
Seat 2: Captaing13 (65425)
Seat 3: Macgyver422 (28840)
Seat 4: P1xel7 (39078)
Seat 5: juanKing880 (93440)
Seat 6: Nesta627 (114327)
*** ANTE/BLINDS ***
Kourah posts ante 160
Captaing13 posts ante 160
Macgyver422 posts ante 160
P1xel7 posts ante 160
juanKing880 posts ante 160
Nesta627 posts ante 160
Kourah posts small blind 700
Captaing13 posts big blind 1400
Dealt to P1xel7 [Kd 2c]
*** PRE-FLOP *** 
Macgyver422 folds
P1xel7 folds
juanKing880 calls 1400
Nesta627 calls 1400
Kourah folds
Captaing13 checks
*** FLOP *** [Qs 6h Jh]
Captaing13 checks
juanKing880 checks
Nesta627 bets 2100
Captaing13 calls 2100
juanKing880 folds
*** TURN *** [Qs 6h Jh][6d]
Captaing13 bets 5030
Nesta627 calls 5030
*** RIVER *** [Qs 6h Jh 6d][5d]
Captaing13 bets 13078
Nesta627 calls 13078
*** SHOW DOWN ***
Nesta627 shows [2h Qh] (Two pairs : Queens and 6)
Captaing13 shows [Qd Ks] (Two pairs : Queens and 6)
Captaing13 collected 46276 from pot
*** SUMMARY ***
Total pot 46276 | No rake
Board: [Qs 6h Jh 6d 5d]
Seat 2: Captaing13 (big blind) showed [Qd Ks] and won 46276 with Two pairs : Queens and 6
Seat 6: Nesta627 (button) showed [2h Qh] and lost with Two pairs : Queens and 6


Winamax Poker - Tournament "MYSTERY KO" buyIn: 0.90€ + 0.10€ level: 12 - HandId: #3047856029015474228-122-1700083025 - Holdem no limit (160/700/1400) - 2023/11/15 21:17:05 UTC
Table: 'MYSTERY KO(709634281)#0051' 6-max (real money) Seat #1 is the button
Seat 1: Kourah (66282)
Seat 2: Captaing13 (89933)
Seat 3: Macgyver422 (28680)
Seat 4: P1xel7 (38918)
Seat 5: juanKing880 (91880)
Seat 6: Nesta627 (92559)
*** ANTE/BLINDS ***
Captaing13 posts ante 160
Macgyver422 posts ante 160
Kourah posts ante 160
P1xel7 posts ante 160
juanKing880 posts ante 160
Nesta627 posts ante 160
Captaing13 posts small blind 700
Macgyver422 posts big blind 1400
Dealt to P1xel7 [5s Ac]
*** PRE-FLOP *** 
P1xel7 folds
juanKing880 folds
Nesta627 raises 1540 to 2940
Kourah calls 2940
Captaing13 folds
Macgyver422 folds
*** FLOP *** [8s Kc 2c]
Nesta627 checks
Kourah checks
*** TURN *** [8s Kc 2c][Qd]
Nesta627 bets 2950
Kourah calls 2950
*** RIVER *** [8s Kc 2c Qd][6c]
Nesta627 bets 11200
Kourah calls 11200
*** SHOW DOWN ***
Nesta627 shows [4c As] (High card : Ace)
Kourah shows [Qh Tc] (One pair : Queens)
Kourah collected 37240 from pot
*** SUMMARY ***
Total pot 37240 | No rake
Board: [8s Kc 2c Qd 6c]
Seat 1: Kourah (button) showed [Qh Tc] and won 37240 with One pair : Queens
Seat 6: Nesta627 showed [4c As] and lost with High card : Ace


Winamax Poker - Tournament "MYSTERY KO" buyIn: 0.90€ + 0.10€ level: 12 - HandId: #3047856029015474228-123-1700083131 - Holdem no limit (160/700/1400) - 2023/11/15 21:18:51 UTC
Table: 'MYSTERY KO(709634281)#0051' 6-max (real money) Seat #2 is the button
Seat 1: Kourah (86272)
Seat 2: Captaing13 (89073)
Seat 3: Macgyver422 (27120)
Seat 4: P1xel7 (38758)
Seat 5: juanKing880 (91720)
Seat 6: Nesta627 (75309)
*** ANTE/BLINDS ***
Macgyver422 posts ante 160
P1xel7 posts ante 160
Kourah posts ante 160
Captaing13 posts ante 160
juanKing880 posts ante 160
Nesta627 posts ante 160
Macgyver422 posts small blind 700
P1xel7 posts big blind 1400
Dealt to P1xel7 [Ac Ah]
*** PRE-FLOP *** 
juanKing880 folds
Nesta627 folds
Kourah folds
Captaing13 folds
Macgyver422 folds
P1xel7 collected 3060 from pot
*** SUMMARY ***
Total pot 3060 | No rake
Seat 4: P1xel7 (big blind) won 3060


Winamax Poker - Tournament "MYSTERY KO" buyIn: 0.90€ + 0.10€ level: 13 - HandId: #3047856029015474228-124-1700083151 - Holdem no limit (200/800/1600) - 2023/11/15 21:19:11 UTC
Table: 'MYSTERY KO(709634281)#0051' 6-max (real money) Seat #3 is the button
Seat 1: Kourah (86112)
Seat 2: Captaing13 (88913)
Seat 3: Macgyver422 (26260)
Seat 4: P1xel7 (40258)
Seat 5: juanKing880 (91560)
Seat 6: Nesta627 (75149)
*** ANTE/BLINDS ***
P1xel7 posts ante 200
juanKing880 posts ante 200
Kourah posts ante 200
Captaing13 posts ante 200
Macgyver422 posts ante 200
Nesta627 posts ante 200
P1xel7 posts small blind 800
juanKing880 posts big blind 1600
Dealt to P1xel7 [5s Td]
*** PRE-FLOP *** 
Nesta627 folds
Kourah folds
Captaing13 folds
Macgyver422 folds
P1xel7 folds
juanKing880 collected 3600 from pot
*** SUMMARY ***
Total pot 3600 | No rake
Seat 5: juanKing880 (big blind) won 3600


Winamax Poker - Tournament "MYSTERY KO" buyIn: 0.90€ + 0.10€ level: 13 - HandId: #3047856029015474228-125-1700083171 - Holdem no limit (200/800/1600) - 2023/11/15 21:19:31 UTC
Table: 'MYSTERY KO(709634281)#0051' 6-max (real money) Seat #4 is the button
Seat 1: Kourah (85912)
Seat 2: Captaing13 (88713)
Seat 3: Macgyver422 (26060)
Seat 4: P1xel7 (39258)
Seat 5: juanKing880 (93360)
Seat 6: Nesta627 (74949)
*** ANTE/BLINDS ***
juanKing880 posts ante 200
Nesta627 posts ante 200
Kourah posts ante 200
Captaing13 posts ante 200
Macgyver422 posts ante 200
P1xel7 posts ante 200
juanKing880 posts small blind 800
Nesta627 posts big blind 1600
Dealt to P1xel7 [8h 4h]
*** PRE-FLOP *** 
Kourah folds
Captaing13 folds
Macgyver422 folds
P1xel7 folds
juanKing880 calls 800
Nesta627 checks
*** FLOP *** [Ac 5c 2h]
juanKing880 checks
Nesta627 bets 1600
juanKing880 calls 1600
*** TURN *** [Ac 5c 2h][5h]
juanKing880 checks
Nesta627 bets 5016
juanKing880 folds
Nesta627 collected 12616 from pot
*** SUMMARY ***
Total pot 12616 | No rake
Board: [Ac 5c 2h 5h]
Seat 6: Nesta627 (big blind) won 12616


Winamax Poker - Tournament "MYSTERY KO" buyIn: 0.90€ + 0.10€ level: 13 - HandId: #3047856029015474228-126-1700083241 - Holdem no limit (200/800/1600) - 2023/11/15 21:20:41 UTC
Table: 'MYSTERY KO(709634281)#0051' 6-max (real money) Seat #5 is the button
Seat 1: Kourah (85712)
Seat 2: Captaing13 (88513)
Seat 3: Macgyver422 (25860)
Seat 4: P1xel7 (39058)
Seat 5: juanKing880 (89960)
Seat 6: Nesta627 (79149)
*** ANTE/BLINDS ***
Nesta627 posts ante 200
Kourah posts ante 200
Captaing13 posts ante 200
Macgyver422 posts ante 200
P1xel7 posts ante 200
juanKing880 posts ante 200
Nesta627 posts small blind 800
Kourah posts big blind 1600
Dealt to P1xel7 [9s Ks]
*** PRE-FLOP *** 
Captaing13 folds
Macgyver422 folds
P1xel7 raises 2400 to 4000
juanKing880 calls 4000
Nesta627 raises 74949 to 78949 and is all-in
Kourah folds
P1xel7 folds
juanKing880 folds
Nesta627 collected 89749 from pot
*** SUMMARY ***
Total pot 89749 | No rake
Seat 6: Nesta627 (small blind) won 89749


Winamax Poker - Tournament "MYSTERY KO" buyIn: 0.90€ + 0.10€ level: 13 - HandId: #3047856029015474228-127-1700083284 - Holdem no limit (200/800/1600) - 2023/11/15 21:21:24 UTC
Table: 'MYSTERY KO(709634281)#0051' 6-max (real money) Seat #6 is the button
Seat 1: Kourah (83912)
Seat 2: Captaing13 (88313)
Seat 3: Macgyver422 (25660)
Seat 4: P1xel7 (34858)
Seat 5: juanKing880 (85760)
Seat 6: Nesta627 (89749)
*** ANTE/BLINDS ***
Kourah posts ante 200
Captaing13 posts ante 200
Macgyver422 posts ante 200
P1xel7 posts ante 200
juanKing880 posts ante 200
Nesta627 posts ante 200
Kourah posts small blind 800
Captaing13 posts big blind 1600
Dealt to P1xel7 [5h 9h]
*** PRE-FLOP *** 
Macgyver422 folds
P1xel7 folds
juanKing880 calls 1600
Nesta627 folds
Kourah raises 4000 to 5600
Captaing13 folds
juanKing880 calls 4000
*** FLOP *** [3h Js 6d]
Kourah bets 4900
juanKing880 raises 75060 to 79960 and is all-in
Kourah folds
juanKing880 collected 98860 from pot
*** SUMMARY ***
Total pot 98860 | No rake
Board: [3h Js 6d]
Seat 5: juanKing880 won 98860


Winamax Poker - Tournament "MYSTERY KO" buyIn: 0.90€ + 0.10€ level: 13 - HandId: #3047856029015474228-128-1700083357 - Holdem no limit (200/800/1600) - 2023/11/15 21:22:37 UTC
Table: 'MYSTERY KO(709634281)#0051' 6-max (real money) Seat #1 is the button
Seat 1: Kourah (73212)
Seat 2: Captaing13 (86513)
Seat 3: Macgyver422 (25460)
Seat 4: P1xel7 (34658)
Seat 5: juanKing880 (98860)
Seat 6: Nesta627 (89549)
*** ANTE/BLINDS ***
Captaing13 posts ante 200
Macgyver422 posts ante 200
Kourah posts ante 200
P1xel7 posts ante 200
juanKing880 posts ante 200
Nesta627 posts ante 200
Captaing13 posts small blind 800
Macgyver422 posts big blind 1600
Dealt to P1xel7 [2c 2h]
*** PRE-FLOP *** 
P1xel7 raises 2400 to 4000
juanKing880 folds
Nesta627 calls 4000
Kourah calls 4000
Captaing13 folds
Macgyver422 folds
*** FLOP *** [3c Jh 4h]
P1xel7 bets 10140
Nesta627 folds
Kourah folds
P1xel7 collected 25740 from pot
*** SUMMARY ***
Total pot 25740 | No rake
Board: [3c Jh 4h]
Seat 4: P1xel7 won 25740


Winamax Poker - Tournament "MYSTERY KO" buyIn: 0.90€ + 0.10€ level: 13 - HandId: #3047856029015474228-129-1700083410 - Holdem no limit (200/800/1600) - 2023/11/15 21:23:30 UTC
Table: 'MYSTERY KO(709634281)#0051' 6-max (real money) Seat #2 is the button
Seat 1: Kourah (69012)
Seat 2: Captaing13 (85513)
Seat 3: Macgyver422 (23660)
Seat 4: P1xel7 (46058)
Seat 5: juanKing880 (98660)
Seat 6: Nesta627 (85349)
*** ANTE/BLINDS ***
Macgyver422 posts ante 200
P1xel7 posts ante 200
Kourah posts ante 200
Captaing13 posts ante 200
juanKing880 posts ante 200
Nesta627 posts ante 200
Macgyver422 posts small blind 800
P1xel7 posts big blind 1600
Dealt to P1xel7 [8c Kc]
*** PRE-FLOP *** 
juanKing880 folds
Nesta627 raises 1760 to 3360
Kourah folds
Captaing13 folds
Macgyver422 folds
P1xel7 calls 1760
*** FLOP *** [3c 7s 3d]
P1xel7 checks
Nesta627 checks
*** TURN *** [3c 7s 3d][8h]
P1xel7 bets 3052
Nesta627 raises 6548 to 9600
P1xel7 calls 6548
*** RIVER *** [3c 7s 3d 8h][2h]
P1xel7 checks
Nesta627 checks
*** SHOW DOWN ***
Nesta627 shows [Qd Jd] (One pair : 3)
P1xel7 shows [8c Kc] (Two pairs : 8 and 3)
P1xel7 collected 27920 from pot
*** SUMMARY ***
Total pot 27920 | No rake
Board: [3c 7s 3d 8h 2h]
Seat 4: P1xel7 (big blind) showed [8c Kc] and won 27920 with Two pairs : 8 and 3
Seat 6: Nesta627 showed [Qd Jd] and lost with One pair : 3


Winamax Poker - Tournament "MYSTERY KO" buyIn: 0.90€ + 0.10€ level: 13 - HandId: #3047856029015474228-130-1700083458 - Holdem no limit (200/800/1600) - 2023/11/15 21:24:18 UTC
Table: 'MYSTERY KO(709634281)#0051' 6-max (real money) Seat #3 is the button
Seat 1: Kourah (68812)
Seat 2: Captaing13 (85313)
Seat 3: Macgyver422 (22660)
Seat 4: P1xel7 (60818)
Seat 5: juanKing880 (98460)
Seat 6: Nesta627 (72189)
*** ANTE/BLINDS ***
P1xel7 posts ante 200
juanKing880 posts ante 200
Kourah posts ante 200
Captaing13 posts ante 200
Macgyver422 posts ante 200
Nesta627 posts ante 200
P1xel7 posts small blind 800
juanKing880 posts big blind 1600
Dealt to P1xel7 [Kc Ks]
*** PRE-FLOP *** 
Nesta627 folds
Kourah folds
Captaing13 folds
Macgyver422 raises 20860 to 22460 and is all-in
P1xel7 raises 38158 to 60618 and is all-in
juanKing880 folds
*** FLOP *** [2c 2d 7d]
*** TURN *** [2c 2d 7d][8d]
*** RIVER *** [2c 2d 7d 8d][6c]
*** SHOW DOWN ***
Macgyver422 shows [Ah 6h] (Two pairs : 6 and 2)
P1xel7 shows [Kc Ks] (Two pairs : Kings and 2)
P1xel7 collected 85878 from pot
*** SUMMARY ***
Total pot 85878 | No rake
Board: [2c 2d 7d 8d 6c]
Seat 3: Macgyver422 (button) showed [Ah 6h] and lost with Two pairs : 6 and 2
Seat 4: P1xel7 (small blind) showed [Kc Ks] and won 85878 with Two pairs : Kings and 2


Winamax Poker - Tournament "MYSTERY KO" buyIn: 0.90€ + 0.10€ level: 13 - HandId: #3047856029015474228-131-1700083531 - Holdem no limit (200/800/1600) - 2023/11/15 21:25:31 UTC
Table: 'MYSTERY KO(709634281)#0051' 6-max (real money) Seat #4 is the button
Seat 1: Kourah (68612)
Seat 2: Captaing13 (85113)
Seat 4: P1xel7 (85878)
Seat 5: juanKing880 (96660)
Seat 6: Nesta627 (71989)
*** ANTE/BLINDS ***
juanKing880 posts ante 200
Nesta627 posts ante 200
Kourah posts ante 200
Captaing13 posts ante 200
P1xel7 posts ante 200
juanKing880 posts small blind 800
Nesta627 posts big blind 1600
Dealt to P1xel7 [6s Ac]
*** PRE-FLOP *** 
Kourah folds
Captaing13 folds
P1xel7 raises 2400 to 4000
juanKing880 folds
Nesta627 folds
P1xel7 collected 7400 from pot
*** SUMMARY ***
Total pot 7400 | No rake
Seat 4: P1xel7 (button) won 7400


Winamax Poker - Tournament "MYSTERY KO" buyIn: 0.90€ + 0.10€ level: 13 - HandId: #3047856029015474228-132-1700083560 - Holdem no limit (200/800/1600) - 2023/11/15 21:26:00 UTC
Table: 'MYSTERY KO(709634281)#0051' 6-max (real money) Seat #5 is the button
Seat 1: Kourah (68412)
Seat 2: Captaing13 (84913)
Seat 4: P1xel7 (89078)
Seat 5: juanKing880 (95660)
Seat 6: Nesta627 (70189)
*** ANTE/BLINDS ***
Nesta627 posts ante 200
Kourah posts ante 200
Captaing13 posts ante 200
P1xel7 posts ante 200
juanKing880 posts ante 200
Nesta627 posts small blind 800
Kourah posts big blind 1600
Dealt to P1xel7 [6d 9s]
*** PRE-FLOP *** 
Captaing13 raises 1600 to 3200
P1xel7 folds
juanKing880 folds
Nesta627 folds
Kourah folds
Captaing13 collected 6600 from pot
*** SUMMARY ***
Total pot 6600 | No rake
Seat 2: Captaing13 won 6600


Winamax Poker - Tournament "MYSTERY KO" buyIn: 0.90€ + 0.10€ level: 14 - HandId: #3047856029015474228-133-1700083586 - Holdem no limit (250/1000/2000) - 2023/11/15 21:26:26 UTC
Table: 'MYSTERY KO(709634281)#0051' 6-max (real money) Seat #6 is the button
Seat 1: Kourah (66612)
Seat 2: Captaing13 (88113)
Seat 4: P1xel7 (88878)
Seat 5: juanKing880 (95460)
Seat 6: Nesta627 (69189)
*** ANTE/BLINDS ***
Kourah posts ante 250
Captaing13 posts ante 250
P1xel7 posts ante 250
juanKing880 posts ante 250
Nesta627 posts ante 250
Kourah posts small blind 1000
Captaing13 posts big blind 2000
Dealt to P1xel7 [5d 8s]
*** PRE-FLOP *** 
P1xel7 folds
juanKing880 folds
Nesta627 raises 2200 to 4200
Kourah folds
Captaing13 folds
Nesta627 collected 8450 from pot
*** SUMMARY ***
Total pot 8450 | No rake
Seat 6: Nesta627 (button) won 8450


Winamax Poker - Tournament "MYSTERY KO" buyIn: 0.90€ + 0.10€ level: 14 - HandId: #3047856029015474228-134-1700083598 - Holdem no limit (250/1000/2000) - 2023/11/15 21:26:38 UTC
Table: 'MYSTERY KO(709634281)#0051' 6-max (real money) Seat #1 is the button
Seat 1: Kourah (65362)
Seat 2: Captaing13 (85863)
Seat 4: P1xel7 (88628)
Seat 5: juanKing880 (95210)
Seat 6: Nesta627 (73189)
*** ANTE/BLINDS ***
Captaing13 posts ante 250
P1xel7 posts ante 250
Kourah posts ante 250
juanKing880 posts ante 250
Nesta627 posts ante 250
Captaing13 posts small blind 1000
P1xel7 posts big blind 2000
Dealt to P1xel7 [9h 7s]
*** PRE-FLOP *** 
juanKing880 folds
Nesta627 folds
Kourah folds
Captaing13 calls 1000
P1xel7 checks
*** FLOP *** [3s 2c Tc]
Captaing13 bets 2625
P1xel7 folds
Captaing13 collected 7875 from pot
*** SUMMARY ***
Total pot 7875 | No rake
Board: [3s 2c Tc]
Seat 2: Captaing13 (small blind) won 7875


Winamax Poker - Tournament "MYSTERY KO" buyIn: 0.90€ + 0.10€ level: 14 - HandId: #3047856029015474228-135-1700083636 - Holdem no limit (250/1000/2000) - 2023/11/15 21:27:16 UTC
Table: 'MYSTERY KO(709634281)#0051' 6-max (real money) Seat #2 is the button
Seat 1: Kourah (65112)
Seat 2: Captaing13 (88863)
Seat 3: Stany-31 (39511)
Seat 4: P1xel7 (86378)
Seat 5: juanKing880 (94960)
Seat 6: Nesta627 (72939)
*** ANTE/BLINDS ***
P1xel7 posts ante 250
juanKing880 posts ante 250
Kourah posts ante 250
Captaing13 posts ante 250
Nesta627 posts ante 250
P1xel7 posts small blind 1000
juanKing880 posts big blind 2000
Dealt to P1xel7 [3h Ac]
*** PRE-FLOP *** 
Nesta627 folds
Kourah folds
Captaing13 folds
P1xel7 raises 3000 to 5000
juanKing880 calls 3000
*** FLOP *** [7d Th Kc]
P1xel7 bets 7313
juanKing880 folds
P1xel7 collected 18563 from pot
*** SUMMARY ***
Total pot 18563 | No rake
Board: [7d Th Kc]
Seat 4: P1xel7 (small blind) won 18563


Winamax Poker - Tournament "MYSTERY KO" buyIn: 0.90€ + 0.10€ level: 14 - HandId: #3047856029015474228-136-1700083672 - Holdem no limit (250/1000/2000) - 2023/11/15 21:27:52 UTC
Table: 'MYSTERY KO(709634281)#0051' 6-max (real money) Seat #4 is the button
Seat 1: Kourah (64862)
Seat 2: Captaing13 (88613)
Seat 3: Stany-31 (39511)
Seat 4: P1xel7 (92378)
Seat 5: juanKing880 (89710)
Seat 6: Nesta627 (72689)
*** ANTE/BLINDS ***
juanKing880 posts ante 250
Nesta627 posts ante 250
Kourah posts ante 250
Captaing13 posts ante 250
Stany-31 posts ante 250
P1xel7 posts ante 250
juanKing880 posts small blind 1000
Nesta627 posts big blind 2000
Dealt to P1xel7 [Qc Js]
*** PRE-FLOP *** 
Kourah folds
Captaing13 folds
Stany-31 raises 37261 to 39261 and is all-in
P1xel7 folds
juanKing880 folds
Nesta627 folds
Stany-31 collected 43761 from pot
*** SUMMARY ***
Total pot 43761 | No rake
Seat 3: Stany-31 won 43761


Winamax Poker - Tournament "MYSTERY KO" buyIn: 0.90€ + 0.10€ level: 14 - HandId: #3047856029015474207-123-1700083775 - Holdem no limit (250/1000/2000) - 2023/11/15 21:29:35 UTC
Table: 'MYSTERY KO(709634281)#0030' 6-max (real money) Seat #3 is the button
Seat 1: P1xel7 (92128)
Seat 2: Bar2ligne (47290)
Seat 3: AlkZeus (70848)
Seat 4: oryx88 (23687)
Seat 5: Braquage95 (32816)
Seat 6: PeterparKKer (65980)
*** ANTE/BLINDS ***
oryx88 posts ante 250
Braquage95 posts ante 250
P1xel7 posts ante 250
Bar2ligne posts ante 250
AlkZeus posts ante 250
PeterparKKer posts ante 250
oryx88 posts small blind 1000
Braquage95 posts big blind 2000
Dealt to P1xel7 [Ac 7h]
*** PRE-FLOP *** 
PeterparKKer folds
P1xel7 folds
Bar2ligne folds
AlkZeus folds
oryx88 folds
Braquage95 collected 4500 from pot
*** SUMMARY ***
Total pot 4500 | No rake
Seat 5: Braquage95 (big blind) won 4500


Winamax Poker - Tournament "MYSTERY KO" buyIn: 0.90€ + 0.10€ level: 14 - HandId: #3047856029015474207-124-1700083798 - Holdem no limit (250/1000/2000) - 2023/11/15 21:29:58 UTC
Table: 'MYSTERY KO(709634281)#0030' 6-max (real money) Seat #4 is the button
Seat 1: P1xel7 (91878)
Seat 2: Bar2ligne (47040)
Seat 3: AlkZeus (70598)
Seat 4: oryx88 (22437)
Seat 5: Braquage95 (35066)
Seat 6: PeterparKKer (65730)
*** ANTE/BLINDS ***
Braquage95 posts ante 250
PeterparKKer posts ante 250
P1xel7 posts ante 250
Bar2ligne posts ante 250
AlkZeus posts ante 250
oryx88 posts ante 250
Braquage95 posts small blind 1000
PeterparKKer posts big blind 2000
Dealt to P1xel7 [5s 6d]
*** PRE-FLOP *** 
P1xel7 folds
Bar2ligne folds
AlkZeus folds
oryx88 folds
Braquage95 folds
PeterparKKer collected 4500 from pot
*** SUMMARY ***
Total pot 4500 | No rake
Seat 6: PeterparKKer (big blind) won 4500


Winamax Poker - Tournament "MYSTERY KO" buyIn: 0.90€ + 0.10€ level: 14 - HandId: #3047856029015474207-125-1700083813 - Holdem no limit (250/1000/2000) - 2023/11/15 21:30:13 UTC
Table: 'MYSTERY KO(709634281)#0030' 6-max (real money) Seat #5 is the button
Seat 1: P1xel7 (91628)
Seat 2: Bar2ligne (46790)
Seat 3: AlkZeus (70348)
Seat 4: oryx88 (22187)
Seat 5: Braquage95 (33816)
Seat 6: PeterparKKer (67980)
*** ANTE/BLINDS ***
PeterparKKer posts ante 250
P1xel7 posts ante 250
Bar2ligne posts ante 250
AlkZeus posts ante 250
oryx88 posts ante 250
Braquage95 posts ante 250
PeterparKKer posts small blind 1000
P1xel7 posts big blind 2000
Dealt to P1xel7 [Tc Ac]
*** PRE-FLOP *** 
Bar2ligne raises 2000 to 4000
AlkZeus folds
oryx88 folds
Braquage95 calls 4000
PeterparKKer folds
P1xel7 calls 2000
*** FLOP *** [4d Td 7c]
P1xel7 checks
Bar2ligne checks
Braquage95 bets 29566 and is all-in
P1xel7 raises 29566 to 59132
Bar2ligne folds
*** TURN *** [4d Td 7c][Kh]
*** RIVER *** [4d Td 7c Kh][3d]
*** SHOW DOWN ***
Braquage95 shows [9h 9c] (One pair : 9)
P1xel7 shows [Tc Ac] (One pair : Tens)
P1xel7 collected 103198 from pot
*** SUMMARY ***
Total pot 103198 | No rake
Board: [4d Td 7c Kh 3d]
Seat 1: P1xel7 (big blind) showed [Tc Ac] and won 103198 with One pair : Tens
Seat 5: Braquage95 (button) showed [9h 9c] and lost with One pair : 9


Winamax Poker - Tournament "MYSTERY KO" buyIn: 0.90€ + 0.10€ level: 14 - HandId: #3047856029015474207-126-1700083892 - Holdem no limit (250/1000/2000) - 2023/11/15 21:31:32 UTC
Table: 'MYSTERY KO(709634281)#0030' 6-max (real money) Seat #6 is the button
Seat 1: P1xel7 (131444)
Seat 2: Bar2ligne (42540)
Seat 3: AlkZeus (70098)
Seat 4: oryx88 (21937)
Seat 6: PeterparKKer (66730)
*** ANTE/BLINDS ***
P1xel7 posts ante 250
Bar2ligne posts ante 250
AlkZeus posts ante 250
oryx88 posts ante 250
PeterparKKer posts ante 250
P1xel7 posts small blind 1000
Bar2ligne posts big blind 2000
Dealt to P1xel7 [Ks 2s]
*** PRE-FLOP *** 
AlkZeus folds
oryx88 folds
PeterparKKer folds
P1xel7 raises 4000 to 6000
Bar2ligne calls 4000
*** FLOP *** [Qc Ac 5c]
P1xel7 checks
Bar2ligne checks
*** TURN *** [Qc Ac 5c][7d]
P1xel7 bets 4638
Bar2ligne calls 4638
*** RIVER *** [Qc Ac 5c 7d][2d]
P1xel7 bets 5632
Bar2ligne calls 5632
*** SHOW DOWN ***
P1xel7 shows [Ks 2s] (One pair : 2)
Bar2ligne shows [4d Qd] (One pair : Queens)
Bar2ligne collected 33790 from pot
*** SUMMARY ***
Total pot 33790 | No rake
Board: [Qc Ac 5c 7d 2d]
Seat 1: P1xel7 (small blind) showed [Ks 2s] and lost with One pair : 2
Seat 2: Bar2ligne (big blind) showed [4d Qd] and won 33790 with One pair : Queens


Winamax Poker - Tournament "MYSTERY KO" buyIn: 0.90€ + 0.10€ level: 14 - HandId: #3047856029015474207-127-1700083939 - Holdem no limit (250/1000/2000) - 2023/11/15 21:32:19 UTC
Table: 'MYSTERY KO(709634281)#0030' 6-max (real money) Seat #1 is the button
Seat 1: P1xel7 (114924)
Seat 2: Bar2ligne (59810)
Seat 3: AlkZeus (69848)
Seat 4: oryx88 (21687)
Seat 5: La ceniza (26158)
Seat 6: PeterparKKer (66480)
*** ANTE/BLINDS ***
Bar2ligne posts ante 250
AlkZeus posts ante 250
P1xel7 posts ante 250
oryx88 posts ante 250
La ceniza posts ante 250
PeterparKKer posts ante 250
Bar2ligne posts small blind 1000
AlkZeus posts big blind 2000
Dealt to P1xel7 [Kc Jc]
*** PRE-FLOP *** 
oryx88 folds
La ceniza folds
PeterparKKer folds
P1xel7 raises 3000 to 5000
Bar2ligne folds
AlkZeus folds
P1xel7 collected 9500 from pot
*** SUMMARY ***
Total pot 9500 | No rake
Seat 1: P1xel7 (button) won 9500


Winamax Poker - Tournament "MYSTERY KO" buyIn: 0.90€ + 0.10€ level: 15 - HandId: #3047856029015474207-128-1700083990 - Holdem no limit (300/1250/2500) - 2023/11/15 21:33:10 UTC
Table: 'MYSTERY KO(709634281)#0030' 6-max (real money) Seat #2 is the button
Seat 1: P1xel7 (119174)
Seat 2: Bar2ligne (58560)
Seat 3: AlkZeus (67598)
Seat 4: oryx88 (21437)
Seat 5: La ceniza (25908)
Seat 6: PeterparKKer (66230)
*** ANTE/BLINDS ***
AlkZeus posts ante 300
oryx88 posts ante 300
P1xel7 posts ante 300
Bar2ligne posts ante 300
La ceniza posts ante 300
PeterparKKer posts ante 300
AlkZeus posts small blind 1250
oryx88 posts big blind 2500
Dealt to P1xel7 [Js 7s]
*** PRE-FLOP *** 
La ceniza folds
PeterparKKer folds
P1xel7 folds
Bar2ligne raises 2500 to 5000
AlkZeus calls 3750
oryx88 folds
*** FLOP *** [Qh 6s 2s]
AlkZeus checks
Bar2ligne checks
*** TURN *** [Qh 6s 2s][8c]
AlkZeus bets 9295
Bar2ligne folds
AlkZeus collected 23595 from pot
*** SUMMARY ***
Total pot 23595 | No rake
Board: [Qh 6s 2s 8c]
Seat 3: AlkZeus (small blind) won 23595


Winamax Poker - Tournament "MYSTERY KO" buyIn: 0.90€ + 0.10€ level: 15 - HandId: #3047856029015474207-129-1700084042 - Holdem no limit (300/1250/2500) - 2023/11/15 21:34:02 UTC
Table: 'MYSTERY KO(709634281)#0030' 6-max (real money) Seat #3 is the button
Seat 1: P1xel7 (118874)
Seat 2: Bar2ligne (53260)
Seat 3: AlkZeus (76598)
Seat 4: oryx88 (18637)
Seat 5: La ceniza (25608)
Seat 6: PeterparKKer (65930)
*** ANTE/BLINDS ***
oryx88 posts ante 300
La ceniza posts ante 300
P1xel7 posts ante 300
Bar2ligne posts ante 300
AlkZeus posts ante 300
PeterparKKer posts ante 300
oryx88 posts small blind 1250
La ceniza posts big blind 2500
Dealt to P1xel7 [Jc Qc]
*** PRE-FLOP *** 
PeterparKKer folds
P1xel7 raises 5000 to 7500
Bar2ligne folds
AlkZeus folds
oryx88 folds
La ceniza folds
P1xel7 collected 13050 from pot
*** SUMMARY ***
Total pot 13050 | No rake
Seat 1: P1xel7 won 13050


Winamax Poker - Tournament "MYSTERY KO" buyIn: 0.90€ + 0.10€ level: 15 - HandId: #3047856029015474207-130-1700084078 - Holdem no limit (300/1250/2500) - 2023/11/15 21:34:38 UTC
Table: 'MYSTERY KO(709634281)#0030' 6-max (real money) Seat #4 is the button
Seat 1: P1xel7 (124124)
Seat 2: Bar2ligne (52960)
Seat 3: AlkZeus (76298)
Seat 4: oryx88 (17087)
Seat 5: La ceniza (22808)
Seat 6: PeterparKKer (65630)
*** ANTE/BLINDS ***
La ceniza posts ante 300
PeterparKKer posts ante 300
P1xel7 posts ante 300
Bar2ligne posts ante 300
AlkZeus posts ante 300
oryx88 posts ante 300
La ceniza posts small blind 1250
PeterparKKer posts big blind 2500
Dealt to P1xel7 [7d 9c]
*** PRE-FLOP *** 
P1xel7 folds
Bar2ligne raises 2500 to 5000
AlkZeus folds
oryx88 folds
La ceniza folds
PeterparKKer folds
Bar2ligne collected 10550 from pot
*** SUMMARY ***
Total pot 10550 | No rake
Seat 2: Bar2ligne won 10550


Winamax Poker - Tournament "MYSTERY KO" buyIn: 0.90€ + 0.10€ level: 15 - HandId: #3047856029015474207-131-1700084094 - Holdem no limit (300/1250/2500) - 2023/11/15 21:34:54 UTC
Table: 'MYSTERY KO(709634281)#0030' 6-max (real money) Seat #5 is the button
Seat 1: P1xel7 (123824)
Seat 2: Bar2ligne (58210)
Seat 3: AlkZeus (75998)
Seat 4: oryx88 (16787)
Seat 5: La ceniza (21258)
Seat 6: PeterparKKer (62830)
*** ANTE/BLINDS ***
PeterparKKer posts ante 300
P1xel7 posts ante 300
Bar2ligne posts ante 300
AlkZeus posts ante 300
oryx88 posts ante 300
La ceniza posts ante 300
PeterparKKer posts small blind 1250
P1xel7 posts big blind 2500
Dealt to P1xel7 [8s 6s]
*** PRE-FLOP *** 
Bar2ligne raises 2500 to 5000
AlkZeus folds
oryx88 folds
La ceniza folds
PeterparKKer folds
P1xel7 calls 2500
*** FLOP *** [Kd Kh 6d]
P1xel7 checks
Bar2ligne checks
*** TURN *** [Kd Kh 6d][Ts]
P1xel7 bets 4568
Bar2ligne calls 4568
*** RIVER *** [Kd Kh 6d Ts][7c]
P1xel7 bets 7765
Bar2ligne folds
P1xel7 collected 29951 from pot
*** SUMMARY ***
Total pot 29951 | No rake
Board: [Kd Kh 6d Ts 7c]
Seat 1: P1xel7 (big blind) won 29951


Winamax Poker - Tournament "MYSTERY KO" buyIn: 0.90€ + 0.10€ level: 15 - HandId: #3047856029015474207-132-1700084131 - Holdem no limit (300/1250/2500) - 2023/11/15 21:35:31 UTC
Table: 'MYSTERY KO(709634281)#0030' 6-max (real money) Seat #6 is the button
Seat 1: P1xel7 (136142)
Seat 2: Bar2ligne (48342)
Seat 3: AlkZeus (75698)
Seat 4: oryx88 (16487)
Seat 5: La ceniza (20958)
Seat 6: PeterparKKer (61280)
*** ANTE/BLINDS ***
P1xel7 posts ante 300
Bar2ligne posts ante 300
AlkZeus posts ante 300
oryx88 posts ante 300
La ceniza posts ante 300
PeterparKKer posts ante 300
P1xel7 posts small blind 1250
Bar2ligne posts big blind 2500
Dealt to P1xel7 [6s 7d]
*** PRE-FLOP *** 
AlkZeus folds
oryx88 folds
La ceniza folds
PeterparKKer folds
P1xel7 folds
Bar2ligne collected 5550 from pot
*** SUMMARY ***
Total pot 5550 | No rake
Seat 2: Bar2ligne (big blind) won 5550


Winamax Poker - Tournament "MYSTERY KO" buyIn: 0.90€ + 0.10€ level: 15 - HandId: #3047856029015474207-133-1700084158 - Holdem no limit (300/1250/2500) - 2023/11/15 21:35:58 UTC
Table: 'MYSTERY KO(709634281)#0030' 6-max (real money) Seat #1 is the button
Seat 1: P1xel7 (134592)
Seat 2: Bar2ligne (51092)
Seat 3: AlkZeus (75398)
Seat 4: oryx88 (16187)
Seat 5: La ceniza (20658)
Seat 6: PeterparKKer (60980)
*** ANTE/BLINDS ***
Bar2ligne posts ante 300
AlkZeus posts ante 300
P1xel7 posts ante 300
oryx88 posts ante 300
La ceniza posts ante 300
PeterparKKer posts ante 300
Bar2ligne posts small blind 1250
AlkZeus posts big blind 2500
Dealt to P1xel7 [8c 5h]
*** PRE-FLOP *** 
oryx88 folds
La ceniza folds
PeterparKKer folds
P1xel7 folds
Bar2ligne raises 5000 to 7500
AlkZeus folds
Bar2ligne collected 11800 from pot
*** SUMMARY ***
Total pot 11800 | No rake
Seat 2: Bar2ligne (small blind) won 11800


Winamax Poker - Tournament "MYSTERY KO" buyIn: 0.90€ + 0.10€ level: 15 - HandId: #3047856029015474207-134-1700084204 - Holdem no limit (300/1250/2500) - 2023/11/15 21:36:44 UTC
Table: 'MYSTERY KO(709634281)#0030' 6-max (real money) Seat #2 is the button
Seat 1: P1xel7 (134292)
Seat 2: Bar2ligne (55092)
Seat 3: AlkZeus (72598)
Seat 4: oryx88 (15887)
Seat 5: La ceniza (20358)
Seat 6: PeterparKKer (60680)
*** ANTE/BLINDS ***
AlkZeus posts ante 300
oryx88 posts ante 300
P1xel7 posts ante 300
Bar2ligne posts ante 300
La ceniza posts ante 300
PeterparKKer posts ante 300
AlkZeus posts small blind 1250
oryx88 posts big blind 2500
Dealt to P1xel7 [Tc 4d]
*** PRE-FLOP *** 
La ceniza folds
PeterparKKer raises 3750 to 6250
P1xel7 folds
Bar2ligne raises 48542 to 54792 and is all-in
AlkZeus folds
oryx88 folds
PeterparKKer calls 48542
*** FLOP *** [6h 4s 8d]
*** TURN *** [6h 4s 8d][Td]
*** RIVER *** [6h 4s 8d Td][Ah]
*** SHOW DOWN ***
PeterparKKer shows [Kh Kd] (One pair : Kings)
Bar2ligne shows [Ts Ac] (Two pairs : Aces and Tens)
Bar2ligne collected 115134 from pot
*** SUMMARY ***
Total pot 115134 | No rake
Board: [6h 4s 8d Td Ah]
Seat 2: Bar2ligne (button) showed [Ts Ac] and won 115134 with Two pairs : Aces and Tens
Seat 6: PeterparKKer showed [Kh Kd] and lost with One pair : Kings


Winamax Poker - Tournament "MYSTERY KO" buyIn: 0.90€ + 0.10€ level: 15 - HandId: #3047856029015474207-135-1700084260 - Holdem no limit (300/1250/2500) - 2023/11/15 21:37:40 UTC
Table: 'MYSTERY KO(709634281)#0030' 6-max (real money) Seat #3 is the button
Seat 1: P1xel7 (133992)
Seat 2: Bar2ligne (115134)
Seat 3: AlkZeus (71048)
Seat 4: oryx88 (13087)
Seat 5: La ceniza (20058)
Seat 6: PeterparKKer (5588)
*** ANTE/BLINDS ***
oryx88 posts ante 300
La ceniza posts ante 300
P1xel7 posts ante 300
Bar2ligne posts ante 300
AlkZeus posts ante 300
PeterparKKer posts ante 300
oryx88 posts small blind 1250
La ceniza posts big blind 2500
Dealt to P1xel7 [3h 8d]
*** PRE-FLOP *** 
PeterparKKer folds
P1xel7 folds
Bar2ligne folds
AlkZeus folds
oryx88 folds
La ceniza collected 5550 from pot
*** SUMMARY ***
Total pot 5550 | No rake
Seat 5: La ceniza (big blind) won 5550


Winamax Poker - Tournament "MYSTERY KO" buyIn: 0.90€ + 0.10€ level: 15 - HandId: #3047856029015474207-136-1700084287 - Holdem no limit (300/1250/2500) - 2023/11/15 21:38:07 UTC
Table: 'MYSTERY KO(709634281)#0030' 6-max (real money) Seat #4 is the button
Seat 1: P1xel7 (133692)
Seat 2: Bar2ligne (114834)
Seat 3: AlkZeus (70748)
Seat 4: oryx88 (11537)
Seat 5: La ceniza (22808)
Seat 6: PeterparKKer (5288)
*** ANTE/BLINDS ***
La ceniza posts ante 300
PeterparKKer posts ante 300
P1xel7 posts ante 300
Bar2ligne posts ante 300
AlkZeus posts ante 300
oryx88 posts ante 300
La ceniza posts small blind 1250
PeterparKKer posts big blind 2500
Dealt to P1xel7 [5d 4h]
*** PRE-FLOP *** 
P1xel7 folds
Bar2ligne folds
AlkZeus folds
oryx88 folds
La ceniza folds
PeterparKKer collected 5550 from pot
*** SUMMARY ***
Total pot 5550 | No rake
Seat 6: PeterparKKer (big blind) won 5550


Winamax Poker - Tournament "MYSTERY KO" buyIn: 0.90€ + 0.10€ level: 15 - HandId: #3047856029015474207-137-1700084327 - Holdem no limit (300/1250/2500) - 2023/11/15 21:38:47 UTC
Table: 'MYSTERY KO(709634281)#0030' 6-max (real money) Seat #5 is the button
Seat 1: P1xel7 (133392)
Seat 2: Bar2ligne (114534)
Seat 3: AlkZeus (70448)
Seat 4: oryx88 (11237)
Seat 5: La ceniza (21258)
Seat 6: PeterparKKer (8038)
*** ANTE/BLINDS ***
PeterparKKer posts ante 300
P1xel7 posts ante 300
Bar2ligne posts ante 300
AlkZeus posts ante 300
oryx88 posts ante 300
La ceniza posts ante 300
PeterparKKer posts small blind 1250
P1xel7 posts big blind 2500
Dealt to P1xel7 [Jh 7s]
*** PRE-FLOP *** 
Bar2ligne folds
AlkZeus folds
oryx88 folds
La ceniza raises 18458 to 20958 and is all-in
PeterparKKer calls 6488 and is all-in
P1xel7 folds
*** FLOP *** [5h Tc 4d]
*** TURN *** [5h Tc 4d][2c]
*** RIVER *** [5h Tc 4d 2c][9c]
*** SHOW DOWN ***
PeterparKKer shows [Ts Kd] (One pair : Tens)
La ceniza shows [2s 2d] (Trips of 2)
La ceniza collected 32996 from pot
*** SUMMARY ***
Total pot 32996 | No rake
Board: [5h Tc 4d 2c 9c]
Seat 5: La ceniza (button) showed [2s 2d] and won 32996 with Trips of 2
Seat 6: PeterparKKer (small blind) showed [Ts Kd] and lost with One pair : Tens


Winamax Poker - Tournament "MYSTERY KO" buyIn: 0.90€ + 0.10€ level: 15 - HandId: #3047856029015474207-138-1700084355 - Holdem no limit (300/1250/2500) - 2023/11/15 21:39:15 UTC
Table: 'MYSTERY KO(709634281)#0030' 6-max (real money) Seat #6 is the button
Seat 1: P1xel7 (130592)
Seat 2: Bar2ligne (114234)
Seat 3: AlkZeus (70148)
Seat 4: oryx88 (10937)
Seat 5: La ceniza (32996)
*** ANTE/BLINDS ***
P1xel7 posts ante 300
Bar2ligne posts ante 300
AlkZeus posts ante 300
oryx88 posts ante 300
La ceniza posts ante 300
P1xel7 posts small blind 1250
Bar2ligne posts big blind 2500
Dealt to P1xel7 [6d 8d]
*** PRE-FLOP *** 
AlkZeus folds
oryx88 raises 8137 to 10637 and is all-in
La ceniza folds
P1xel7 folds
Bar2ligne folds
oryx88 collected 15887 from pot
*** SUMMARY ***
Total pot 15887 | No rake
Seat 4: oryx88 won 15887


Winamax Poker - Tournament "MYSTERY KO" buyIn: 0.90€ + 0.10€ level: 15 - HandId: #3047856029015474207-139-1700084373 - Holdem no limit (300/1250/2500) - 2023/11/15 21:39:33 UTC
Table: 'MYSTERY KO(709634281)#0030' 6-max (real money) Seat #1 is the button
Seat 1: P1xel7 (129042)
Seat 2: Bar2ligne (111434)
Seat 3: AlkZeus (69848)
Seat 4: oryx88 (15887)
Seat 5: La ceniza (32696)
*** ANTE/BLINDS ***
Bar2ligne posts ante 300
AlkZeus posts ante 300
P1xel7 posts ante 300
oryx88 posts ante 300
La ceniza posts ante 300
Bar2ligne posts small blind 1250
AlkZeus posts big blind 2500
Dealt to P1xel7 [Jd Ac]
*** PRE-FLOP *** 
oryx88 folds
La ceniza folds
P1xel7 raises 3750 to 6250
Bar2ligne folds
AlkZeus calls 3750
*** FLOP *** [7s Ks Kd]
AlkZeus checks
P1xel7 bets 9913
AlkZeus folds
P1xel7 collected 25163 from pot
*** SUMMARY ***
Total pot 25163 | No rake
Board: [7s Ks Kd]
Seat 1: P1xel7 (button) won 25163


Winamax Poker - Tournament "MYSTERY KO" buyIn: 0.90€ + 0.10€ level: 16 - HandId: #3047856029015474207-140-1700084426 - Holdem no limit (350/1500/3000) - 2023/11/15 21:40:26 UTC
Table: 'MYSTERY KO(709634281)#0030' 6-max (real money) Seat #2 is the button
Seat 1: P1xel7 (137742)
Seat 2: Bar2ligne (109884)
Seat 3: AlkZeus (63298)
Seat 4: oryx88 (15587)
Seat 5: La ceniza (32396)
*** ANTE/BLINDS ***
AlkZeus posts ante 350
oryx88 posts ante 350
P1xel7 posts ante 350
Bar2ligne posts ante 350
La ceniza posts ante 350
AlkZeus posts small blind 1500
oryx88 posts big blind 3000
Dealt to P1xel7 [5s 2s]
*** PRE-FLOP *** 
La ceniza folds
P1xel7 folds
Bar2ligne folds
AlkZeus calls 1500
oryx88 checks
*** FLOP *** [Ts 2h 9s]
AlkZeus bets 5038
oryx88 folds
AlkZeus collected 12788 from pot
*** SUMMARY ***
Total pot 12788 | No rake
Board: [Ts 2h 9s]
Seat 3: AlkZeus (small blind) won 12788


Winamax Poker - Tournament "MYSTERY KO" buyIn: 0.90€ + 0.10€ level: 16 - HandId: #3047856029015474207-141-1700084448 - Holdem no limit (350/1500/3000) - 2023/11/15 21:40:48 UTC
Table: 'MYSTERY KO(709634281)#0030' 6-max (real money) Seat #3 is the button
Seat 1: P1xel7 (137392)
Seat 2: Bar2ligne (109534)
Seat 3: AlkZeus (67698)
Seat 4: oryx88 (12237)
Seat 5: La ceniza (32046)
Seat 6: deivGo (29935)
*** ANTE/BLINDS ***
oryx88 posts ante 350
La ceniza posts ante 350
P1xel7 posts ante 350
Bar2ligne posts ante 350
AlkZeus posts ante 350
deivGo posts ante 350
oryx88 posts small blind 1500
La ceniza posts big blind 3000
Dealt to P1xel7 [9d 8s]
*** PRE-FLOP *** 
deivGo folds
P1xel7 folds
Bar2ligne folds
AlkZeus folds
oryx88 raises 8887 to 11887 and is all-in
La ceniza calls 8887
*** FLOP *** [Qc Ks Th]
*** TURN *** [Qc Ks Th][6c]
*** RIVER *** [Qc Ks Th 6c][Ah]
*** SHOW DOWN ***
La ceniza shows [Kc 2c] (One pair : Kings)
oryx88 shows [Ad Qs] (Two pairs : Aces and Queens)
oryx88 collected 25874 from pot
*** SUMMARY ***
Total pot 25874 | No rake
Board: [Qc Ks Th 6c Ah]
Seat 4: oryx88 (small blind) showed [Ad Qs] and won 25874 with Two pairs : Aces and Queens
Seat 5: La ceniza (big blind) showed [Kc 2c] and lost with One pair : Kings


Winamax Poker - Tournament "MYSTERY KO" buyIn: 0.90€ + 0.10€ level: 16 - HandId: #3047856029015474207-142-1700084475 - Holdem no limit (350/1500/3000) - 2023/11/15 21:41:15 UTC
Table: 'MYSTERY KO(709634281)#0030' 6-max (real money) Seat #4 is the button
Seat 1: P1xel7 (137042)
Seat 2: Bar2ligne (109184)
Seat 3: AlkZeus (67348)
Seat 4: oryx88 (25874)
Seat 5: La ceniza (19809)
Seat 6: deivGo (29585)
*** ANTE/BLINDS ***
La ceniza posts ante 350
deivGo posts ante 350
P1xel7 posts ante 350
Bar2ligne posts ante 350
AlkZeus posts ante 350
oryx88 posts ante 350
La ceniza posts small blind 1500
deivGo posts big blind 3000
Dealt to P1xel7 [2h Jd]
*** PRE-FLOP *** 
P1xel7 folds
Bar2ligne raises 3000 to 6000
AlkZeus folds
oryx88 folds
La ceniza folds
deivGo folds
Bar2ligne collected 12600 from pot
*** SUMMARY ***
Total pot 12600 | No rake
Seat 2: Bar2ligne won 12600


Winamax Poker - Tournament "MYSTERY KO" buyIn: 0.90€ + 0.10€ level: 16 - HandId: #3047856029015474207-143-1700084492 - Holdem no limit (350/1500/3000) - 2023/11/15 21:41:32 UTC
Table: 'MYSTERY KO(709634281)#0030' 6-max (real money) Seat #5 is the button
Seat 1: P1xel7 (136692)
Seat 2: Bar2ligne (115434)
Seat 3: AlkZeus (66998)
Seat 4: oryx88 (25524)
Seat 5: La ceniza (17959)
Seat 6: deivGo (26235)
*** ANTE/BLINDS ***
deivGo posts ante 350
P1xel7 posts ante 350
Bar2ligne posts ante 350
AlkZeus posts ante 350
oryx88 posts ante 350
La ceniza posts ante 350
deivGo posts small blind 1500
P1xel7 posts big blind 3000
Dealt to P1xel7 [Ah Ts]
*** PRE-FLOP *** 
Bar2ligne folds
AlkZeus folds
oryx88 calls 3000
La ceniza folds
deivGo raises 22885 to 25885 and is all-in
P1xel7 calls 22885
oryx88 calls 22174 and is all-in
*** FLOP *** [6s Kh 6c]
*** TURN *** [6s Kh 6c][9d]
*** RIVER *** [6s Kh 6c 9d][Qc]
*** SHOW DOWN ***
P1xel7 shows [Ah Ts] (One pair : 6)
oryx88 shows [Ad 7c] (One pair : 6)
deivGo shows [Ac 9s] (Two pairs : 9 and 6)
deivGo collected 79044 from pot
*** SUMMARY ***
Total pot 79044 | No rake
Board: [6s Kh 6c 9d Qc]
Seat 1: P1xel7 (big blind) showed [Ah Ts] and lost with One pair : 6
Seat 4: oryx88 showed [Ad 7c] and lost with One pair : 6
Seat 6: deivGo (small blind) showed [Ac 9s] and won 79044 with Two pairs : 9 and 6


Winamax Poker - Tournament "MYSTERY KO" buyIn: 0.90€ + 0.10€ level: 16 - HandId: #3047856029015474207-144-1700084530 - Holdem no limit (350/1500/3000) - 2023/11/15 21:42:10 UTC
Table: 'MYSTERY KO(709634281)#0030' 6-max (real money) Seat #6 is the button
Seat 1: P1xel7 (110457)
Seat 2: Bar2ligne (115084)
Seat 3: AlkZeus (66648)
Seat 5: La ceniza (17609)
Seat 6: deivGo (79044)
*** ANTE/BLINDS ***
P1xel7 posts ante 350
Bar2ligne posts ante 350
AlkZeus posts ante 350
La ceniza posts ante 350
deivGo posts ante 350
P1xel7 posts small blind 1500
Bar2ligne posts big blind 3000
Dealt to P1xel7 [4s Ah]
*** PRE-FLOP *** 
AlkZeus folds
La ceniza raises 4500 to 7500
deivGo raises 15000 to 22500
P1xel7 folds
Bar2ligne folds
La ceniza calls 9759 and is all-in
*** FLOP *** [Kh Ac Kc]
*** TURN *** [Kh Ac Kc][As]
*** RIVER *** [Kh Ac Kc As][8s]
*** SHOW DOWN ***
La ceniza shows [Ks Kd] (Quads of Kings)
deivGo shows [Qh Qc] (Two pairs : Aces and Kings)
deivGo collected 5241 from side pot 1
La ceniza collected 40768 from main pot
*** SUMMARY ***
Total pot 46009 | No rake
Board: [Kh Ac Kc As 8s]
Seat 5: La ceniza showed [Ks Kd] and won 40768 with Quads of Kings
Seat 6: deivGo (button) showed [Qh Qc] and won 5241 with Two pairs : Aces and Kings


Winamax Poker - Tournament "MYSTERY KO" buyIn: 0.90€ + 0.10€ level: 16 - HandId: #3047856029015474207-145-1700084562 - Holdem no limit (350/1500/3000) - 2023/11/15 21:42:42 UTC
Table: 'MYSTERY KO(709634281)#0030' 6-max (real money) Seat #1 is the button
Seat 1: P1xel7 (108607)
Seat 2: Bar2ligne (111734)
Seat 3: AlkZeus (66298)
Seat 4: Tino-10 wnm (107672)
Seat 5: La ceniza (40768)
Seat 6: deivGo (61435)
*** ANTE/BLINDS ***
Bar2ligne posts ante 350
AlkZeus posts ante 350
P1xel7 posts ante 350
Tino-10 wnm posts ante 350
La ceniza posts ante 350
deivGo posts ante 350
Bar2ligne posts small blind 1500
AlkZeus posts big blind 3000
Dealt to P1xel7 [2h 3d]
*** PRE-FLOP *** 
Tino-10 wnm folds
La ceniza folds
deivGo raises 3000 to 6000
P1xel7 folds
Bar2ligne folds
AlkZeus folds
deivGo collected 12600 from pot
*** SUMMARY ***
Total pot 12600 | No rake
Seat 6: deivGo won 12600


Winamax Poker - Tournament "MYSTERY KO" buyIn: 0.90€ + 0.10€ level: 16 - HandId: #3047856029015474207-146-1700084596 - Holdem no limit (350/1500/3000) - 2023/11/15 21:43:16 UTC
Table: 'MYSTERY KO(709634281)#0030' 6-max (real money) Seat #2 is the button
Seat 1: P1xel7 (108257)
Seat 2: Bar2ligne (109884)
Seat 3: AlkZeus (62948)
Seat 4: Tino-10 wnm (107322)
Seat 5: La ceniza (40418)
Seat 6: deivGo (67685)
*** ANTE/BLINDS ***
AlkZeus posts ante 350
Tino-10 wnm posts ante 350
P1xel7 posts ante 350
Bar2ligne posts ante 350
La ceniza posts ante 350
deivGo posts ante 350
AlkZeus posts small blind 1500
Tino-10 wnm posts big blind 3000
Dealt to P1xel7 [6h 4h]
*** PRE-FLOP *** 
La ceniza folds
deivGo folds
P1xel7 folds
Bar2ligne folds
AlkZeus folds
Tino-10 wnm collected 6600 from pot
*** SUMMARY ***
Total pot 6600 | No rake
Seat 4: Tino-10 wnm (big blind) won 6600


Winamax Poker - Tournament "MYSTERY KO" buyIn: 0.90€ + 0.10€ level: 16 - HandId: #3047856029015474207-147-1700084609 - Holdem no limit (350/1500/3000) - 2023/11/15 21:43:29 UTC
Table: 'MYSTERY KO(709634281)#0030' 6-max (real money) Seat #3 is the button
Seat 1: P1xel7 (107907)
Seat 2: Bar2ligne (109534)
Seat 3: AlkZeus (61098)
Seat 4: Tino-10 wnm (110572)
Seat 5: La ceniza (40068)
Seat 6: deivGo (67335)
*** ANTE/BLINDS ***
Tino-10 wnm posts ante 350
La ceniza posts ante 350
P1xel7 posts ante 350
Bar2ligne posts ante 350
AlkZeus posts ante 350
deivGo posts ante 350
Tino-10 wnm posts small blind 1500
La ceniza posts big blind 3000
Dealt to P1xel7 [5c Kh]
*** PRE-FLOP *** 
deivGo folds
P1xel7 folds
Bar2ligne raises 3000 to 6000
AlkZeus folds
Tino-10 wnm folds
La ceniza calls 3000
*** FLOP *** [6c Ts 4c]
La ceniza checks
Bar2ligne checks
*** TURN *** [6c Ts 4c][4s]
La ceniza bets 5460
Bar2ligne folds
La ceniza collected 21060 from pot
*** SUMMARY ***
Total pot 21060 | No rake
Board: [6c Ts 4c 4s]
Seat 5: La ceniza (big blind) won 21060


Winamax Poker - Tournament "MYSTERY KO" buyIn: 0.90€ + 0.10€ level: 16 - HandId: #3047856029015474207-148-1700084647 - Holdem no limit (350/1500/3000) - 2023/11/15 21:44:07 UTC
Table: 'MYSTERY KO(709634281)#0030' 6-max (real money) Seat #4 is the button
Seat 1: P1xel7 (107557)
Seat 2: Bar2ligne (103184)
Seat 3: AlkZeus (60748)
Seat 4: Tino-10 wnm (108722)
Seat 5: La ceniza (49318)
Seat 6: deivGo (66985)
*** ANTE/BLINDS ***
La ceniza posts ante 350
deivGo posts ante 350
P1xel7 posts ante 350
Bar2ligne posts ante 350
AlkZeus posts ante 350
Tino-10 wnm posts ante 350
La ceniza posts small blind 1500
deivGo posts big blind 3000
Dealt to P1xel7 [8c 9s]
*** PRE-FLOP *** 
P1xel7 folds
Bar2ligne folds
AlkZeus folds
Tino-10 wnm folds
La ceniza folds
deivGo collected 6600 from pot
*** SUMMARY ***
Total pot 6600 | No rake
Seat 6: deivGo (big blind) won 6600


Winamax Poker - Tournament "MYSTERY KO" buyIn: 0.90€ + 0.10€ level: 16 - HandId: #3047856029015474207-149-1700084661 - Holdem no limit (350/1500/3000) - 2023/11/15 21:44:21 UTC
Table: 'MYSTERY KO(709634281)#0030' 6-max (real money) Seat #5 is the button
Seat 1: P1xel7 (107207)
Seat 2: Bar2ligne (102834)
Seat 3: AlkZeus (60398)
Seat 4: Tino-10 wnm (108372)
Seat 5: La ceniza (47468)
Seat 6: deivGo (70235)
*** ANTE/BLINDS ***
deivGo posts ante 350
P1xel7 posts ante 350
Bar2ligne posts ante 350
AlkZeus posts ante 350
Tino-10 wnm posts ante 350
La ceniza posts ante 350
deivGo posts small blind 1500
P1xel7 posts big blind 3000
Dealt to P1xel7 [Jc 8h]
*** PRE-FLOP *** 
Bar2ligne folds
AlkZeus folds
Tino-10 wnm calls 3000
La ceniza folds
deivGo calls 1500
P1xel7 checks
*** FLOP *** [As 8c Js]
deivGo checks
P1xel7 bets 5550
Tino-10 wnm folds
deivGo calls 5550
*** TURN *** [As 8c Js][Tc]
deivGo checks
P1xel7 bets 14430
deivGo raises 46905 to 61335 and is all-in
P1xel7 calls 46905
*** RIVER *** [As 8c Js Tc][3c]
*** SHOW DOWN ***
P1xel7 shows [Jc 8h] (Two pairs : Jacks and 8)
deivGo shows [Jd Ts] (Two pairs : Jacks and Tens)
deivGo collected 144870 from pot
*** SUMMARY ***
Total pot 144870 | No rake
Board: [As 8c Js Tc 3c]
Seat 1: P1xel7 (big blind) showed [Jc 8h] and lost with Two pairs : Jacks and 8
Seat 6: deivGo (small blind) showed [Jd Ts] and won 144870 with Two pairs : Jacks and Tens


Winamax Poker - Tournament "MYSTERY KO" buyIn: 0.90€ + 0.10€ level: 16 - HandId: #3047856029015474207-150-1700084762 - Holdem no limit (350/1500/3000) - 2023/11/15 21:46:02 UTC
Table: 'MYSTERY KO(709634281)#0030' 6-max (real money) Seat #6 is the button
Seat 1: P1xel7 (36972)
Seat 2: Bar2ligne (102484)
Seat 3: AlkZeus (60048)
Seat 4: Tino-10 wnm (105022)
Seat 5: La ceniza (47118)
Seat 6: deivGo (144870)
*** ANTE/BLINDS ***
P1xel7 posts ante 350
Bar2ligne posts ante 350
AlkZeus posts ante 350
Tino-10 wnm posts ante 350
La ceniza posts ante 350
deivGo posts ante 350
P1xel7 posts small blind 1500
Bar2ligne posts big blind 3000
Dealt to P1xel7 [9c 2c]
*** PRE-FLOP *** 
AlkZeus folds
Tino-10 wnm folds
La ceniza folds
deivGo folds
P1xel7 folds
Bar2ligne collected 6600 from pot
*** SUMMARY ***
Total pot 6600 | No rake
Seat 2: Bar2ligne (big blind) won 6600


Winamax Poker - Tournament "MYSTERY KO" buyIn: 0.90€ + 0.10€ level: 16 - HandId: #3047856029015474207-151-1700084804 - Holdem no limit (350/1500/3000) - 2023/11/15 21:46:44 UTC
Table: 'MYSTERY KO(709634281)#0030' 6-max (real money) Seat #1 is the button
Seat 1: P1xel7 (35122)
Seat 2: Bar2ligne (105734)
Seat 3: AlkZeus (59698)
Seat 4: Tino-10 wnm (104672)
Seat 5: La ceniza (46768)
Seat 6: deivGo (144520)
*** ANTE/BLINDS ***
Bar2ligne posts ante 350
AlkZeus posts ante 350
P1xel7 posts ante 350
Tino-10 wnm posts ante 350
La ceniza posts ante 350
deivGo posts ante 350
Bar2ligne posts small blind 1500
AlkZeus posts big blind 3000
Dealt to P1xel7 [Ts Ah]
*** PRE-FLOP *** 
Tino-10 wnm folds
La ceniza folds
deivGo folds
P1xel7 raises 31772 to 34772 and is all-in
Bar2ligne folds
AlkZeus calls 31772
*** FLOP *** [Ks 2h 5h]
*** TURN *** [Ks 2h 5h][8d]
*** RIVER *** [Ks 2h 5h 8d][3s]
*** SHOW DOWN ***
AlkZeus shows [4s Js] (High card : King)
P1xel7 shows [Ts Ah] (High card : Ace)
P1xel7 collected 73144 from pot
*** SUMMARY ***
Total pot 73144 | No rake
Board: [Ks 2h 5h 8d 3s]
Seat 1: P1xel7 (button) showed [Ts Ah] and won 73144 with High card : Ace
Seat 3: AlkZeus (big blind) showed [4s Js] and lost with High card : King


Winamax Poker - Tournament "MYSTERY KO" buyIn: 0.90€ + 0.10€ level: 17 - HandId: #3047856029015474207-152-1700084836 - Holdem no limit (400/1750/3500) - 2023/11/15 21:47:16 UTC
Table: 'MYSTERY KO(709634281)#0030' 6-max (real money) Seat #2 is the button
Seat 1: P1xel7 (73144)
Seat 2: Bar2ligne (103884)
Seat 3: AlkZeus (24576)
Seat 4: Tino-10 wnm (104322)
Seat 5: La ceniza (46418)
Seat 6: deivGo (144170)
*** ANTE/BLINDS ***
AlkZeus posts ante 400
Tino-10 wnm posts ante 400
P1xel7 posts ante 400
Bar2ligne posts ante 400
La ceniza posts ante 400
deivGo posts ante 400
AlkZeus posts small blind 1750
Tino-10 wnm posts big blind 3500
Dealt to P1xel7 [2s Jd]
*** PRE-FLOP *** 
La ceniza folds
deivGo raises 3500 to 7000
P1xel7 folds
Bar2ligne raises 15750 to 22750
AlkZeus raises 1426 to 24176 and is all-in
Tino-10 wnm folds
deivGo folds
Bar2ligne calls 1426
*** FLOP *** [As 5c 3s]
*** TURN *** [As 5c 3s][Qc]
*** RIVER *** [As 5c 3s Qc][Tc]
*** SHOW DOWN ***
Bar2ligne shows [3h Kh] (One pair : 3)
AlkZeus shows [Qd 7c] (One pair : Queens)
AlkZeus collected 61252 from pot
*** SUMMARY ***
Total pot 61252 | No rake
Board: [As 5c 3s Qc Tc]
Seat 2: Bar2ligne (button) showed [3h Kh] and lost with One pair : 3
Seat 3: AlkZeus (small blind) showed [Qd 7c] and won 61252 with One pair : Queens


Winamax Poker - Tournament "MYSTERY KO" buyIn: 0.90€ + 0.10€ level: 17 - HandId: #3047856029015474207-153-1700084896 - Holdem no limit (400/1750/3500) - 2023/11/15 21:48:16 UTC
Table: 'MYSTERY KO(709634281)#0030' 6-max (real money) Seat #3 is the button
Seat 1: P1xel7 (72744)
Seat 2: Bar2ligne (79308)
Seat 3: AlkZeus (61252)
Seat 4: Tino-10 wnm (100422)
Seat 5: La ceniza (46018)
Seat 6: deivGo (136770)
*** ANTE/BLINDS ***
Tino-10 wnm posts ante 400
La ceniza posts ante 400
P1xel7 posts ante 400
Bar2ligne posts ante 400
AlkZeus posts ante 400
deivGo posts ante 400
Tino-10 wnm posts small blind 1750
La ceniza posts big blind 3500
Dealt to P1xel7 [Ah Ks]
*** PRE-FLOP *** 
deivGo folds
P1xel7 raises 7000 to 10500
Bar2ligne folds
AlkZeus folds
Tino-10 wnm folds
La ceniza folds
P1xel7 collected 18150 from pot
*** SUMMARY ***
Total pot 18150 | No rake
Seat 1: P1xel7 won 18150


Winamax Poker - Tournament "MYSTERY KO" buyIn: 0.90€ + 0.10€ level: 17 - HandId: #3047856029015474207-154-1700084937 - Holdem no limit (400/1750/3500) - 2023/11/15 21:48:57 UTC
Table: 'MYSTERY KO(709634281)#0030' 6-max (real money) Seat #4 is the button
Seat 1: P1xel7 (79994)
Seat 2: Bar2ligne (78908)
Seat 3: AlkZeus (60852)
Seat 4: Tino-10 wnm (98272)
Seat 5: La ceniza (42118)
Seat 6: deivGo (136370)
*** ANTE/BLINDS ***
La ceniza posts ante 400
deivGo posts ante 400
P1xel7 posts ante 400
Bar2ligne posts ante 400
AlkZeus posts ante 400
Tino-10 wnm posts ante 400
La ceniza posts small blind 1750
deivGo posts big blind 3500
Dealt to P1xel7 [Kh Ac]
*** PRE-FLOP *** 
P1xel7 raises 7000 to 10500
Bar2ligne folds
AlkZeus folds
Tino-10 wnm folds
La ceniza folds
deivGo calls 7000
*** FLOP *** [7c Jh 8d]
deivGo checks
P1xel7 bets 16348
deivGo folds
P1xel7 collected 41498 from pot
*** SUMMARY ***
Total pot 41498 | No rake
Board: [7c Jh 8d]
Seat 1: P1xel7 won 41498


Winamax Poker - Tournament "MYSTERY KO" buyIn: 0.90€ + 0.10€ level: 17 - HandId: #3047856029015474207-155-1700085007 - Holdem no limit (400/1750/3500) - 2023/11/15 21:50:07 UTC
Table: 'MYSTERY KO(709634281)#0030' 6-max (real money) Seat #5 is the button
Seat 1: P1xel7 (94244)
Seat 2: Bar2ligne (78508)
Seat 3: AlkZeus (60452)
Seat 4: Tino-10 wnm (97872)
Seat 5: La ceniza (39968)
Seat 6: deivGo (125470)
*** ANTE/BLINDS ***
deivGo posts ante 400
P1xel7 posts ante 400
Bar2ligne posts ante 400
AlkZeus posts ante 400
Tino-10 wnm posts ante 400
La ceniza posts ante 400
deivGo posts small blind 1750
P1xel7 posts big blind 3500
Dealt to P1xel7 [7s 3d]
*** PRE-FLOP *** 
Bar2ligne folds
AlkZeus folds
Tino-10 wnm folds
La ceniza folds
deivGo raises 7000 to 10500
P1xel7 folds
deivGo collected 16400 from pot
*** SUMMARY ***
Total pot 16400 | No rake
Seat 6: deivGo (small blind) won 16400


Winamax Poker - Tournament "MYSTERY KO" buyIn: 0.90€ + 0.10€ level: 17 - HandId: #3047856029015474200-165-1700085081 - Holdem no limit (400/1750/3500) - 2023/11/15 21:51:21 UTC
Table: 'MYSTERY KO(709634281)#0023' 6-max (real money) Seat #4 is the button
Seat 1: U-GOD (64592)
Seat 2: P4ngAll-In (61960)
Seat 3: P1xel7 (90344)
Seat 5: SpearF (93942)
Seat 6: misterweed (300137)
*** ANTE/BLINDS ***
SpearF posts ante 400
misterweed posts ante 400
U-GOD posts ante 400
P4ngAll-In posts ante 400
P1xel7 posts ante 400
SpearF posts small blind 1750
misterweed posts big blind 3500
Dealt to P1xel7 [Tc 6h]
*** PRE-FLOP *** 
U-GOD folds
P4ngAll-In folds
P1xel7 folds
SpearF folds
misterweed collected 7250 from pot
*** SUMMARY ***
Total pot 7250 | No rake
Seat 6: misterweed (big blind) won 7250


Winamax Poker - Tournament "MYSTERY KO" buyIn: 0.90€ + 0.10€ level: 17 - HandId: #3047856029015474200-166-1700085107 - Holdem no limit (400/1750/3500) - 2023/11/15 21:51:47 UTC
Table: 'MYSTERY KO(709634281)#0023' 6-max (real money) Seat #5 is the button
Seat 1: U-GOD (64192)
Seat 2: P4ngAll-In (61560)
Seat 3: P1xel7 (89944)
Seat 5: SpearF (91792)
Seat 6: misterweed (303487)
*** ANTE/BLINDS ***
misterweed posts ante 400
U-GOD posts ante 400
P4ngAll-In posts ante 400
P1xel7 posts ante 400
SpearF posts ante 400
misterweed posts small blind 1750
U-GOD posts big blind 3500
Dealt to P1xel7 [Kh 8h]
*** PRE-FLOP *** 
P4ngAll-In folds
P1xel7 raises 5250 to 8750
SpearF folds
misterweed folds
U-GOD raises 55042 to 63792 and is all-in
P1xel7 folds
U-GOD collected 76292 from pot
*** SUMMARY ***
Total pot 76292 | No rake
Seat 1: U-GOD (big blind) won 76292


Winamax Poker - Tournament "MYSTERY KO" buyIn: 0.90€ + 0.10€ level: 17 - HandId: #3047856029015474200-167-1700085142 - Holdem no limit (400/1750/3500) - 2023/11/15 21:52:22 UTC
Table: 'MYSTERY KO(709634281)#0023' 6-max (real money) Seat #6 is the button
Seat 1: U-GOD (76292)
Seat 2: P4ngAll-In (61160)
Seat 3: P1xel7 (80794)
Seat 5: SpearF (91392)
Seat 6: misterweed (301337)
*** ANTE/BLINDS ***
U-GOD posts ante 400
P4ngAll-In posts ante 400
P1xel7 posts ante 400
SpearF posts ante 400
misterweed posts ante 400
U-GOD posts small blind 1750
P4ngAll-In posts big blind 3500
Dealt to P1xel7 [Qs Kc]
*** PRE-FLOP *** 
P1xel7 raises 5250 to 8750
SpearF folds
misterweed folds
U-GOD raises 67142 to 75892 and is all-in
P4ngAll-In folds
P1xel7 folds
U-GOD collected 90142 from pot
*** SUMMARY ***
Total pot 90142 | No rake
Seat 1: U-GOD (small blind) won 90142


Winamax Poker - Tournament "MYSTERY KO" buyIn: 0.90€ + 0.10€ level: 17 - HandId: #3047856029015474200-168-1700085176 - Holdem no limit (400/1750/3500) - 2023/11/15 21:52:56 UTC
Table: 'MYSTERY KO(709634281)#0023' 6-max (real money) Seat #1 is the button
Seat 1: U-GOD (90142)
Seat 2: P4ngAll-In (57260)
Seat 3: P1xel7 (71644)
Seat 5: SpearF (90992)
Seat 6: misterweed (300937)
*** ANTE/BLINDS ***
P4ngAll-In posts ante 400
P1xel7 posts ante 400
U-GOD posts ante 400
SpearF posts ante 400
misterweed posts ante 400
P4ngAll-In posts small blind 1750
P1xel7 posts big blind 3500
Dealt to P1xel7 [Tc 2d]
*** PRE-FLOP *** 
SpearF folds
misterweed calls 3500
U-GOD folds
P4ngAll-In folds
P1xel7 checks
*** FLOP *** [7s 3h Qc]
P1xel7 checks
misterweed bets 3500
P1xel7 folds
misterweed collected 14250 from pot
*** SUMMARY ***
Total pot 14250 | No rake
Board: [7s 3h Qc]
Seat 6: misterweed won 14250


Winamax Poker - Tournament "MYSTERY KO" buyIn: 0.90€ + 0.10€ level: 17 - HandId: #3047856029015474200-169-1700085213 - Holdem no limit (400/1750/3500) - 2023/11/15 21:53:33 UTC
Table: 'MYSTERY KO(709634281)#0023' 6-max (real money) Seat #2 is the button
Seat 1: U-GOD (89742)
Seat 2: P4ngAll-In (55110)
Seat 3: P1xel7 (67744)
Seat 4: k2f292 (78647)
Seat 5: SpearF (90592)
Seat 6: misterweed (307787)
*** ANTE/BLINDS ***
P1xel7 posts ante 400
k2f292 posts ante 400
U-GOD posts ante 400
P4ngAll-In posts ante 400
SpearF posts ante 400
misterweed posts ante 400
P1xel7 posts small blind 1750
k2f292 posts big blind 3500
Dealt to P1xel7 [Tc 2s]
*** PRE-FLOP *** 
SpearF folds
misterweed raises 11150 to 14650
U-GOD folds
P4ngAll-In folds
P1xel7 folds
k2f292 folds
misterweed collected 22300 from pot
*** SUMMARY ***
Total pot 22300 | No rake
Seat 6: misterweed won 22300


Winamax Poker - Tournament "MYSTERY KO" buyIn: 0.90€ + 0.10€ level: 17 - HandId: #3047856029015474200-170-1700085227 - Holdem no limit (400/1750/3500) - 2023/11/15 21:53:47 UTC
Table: 'MYSTERY KO(709634281)#0023' 6-max (real money) Seat #3 is the button
Seat 1: U-GOD (89342)
Seat 2: P4ngAll-In (54710)
Seat 3: P1xel7 (65594)
Seat 4: k2f292 (74747)
Seat 5: SpearF (90192)
Seat 6: misterweed (315037)
*** ANTE/BLINDS ***
k2f292 posts ante 400
SpearF posts ante 400
U-GOD posts ante 400
P4ngAll-In posts ante 400
P1xel7 posts ante 400
misterweed posts ante 400
k2f292 posts small blind 1750
SpearF posts big blind 3500
Dealt to P1xel7 [Kh Qc]
*** PRE-FLOP *** 
misterweed calls 3500
U-GOD folds
P4ngAll-In folds
P1xel7 raises 10500 to 14000
k2f292 folds
SpearF folds
misterweed calls 10500
*** FLOP *** [4d 4h Td]
misterweed checks
P1xel7 bets 51194 and is all-in
misterweed folds
P1xel7 collected 86844 from pot
*** SUMMARY ***
Total pot 86844 | No rake
Board: [4d 4h Td]
Seat 3: P1xel7 (button) won 86844


Winamax Poker - Tournament "MYSTERY KO" buyIn: 0.90€ + 0.10€ level: 18 - HandId: #3047856029015474200-171-1700085295 - Holdem no limit (500/2000/4000) - 2023/11/15 21:54:55 UTC
Table: 'MYSTERY KO(709634281)#0023' 6-max (real money) Seat #4 is the button
Seat 1: U-GOD (88942)
Seat 2: P4ngAll-In (54310)
Seat 3: P1xel7 (86844)
Seat 4: k2f292 (72597)
Seat 5: SpearF (86292)
Seat 6: misterweed (300637)
*** ANTE/BLINDS ***
SpearF posts ante 500
misterweed posts ante 500
U-GOD posts ante 500
P4ngAll-In posts ante 500
P1xel7 posts ante 500
k2f292 posts ante 500
SpearF posts small blind 2000
misterweed posts big blind 4000
Dealt to P1xel7 [2h Th]
*** PRE-FLOP *** 
U-GOD folds
P4ngAll-In folds
P1xel7 folds
k2f292 raises 13000 to 17000
SpearF raises 68792 to 85792 and is all-in
misterweed folds
k2f292 calls 55097 and is all-in
*** FLOP *** [9s 5d Ts]
*** TURN *** [9s 5d Ts][7s]
*** RIVER *** [9s 5d Ts 7s][2c]
*** SHOW DOWN ***
k2f292 shows [Kc Kh] (One pair : Kings)
SpearF shows [Ks As] (Flush Ace high)
SpearF collected 164889 from pot
*** SUMMARY ***
Total pot 164889 | No rake
Board: [9s 5d Ts 7s 2c]
Seat 4: k2f292 (button) showed [Kc Kh] and lost with One pair : Kings
Seat 5: SpearF (small blind) showed [Ks As] and won 164889 with Flush Ace high


Winamax Poker - Tournament "MYSTERY KO" buyIn: 0.90€ + 0.10€ level: 18 - HandId: #3047856029015474200-172-1700085661 - Holdem no limit (500/2000/4000) - 2023/11/15 22:01:01 UTC
Table: 'MYSTERY KO(709634281)#0023' 6-max (real money) Seat #5 is the button
Seat 1: U-GOD (88442)
Seat 2: P4ngAll-In (53810)
Seat 3: P1xel7 (86344)
Seat 4: GrizarPro (34749)
Seat 5: SpearF (164889)
Seat 6: misterweed (296137)
*** ANTE/BLINDS ***
misterweed posts ante 500
U-GOD posts ante 500
P4ngAll-In posts ante 500
P1xel7 posts ante 500
GrizarPro posts ante 500
SpearF posts ante 500
misterweed posts small blind 2000
U-GOD posts big blind 4000
Dealt to P1xel7 [2s Th]
*** PRE-FLOP *** 
P4ngAll-In folds
P1xel7 folds
GrizarPro raises 30249 to 34249 and is all-in
SpearF folds
misterweed folds
U-GOD folds
GrizarPro collected 43249 from pot
*** SUMMARY ***
Total pot 43249 | No rake
Seat 4: GrizarPro won 43249


Winamax Poker - Tournament "MYSTERY KO" buyIn: 0.90€ + 0.10€ level: 18 - HandId: #3047856029015474200-173-1700085688 - Holdem no limit (500/2000/4000) - 2023/11/15 22:01:28 UTC
Table: 'MYSTERY KO(709634281)#0023' 6-max (real money) Seat #6 is the button
Seat 1: U-GOD (83942)
Seat 2: P4ngAll-In (53310)
Seat 3: P1xel7 (85844)
Seat 4: GrizarPro (43249)
Seat 5: SpearF (164389)
Seat 6: misterweed (293637)
*** ANTE/BLINDS ***
U-GOD posts ante 500
P4ngAll-In posts ante 500
P1xel7 posts ante 500
GrizarPro posts ante 500
SpearF posts ante 500
misterweed posts ante 500
U-GOD posts small blind 2000
P4ngAll-In posts big blind 4000
Dealt to P1xel7 [5d 2c]
*** PRE-FLOP *** 
P1xel7 folds
GrizarPro raises 38749 to 42749 and is all-in
SpearF folds
misterweed folds
U-GOD folds
P4ngAll-In calls 38749
*** FLOP *** [2s 3c Kd]
*** TURN *** [2s 3c Kd][Qc]
*** RIVER *** [2s 3c Kd Qc][8d]
*** SHOW DOWN ***
P4ngAll-In shows [Ad Jd] (High card : Ace)
GrizarPro shows [Qs Jh] (One pair : Queens)
GrizarPro collected 90498 from pot
*** SUMMARY ***
Total pot 90498 | No rake
Board: [2s 3c Kd Qc 8d]
Seat 2: P4ngAll-In (big blind) showed [Ad Jd] and lost with High card : Ace
Seat 4: GrizarPro showed [Qs Jh] and won 90498 with One pair : Queens


Winamax Poker - Tournament "MYSTERY KO" buyIn: 0.90€ + 0.10€ level: 18 - HandId: #3047856029015474200-174-1700085730 - Holdem no limit (500/2000/4000) - 2023/11/15 22:02:10 UTC
Table: 'MYSTERY KO(709634281)#0023' 6-max (real money) Seat #1 is the button
Seat 1: U-GOD (81442)
Seat 2: P4ngAll-In (10061)
Seat 3: P1xel7 (85344)
Seat 4: GrizarPro (90498)
Seat 5: SpearF (163889)
Seat 6: misterweed (293137)
*** ANTE/BLINDS ***
P4ngAll-In posts ante 500
P1xel7 posts ante 500
U-GOD posts ante 500
GrizarPro posts ante 500
SpearF posts ante 500
misterweed posts ante 500
P4ngAll-In posts small blind 2000
P1xel7 posts big blind 4000
Dealt to P1xel7 [Jc Jh]
*** PRE-FLOP *** 
GrizarPro folds
SpearF folds
misterweed folds
U-GOD folds
P4ngAll-In raises 5561 to 9561 and is all-in
P1xel7 calls 5561
*** FLOP *** [7c Kh 6h]
*** TURN *** [7c Kh 6h][Td]
*** RIVER *** [7c Kh 6h Td][Ac]
*** SHOW DOWN ***
P1xel7 shows [Jc Jh] (One pair : Jacks)
P4ngAll-In shows [Qc Js] (Straight Ace high)
P4ngAll-In collected 22122 from pot
*** SUMMARY ***
Total pot 22122 | No rake
Board: [7c Kh 6h Td Ac]
Seat 2: P4ngAll-In (small blind) showed [Qc Js] and won 22122 with Straight Ace high
Seat 3: P1xel7 (big blind) showed [Jc Jh] and lost with One pair : Jacks


Winamax Poker - Tournament "MYSTERY KO" buyIn: 0.90€ + 0.10€ level: 18 - HandId: #3047856029015474200-175-1700085757 - Holdem no limit (500/2000/4000) - 2023/11/15 22:02:37 UTC
Table: 'MYSTERY KO(709634281)#0023' 6-max (real money) Seat #2 is the button
Seat 1: U-GOD (80942)
Seat 2: P4ngAll-In (22122)
Seat 3: P1xel7 (75283)
Seat 4: GrizarPro (89998)
Seat 5: SpearF (163389)
Seat 6: misterweed (292637)
*** ANTE/BLINDS ***
P1xel7 posts ante 500
GrizarPro posts ante 500
U-GOD posts ante 500
P4ngAll-In posts ante 500
SpearF posts ante 500
misterweed posts ante 500
P1xel7 posts small blind 2000
GrizarPro posts big blind 4000
Dealt to P1xel7 [As 2d]
*** PRE-FLOP *** 
SpearF folds
misterweed raises 288137 to 292137 and is all-in
U-GOD folds
P4ngAll-In folds
P1xel7 folds
GrizarPro folds
misterweed collected 301137 from pot
*** SUMMARY ***
Total pot 301137 | No rake
Seat 6: misterweed won 301137


Winamax Poker - Tournament "MYSTERY KO" buyIn: 0.90€ + 0.10€ level: 18 - HandId: #3047856029015474200-176-1700085785 - Holdem no limit (500/2000/4000) - 2023/11/15 22:03:05 UTC
Table: 'MYSTERY KO(709634281)#0023' 6-max (real money) Seat #3 is the button
Seat 1: U-GOD (80442)
Seat 2: P4ngAll-In (21622)
Seat 3: P1xel7 (72783)
Seat 4: GrizarPro (85498)
Seat 5: SpearF (162889)
Seat 6: misterweed (301137)
*** ANTE/BLINDS ***
GrizarPro posts ante 500
SpearF posts ante 500
U-GOD posts ante 500
P4ngAll-In posts ante 500
P1xel7 posts ante 500
misterweed posts ante 500
GrizarPro posts small blind 2000
SpearF posts big blind 4000
Dealt to P1xel7 [Td 6h]
*** PRE-FLOP *** 
misterweed folds
U-GOD folds
P4ngAll-In folds
P1xel7 folds
GrizarPro raises 6000 to 10000
SpearF folds
GrizarPro collected 17000 from pot
*** SUMMARY ***
Total pot 17000 | No rake
Seat 4: GrizarPro (small blind) won 17000


Winamax Poker - Tournament "MYSTERY KO" buyIn: 0.90€ + 0.10€ level: 18 - HandId: #3047856029015474200-177-1700085809 - Holdem no limit (500/2000/4000) - 2023/11/15 22:03:29 UTC
Table: 'MYSTERY KO(709634281)#0023' 6-max (real money) Seat #4 is the button
Seat 1: U-GOD (79942)
Seat 2: P4ngAll-In (21122)
Seat 3: P1xel7 (72283)
Seat 4: GrizarPro (91998)
Seat 5: SpearF (158389)
Seat 6: misterweed (300637)
*** ANTE/BLINDS ***
SpearF posts ante 500
misterweed posts ante 500
U-GOD posts ante 500
P4ngAll-In posts ante 500
P1xel7 posts ante 500
GrizarPro posts ante 500
SpearF posts small blind 2000
misterweed posts big blind 4000
Dealt to P1xel7 [9h 5s]
*** PRE-FLOP *** 
U-GOD folds
P4ngAll-In folds
P1xel7 folds
GrizarPro raises 4000 to 8000
SpearF folds
misterweed calls 4000
*** FLOP *** [2c 4d 2s]
misterweed bets 21000
GrizarPro folds
misterweed collected 42000 from pot
*** SUMMARY ***
Total pot 42000 | No rake
Board: [2c 4d 2s]
Seat 6: misterweed (big blind) won 42000


Winamax Poker - Tournament "MYSTERY KO" buyIn: 0.90€ + 0.10€ level: 18 - HandId: #3047856029015474200-178-1700085851 - Holdem no limit (500/2000/4000) - 2023/11/15 22:04:11 UTC
Table: 'MYSTERY KO(709634281)#0023' 6-max (real money) Seat #5 is the button
Seat 1: U-GOD (79442)
Seat 2: P4ngAll-In (20622)
Seat 3: P1xel7 (71783)
Seat 4: GrizarPro (83498)
Seat 5: SpearF (155889)
Seat 6: misterweed (313137)
*** ANTE/BLINDS ***
misterweed posts ante 500
U-GOD posts ante 500
P4ngAll-In posts ante 500
P1xel7 posts ante 500
GrizarPro posts ante 500
SpearF posts ante 500
misterweed posts small blind 2000
U-GOD posts big blind 4000
Dealt to P1xel7 [Jd 4c]
*** PRE-FLOP *** 
P4ngAll-In folds
P1xel7 folds
GrizarPro folds
SpearF raises 4000 to 8000
misterweed calls 6000
U-GOD folds
*** FLOP *** [9s Jh 7c]
misterweed bets 4000
SpearF calls 4000
*** TURN *** [9s Jh 7c][Js]
misterweed bets 10850
SpearF calls 10850
*** RIVER *** [9s Jh 7c Js][8s]
misterweed bets 4000
SpearF calls 4000
*** SHOW DOWN ***
misterweed shows [6d 8d] (Two pairs : Jacks and 8)
SpearF shows [Ac 9h] (Two pairs : Jacks and 9)
SpearF collected 60700 from pot
*** SUMMARY ***
Total pot 60700 | No rake
Board: [9s Jh 7c Js 8s]
Seat 5: SpearF (button) showed [Ac 9h] and won 60700 with Two pairs : Jacks and 9
Seat 6: misterweed (small blind) showed [6d 8d] and lost with Two pairs : Jacks and 8


Winamax Poker - Tournament "MYSTERY KO" buyIn: 0.90€ + 0.10€ level: 18 - HandId: #3047856029015474200-179-1700085899 - Holdem no limit (500/2000/4000) - 2023/11/15 22:04:59 UTC
Table: 'MYSTERY KO(709634281)#0023' 6-max (real money) Seat #6 is the button
Seat 1: U-GOD (74942)
Seat 2: P4ngAll-In (20122)
Seat 3: P1xel7 (71283)
Seat 4: GrizarPro (82998)
Seat 5: SpearF (189239)
Seat 6: misterweed (285787)
*** ANTE/BLINDS ***
U-GOD posts ante 500
P4ngAll-In posts ante 500
P1xel7 posts ante 500
GrizarPro posts ante 500
SpearF posts ante 500
misterweed posts ante 500
U-GOD posts small blind 2000
P4ngAll-In posts big blind 4000
Dealt to P1xel7 [Td 4s]
*** PRE-FLOP *** 
P1xel7 folds
GrizarPro folds
SpearF raises 4000 to 8000
misterweed folds
U-GOD folds
P4ngAll-In folds
SpearF collected 17000 from pot
*** SUMMARY ***
Total pot 17000 | No rake
Seat 5: SpearF won 17000


Winamax Poker - Tournament "MYSTERY KO" buyIn: 0.90€ + 0.10€ level: 18 - HandId: #3047856029015474200-180-1700085932 - Holdem no limit (500/2000/4000) - 2023/11/15 22:05:32 UTC
Table: 'MYSTERY KO(709634281)#0023' 6-max (real money) Seat #1 is the button
Seat 1: U-GOD (72442)
Seat 2: P4ngAll-In (15622)
Seat 3: P1xel7 (70783)
Seat 4: GrizarPro (82498)
Seat 5: SpearF (197739)
Seat 6: misterweed (285287)
*** ANTE/BLINDS ***
P4ngAll-In posts ante 500
P1xel7 posts ante 500
U-GOD posts ante 500
GrizarPro posts ante 500
SpearF posts ante 500
misterweed posts ante 500
P4ngAll-In posts small blind 2000
P1xel7 posts big blind 4000
Dealt to P1xel7 [Jc 3c]
*** PRE-FLOP *** 
GrizarPro folds
SpearF raises 4000 to 8000
misterweed calls 8000
U-GOD folds
P4ngAll-In raises 7122 to 15122 and is all-in
P1xel7 folds
SpearF raises 16878 to 32000
misterweed calls 24000
*** FLOP *** [6s 2s Qc]
SpearF bets 21531
misterweed raises 231256 to 252787 and is all-in
SpearF folds
*** TURN *** [6s 2s Qc][Ac]
*** RIVER *** [6s 2s Qc Ac][6h]
*** SHOW DOWN ***
P4ngAll-In shows [5c 5d] (Two pairs : 6 and 5)
misterweed shows [Qd Td] (Two pairs : Queens and 6)
misterweed collected 360440 from pot
*** SUMMARY ***
Total pot 360440 | No rake
Board: [6s 2s Qc Ac 6h]
Seat 2: P4ngAll-In (small blind) showed [5c 5d] and lost with Two pairs : 6 and 5
Seat 6: misterweed showed [Qd Td] and won 360440 with Two pairs : Queens and 6


Winamax Poker - Tournament "MYSTERY KO" buyIn: 0.90€ + 0.10€ level: 18 - HandId: #3047856029015474200-181-1700085974 - Holdem no limit (500/2000/4000) - 2023/11/15 22:06:14 UTC
Table: 'MYSTERY KO(709634281)#0023' 6-max (real money) Seat #2 is the button
Seat 1: U-GOD (71942)
Seat 3: P1xel7 (66283)
Seat 4: GrizarPro (81998)
Seat 5: SpearF (143708)
Seat 6: misterweed (360440)
*** ANTE/BLINDS ***
P1xel7 posts ante 500
GrizarPro posts ante 500
U-GOD posts ante 500
SpearF posts ante 500
misterweed posts ante 500
P1xel7 posts small blind 2000
GrizarPro posts big blind 4000
Dealt to P1xel7 [Tc 8h]
*** PRE-FLOP *** 
SpearF folds
misterweed folds
U-GOD folds
P1xel7 folds
GrizarPro collected 8500 from pot
*** SUMMARY ***
Total pot 8500 | No rake
Seat 4: GrizarPro (big blind) won 8500


Winamax Poker - Tournament "MYSTERY KO" buyIn: 0.90€ + 0.10€ level: 18 - HandId: #3047856029015474200-182-1700085989 - Holdem no limit (500/2000/4000) - 2023/11/15 22:06:29 UTC
Table: 'MYSTERY KO(709634281)#0023' 6-max (real money) Seat #3 is the button
Seat 1: U-GOD (71442)
Seat 3: P1xel7 (63783)
Seat 4: GrizarPro (85998)
Seat 5: SpearF (143208)
Seat 6: misterweed (359940)
*** ANTE/BLINDS ***
GrizarPro posts ante 500
SpearF posts ante 500
U-GOD posts ante 500
P1xel7 posts ante 500
misterweed posts ante 500
GrizarPro posts small blind 2000
SpearF posts big blind 4000
Dealt to P1xel7 [6s 4s]
*** PRE-FLOP *** 
misterweed calls 4000
U-GOD folds
P1xel7 folds
GrizarPro folds
SpearF checks
*** FLOP *** [5h Ad 8d]
SpearF checks
misterweed bets 12500
SpearF folds
misterweed collected 25000 from pot
*** SUMMARY ***
Total pot 25000 | No rake
Board: [5h Ad 8d]
Seat 6: misterweed won 25000


Winamax Poker - Tournament "MYSTERY KO" buyIn: 0.90€ + 0.10€ level: 18 - HandId: #3047856029015474200-183-1700086018 - Holdem no limit (500/2000/4000) - 2023/11/15 22:06:58 UTC
Table: 'MYSTERY KO(709634281)#0023' 6-max (real money) Seat #4 is the button
Seat 1: U-GOD (70942)
Seat 3: P1xel7 (63283)
Seat 4: GrizarPro (83498)
Seat 5: SpearF (138708)
Seat 6: misterweed (367940)
*** ANTE/BLINDS ***
SpearF posts ante 500
misterweed posts ante 500
U-GOD posts ante 500
P1xel7 posts ante 500
GrizarPro posts ante 500
SpearF posts small blind 2000
misterweed posts big blind 4000
Dealt to P1xel7 [As Qd]
*** PRE-FLOP *** 
U-GOD folds
P1xel7 raises 58783 to 62783 and is all-in
GrizarPro folds
SpearF raises 75425 to 138208 and is all-in
misterweed folds
*** FLOP *** [4s 3h Jd]
*** TURN *** [4s 3h Jd][7d]
*** RIVER *** [4s 3h Jd 7d][5s]
*** SHOW DOWN ***
P1xel7 shows [As Qd] (High card : Ace)
SpearF shows [Ah Ks] (High card : Ace)
SpearF collected 207491 from pot
*** SUMMARY ***
Total pot 207491 | No rake
Board: [4s 3h Jd 7d 5s]
Seat 3: P1xel7 showed [As Qd] and lost with High card : Ace
Seat 5: SpearF (small blind) showed [Ah Ks] and won 207491 with High card : Ace


