Winamax Poker - Tournament "SKENIGMA Payant A" buyIn: 1.80€ + 0.20€ level: 4 - HandId: #3069735365515411458-42-1701117099 - Holdem no limit (30/125/250) - 2023/11/27 20:31:39 UTC
Table: 'SKENIGMA Payant A(714728461)#01' 6-max (real money) Seat #6 is the button
Seat 1: GBG57018 (23041)
Seat 2: mataberrant (20686)
Seat 3: Enzooo56 (17252)
Seat 4: P1xel7 (20000)
Seat 6: Jibaro (19216)
*** ANTE/BLINDS ***
GBG57018 posts ante 30
mataberrant posts ante 30
Enzooo56 posts ante 30
P1xel7 posts ante 30
Jibaro posts ante 30
GBG57018 posts small blind 125
mataberrant posts big blind 250
Dealt to P1xel7 [Jd 3s]
*** PRE-FLOP *** 
Enzooo56 raises 375 to 625
P1xel7 folds
Jibaro folds
GBG57018 folds
mataberrant calls 375
*** FLOP *** [4d 2s 4c]
mataberrant checks
Enzooo56 bets 381
mataberrant calls 381
*** TURN *** [4d 2s 4c][5s]
mataberrant checks
Enzooo56 bets 800
mataberrant folds
Enzooo56 collected 3087 from pot
*** SUMMARY ***
Total pot 3087 | No rake
Board: [4d 2s 4c 5s]
Seat 3: Enzooo56 won 3087


Winamax Poker - Tournament "SKENIGMA Payant A" buyIn: 1.80€ + 0.20€ level: 5 - HandId: #3069735365515411458-43-1701117148 - Holdem no limit (40/150/300) - 2023/11/27 20:32:28 UTC
Table: 'SKENIGMA Payant A(714728461)#01' 6-max (real money) Seat #1 is the button
Seat 1: GBG57018 (22886)
Seat 2: mataberrant (19650)
Seat 3: Enzooo56 (18503)
Seat 4: P1xel7 (19970)
Seat 6: Jibaro (19186)
*** ANTE/BLINDS ***
mataberrant posts ante 40
Enzooo56 posts ante 40
GBG57018 posts ante 40
P1xel7 posts ante 40
Jibaro posts ante 40
mataberrant posts small blind 150
Enzooo56 posts big blind 300
Dealt to P1xel7 [Qs 7h]
*** PRE-FLOP *** 
P1xel7 folds
Jibaro folds
GBG57018 folds
mataberrant raises 300 to 600
Enzooo56 calls 300
*** FLOP *** [7s 2s 2h]
mataberrant checks
Enzooo56 bets 350
mataberrant folds
Enzooo56 collected 1750 from pot
*** SUMMARY ***
Total pot 1750 | No rake
Board: [7s 2s 2h]
Seat 3: Enzooo56 (big blind) won 1750


Winamax Poker - Tournament "SKENIGMA Payant A" buyIn: 1.80€ + 0.20€ level: 5 - HandId: #3069735365515411458-44-1701117192 - Holdem no limit (40/150/300) - 2023/11/27 20:33:12 UTC
Table: 'SKENIGMA Payant A(714728461)#01' 6-max (real money) Seat #2 is the button
Seat 1: GBG57018 (22846)
Seat 2: mataberrant (19010)
Seat 3: Enzooo56 (19263)
Seat 4: P1xel7 (19930)
Seat 6: Jibaro (19146)
*** ANTE/BLINDS ***
Enzooo56 posts ante 40
P1xel7 posts ante 40
GBG57018 posts ante 40
mataberrant posts ante 40
Jibaro posts ante 40
Enzooo56 posts small blind 150
P1xel7 posts big blind 300
Dealt to P1xel7 [4h Jd]
*** PRE-FLOP *** 
Jibaro folds
GBG57018 folds
mataberrant folds
Enzooo56 folds
P1xel7 collected 650 from pot
*** SUMMARY ***
Total pot 650 | No rake
Seat 4: P1xel7 (big blind) won 650


Winamax Poker - Tournament "SKENIGMA Payant A" buyIn: 1.80€ + 0.20€ level: 5 - HandId: #3069735365515411458-45-1701117199 - Holdem no limit (40/150/300) - 2023/11/27 20:33:19 UTC
Table: 'SKENIGMA Payant A(714728461)#01' 6-max (real money) Seat #3 is the button
Seat 1: GBG57018 (22806)
Seat 2: mataberrant (18970)
Seat 3: Enzooo56 (19073)
Seat 4: P1xel7 (20240)
Seat 6: Jibaro (19106)
*** ANTE/BLINDS ***
P1xel7 posts ante 40
Jibaro posts ante 40
GBG57018 posts ante 40
mataberrant posts ante 40
Enzooo56 posts ante 40
P1xel7 posts small blind 150
Jibaro posts big blind 300
Dealt to P1xel7 [Ks 7d]
*** PRE-FLOP *** 
GBG57018 folds
mataberrant folds
Enzooo56 raises 450 to 750
P1xel7 folds
Jibaro raises 1500 to 2250
Enzooo56 calls 1500
*** FLOP *** [8h 4d 5h]
Jibaro bets 1848
Enzooo56 raises 3349 to 5197
Jibaro folds
Enzooo56 collected 11895 from pot
*** SUMMARY ***
Total pot 11895 | No rake
Board: [8h 4d 5h]
Seat 3: Enzooo56 (button) won 11895


Winamax Poker - Tournament "SKENIGMA Payant A" buyIn: 1.80€ + 0.20€ level: 5 - HandId: #3069735365515411458-46-1701117275 - Holdem no limit (40/150/300) - 2023/11/27 20:34:35 UTC
Table: 'SKENIGMA Payant A(714728461)#01' 6-max (real money) Seat #4 is the button
Seat 1: GBG57018 (22766)
Seat 2: mataberrant (18930)
Seat 3: Enzooo56 (23481)
Seat 4: P1xel7 (20050)
Seat 6: Jibaro (14968)
*** ANTE/BLINDS ***
Jibaro posts ante 40
GBG57018 posts ante 40
mataberrant posts ante 40
Enzooo56 posts ante 40
P1xel7 posts ante 40
Jibaro posts small blind 150
GBG57018 posts big blind 300
Dealt to P1xel7 [Tc 6s]
*** PRE-FLOP *** 
mataberrant folds
Enzooo56 folds
P1xel7 folds
Jibaro folds
GBG57018 collected 650 from pot
*** SUMMARY ***
Total pot 650 | No rake
Seat 1: GBG57018 (big blind) won 650


Winamax Poker - Tournament "SKENIGMA Payant A" buyIn: 1.80€ + 0.20€ level: 5 - HandId: #3069735365515411458-47-1701117285 - Holdem no limit (40/150/300) - 2023/11/27 20:34:45 UTC
Table: 'SKENIGMA Payant A(714728461)#01' 6-max (real money) Seat #6 is the button
Seat 1: GBG57018 (23076)
Seat 2: mataberrant (18890)
Seat 3: Enzooo56 (23441)
Seat 4: P1xel7 (20010)
Seat 6: Jibaro (14778)
*** ANTE/BLINDS ***
GBG57018 posts ante 40
mataberrant posts ante 40
Enzooo56 posts ante 40
P1xel7 posts ante 40
Jibaro posts ante 40
GBG57018 posts small blind 150
mataberrant posts big blind 300
Dealt to P1xel7 [Qh 4d]
*** PRE-FLOP *** 
Enzooo56 folds
P1xel7 folds
Jibaro folds
GBG57018 raises 450 to 750
mataberrant folds
GBG57018 collected 1250 from pot
*** SUMMARY ***
Total pot 1250 | No rake
Seat 1: GBG57018 (small blind) won 1250


Winamax Poker - Tournament "SKENIGMA Payant A" buyIn: 1.80€ + 0.20€ level: 5 - HandId: #3069735365515411458-48-1701117304 - Holdem no limit (40/150/300) - 2023/11/27 20:35:04 UTC
Table: 'SKENIGMA Payant A(714728461)#01' 6-max (real money) Seat #1 is the button
Seat 1: GBG57018 (23536)
Seat 2: mataberrant (18550)
Seat 3: Enzooo56 (23401)
Seat 4: P1xel7 (19970)
Seat 6: Jibaro (14738)
*** ANTE/BLINDS ***
mataberrant posts ante 40
Enzooo56 posts ante 40
GBG57018 posts ante 40
P1xel7 posts ante 40
Jibaro posts ante 40
mataberrant posts small blind 150
Enzooo56 posts big blind 300
Dealt to P1xel7 [8c 9h]
*** PRE-FLOP *** 
P1xel7 folds
Jibaro folds
GBG57018 folds
mataberrant raises 300 to 600
Enzooo56 folds
mataberrant collected 1100 from pot
*** SUMMARY ***
Total pot 1100 | No rake
Seat 2: mataberrant (small blind) won 1100


Winamax Poker - Tournament "SKENIGMA Payant A" buyIn: 1.80€ + 0.20€ level: 5 - HandId: #3069735365515411458-49-1701117349 - Holdem no limit (40/150/300) - 2023/11/27 20:35:49 UTC
Table: 'SKENIGMA Payant A(714728461)#01' 6-max (real money) Seat #2 is the button
Seat 1: GBG57018 (23496)
Seat 2: mataberrant (19010)
Seat 3: Enzooo56 (23061)
Seat 4: P1xel7 (19930)
Seat 6: Jibaro (14698)
*** ANTE/BLINDS ***
Enzooo56 posts ante 40
P1xel7 posts ante 40
GBG57018 posts ante 40
mataberrant posts ante 40
Jibaro posts ante 40
Enzooo56 posts small blind 150
P1xel7 posts big blind 300
Dealt to P1xel7 [Kd 7s]
*** PRE-FLOP *** 
Jibaro folds
GBG57018 folds
mataberrant raises 300 to 600
Enzooo56 folds
P1xel7 calls 300
*** FLOP *** [Kc 7d 3d]
P1xel7 checks
mataberrant checks
*** TURN *** [Kc 7d 3d][5s]
P1xel7 bets 543
mataberrant folds
P1xel7 collected 2093 from pot
*** SUMMARY ***
Total pot 2093 | No rake
Board: [Kc 7d 3d 5s]
Seat 4: P1xel7 (big blind) won 2093


Winamax Poker - Tournament "SKENIGMA Payant A" buyIn: 1.80€ + 0.20€ level: 5 - HandId: #3069735365515411458-50-1701117395 - Holdem no limit (40/150/300) - 2023/11/27 20:36:35 UTC
Table: 'SKENIGMA Payant A(714728461)#01' 6-max (real money) Seat #3 is the button
Seat 1: GBG57018 (23456)
Seat 2: mataberrant (18370)
Seat 3: Enzooo56 (22871)
Seat 4: P1xel7 (20840)
Seat 6: Jibaro (14658)
*** ANTE/BLINDS ***
P1xel7 posts ante 40
Jibaro posts ante 40
GBG57018 posts ante 40
mataberrant posts ante 40
Enzooo56 posts ante 40
P1xel7 posts small blind 150
Jibaro posts big blind 300
Dealt to P1xel7 [8c 3h]
*** PRE-FLOP *** 
GBG57018 folds
mataberrant raises 450 to 750
Enzooo56 folds
P1xel7 folds
Jibaro calls 450
*** FLOP *** [Jh 7h Qd]
Jibaro checks
mataberrant checks
*** TURN *** [Jh 7h Qd][2d]
Jibaro checks
mataberrant bets 450
Jibaro calls 450
*** RIVER *** [Jh 7h Qd 2d][4s]
Jibaro checks
mataberrant bets 2750
Jibaro raises 3350 to 6100
mataberrant calls 3350
*** SHOW DOWN ***
Jibaro shows [4c 7c] (Two pairs : 7 and 4)
mataberrant shows [2c 2s] (Trips of 2)
mataberrant collected 14950 from pot
*** SUMMARY ***
Total pot 14950 | No rake
Board: [Jh 7h Qd 2d 4s]
Seat 2: mataberrant showed [2c 2s] and won 14950 with Trips of 2
Seat 6: Jibaro (big blind) showed [4c 7c] and lost with Two pairs : 7 and 4


Winamax Poker - Tournament "SKENIGMA Payant A" buyIn: 1.80€ + 0.20€ level: 5 - HandId: #3069735365515411458-51-1701117462 - Holdem no limit (40/150/300) - 2023/11/27 20:37:42 UTC
Table: 'SKENIGMA Payant A(714728461)#01' 6-max (real money) Seat #4 is the button
Seat 1: GBG57018 (23416)
Seat 2: mataberrant (25980)
Seat 3: Enzooo56 (22831)
Seat 4: P1xel7 (20650)
Seat 6: Jibaro (7318)
*** ANTE/BLINDS ***
Jibaro posts ante 40
GBG57018 posts ante 40
mataberrant posts ante 40
Enzooo56 posts ante 40
P1xel7 posts ante 40
Jibaro posts small blind 150
GBG57018 posts big blind 300
Dealt to P1xel7 [2s 4c]
*** PRE-FLOP *** 
mataberrant folds
Enzooo56 folds
P1xel7 folds
Jibaro raises 6978 to 7278 and is all-in
GBG57018 folds
Jibaro collected 7778 from pot
*** SUMMARY ***
Total pot 7778 | No rake
Seat 6: Jibaro (small blind) won 7778


Winamax Poker - Tournament "SKENIGMA Payant A" buyIn: 1.80€ + 0.20€ level: 5 - HandId: #3069735365515411458-52-1701117477 - Holdem no limit (40/150/300) - 2023/11/27 20:37:57 UTC
Table: 'SKENIGMA Payant A(714728461)#01' 6-max (real money) Seat #6 is the button
Seat 1: GBG57018 (23076)
Seat 2: mataberrant (25940)
Seat 3: Enzooo56 (22791)
Seat 4: P1xel7 (20610)
Seat 6: Jibaro (7778)
*** ANTE/BLINDS ***
GBG57018 posts ante 40
mataberrant posts ante 40
Enzooo56 posts ante 40
P1xel7 posts ante 40
Jibaro posts ante 40
GBG57018 posts small blind 150
mataberrant posts big blind 300
Dealt to P1xel7 [Qs Kd]
*** PRE-FLOP *** 
Enzooo56 folds
P1xel7 raises 450 to 750
Jibaro raises 6988 to 7738 and is all-in
GBG57018 folds
mataberrant folds
P1xel7 folds
Jibaro collected 9138 from pot
*** SUMMARY ***
Total pot 9138 | No rake
Seat 6: Jibaro (button) won 9138


Winamax Poker - Tournament "SKENIGMA Payant A" buyIn: 1.80€ + 0.20€ level: 5 - HandId: #3069735365515411458-53-1701117520 - Holdem no limit (40/150/300) - 2023/11/27 20:38:40 UTC
Table: 'SKENIGMA Payant A(714728461)#01' 6-max (real money) Seat #1 is the button
Seat 1: GBG57018 (22886)
Seat 2: mataberrant (25600)
Seat 3: Enzooo56 (22751)
Seat 4: P1xel7 (19820)
Seat 6: Jibaro (9138)
*** ANTE/BLINDS ***
mataberrant posts ante 40
Enzooo56 posts ante 40
GBG57018 posts ante 40
P1xel7 posts ante 40
Jibaro posts ante 40
mataberrant posts small blind 150
Enzooo56 posts big blind 300
Dealt to P1xel7 [Ts 9h]
*** PRE-FLOP *** 
P1xel7 folds
Jibaro folds
GBG57018 folds
mataberrant folds
Enzooo56 collected 650 from pot
*** SUMMARY ***
Total pot 650 | No rake
Seat 3: Enzooo56 (big blind) won 650


Winamax Poker - Tournament "SKENIGMA Payant A" buyIn: 1.80€ + 0.20€ level: 5 - HandId: #3069735365515411458-54-1701117551 - Holdem no limit (40/150/300) - 2023/11/27 20:39:11 UTC
Table: 'SKENIGMA Payant A(714728461)#01' 6-max (real money) Seat #2 is the button
Seat 1: GBG57018 (22846)
Seat 2: mataberrant (25410)
Seat 3: Enzooo56 (23061)
Seat 4: P1xel7 (19780)
Seat 6: Jibaro (9098)
*** ANTE/BLINDS ***
Enzooo56 posts ante 40
P1xel7 posts ante 40
GBG57018 posts ante 40
mataberrant posts ante 40
Jibaro posts ante 40
Enzooo56 posts small blind 150
P1xel7 posts big blind 300
Dealt to P1xel7 [5d Qd]
*** PRE-FLOP *** 
Jibaro folds
GBG57018 raises 450 to 750
mataberrant folds
Enzooo56 calls 600
P1xel7 folds
*** FLOP *** [As 3s 3d]
Enzooo56 checks
GBG57018 checks
*** TURN *** [As 3s 3d][3c]
Enzooo56 checks
GBG57018 bets 1000
Enzooo56 calls 1000
*** RIVER *** [As 3s 3d 3c][4c]
Enzooo56 checks
GBG57018 bets 3200
Enzooo56 folds
GBG57018 collected 7200 from pot
*** SUMMARY ***
Total pot 7200 | No rake
Board: [As 3s 3d 3c 4c]
Seat 1: GBG57018 won 7200


Winamax Poker - Tournament "SKENIGMA Payant A" buyIn: 1.80€ + 0.20€ level: 6 - HandId: #3069735365515411458-55-1701117609 - Holdem no limit (50/200/400) - 2023/11/27 20:40:09 UTC
Table: 'SKENIGMA Payant A(714728461)#01' 6-max (real money) Seat #3 is the button
Seat 1: GBG57018 (25056)
Seat 2: mataberrant (25370)
Seat 3: Enzooo56 (21271)
Seat 4: P1xel7 (19440)
Seat 6: Jibaro (9058)
*** ANTE/BLINDS ***
P1xel7 posts ante 50
Jibaro posts ante 50
GBG57018 posts ante 50
mataberrant posts ante 50
Enzooo56 posts ante 50
P1xel7 posts small blind 200
Jibaro posts big blind 400
Dealt to P1xel7 [6s 6h]
*** PRE-FLOP *** 
GBG57018 raises 600 to 1000
mataberrant folds
Enzooo56 folds
P1xel7 calls 800
Jibaro folds
*** FLOP *** [As 4s 2c]
P1xel7 checks
GBG57018 checks
*** TURN *** [As 4s 2c][8h]
P1xel7 bets 928
GBG57018 folds
P1xel7 collected 3578 from pot
*** SUMMARY ***
Total pot 3578 | No rake
Board: [As 4s 2c 8h]
Seat 4: P1xel7 (small blind) won 3578


Winamax Poker - Tournament "SKENIGMA Payant A" buyIn: 1.80€ + 0.20€ level: 6 - HandId: #3069735365515411458-56-1701117687 - Holdem no limit (50/200/400) - 2023/11/27 20:41:27 UTC
Table: 'SKENIGMA Payant A(714728461)#01' 6-max (real money) Seat #4 is the button
Seat 1: GBG57018 (24006)
Seat 2: mataberrant (25320)
Seat 3: Enzooo56 (21221)
Seat 4: P1xel7 (21040)
Seat 6: Jibaro (8608)
*** ANTE/BLINDS ***
Jibaro posts ante 50
GBG57018 posts ante 50
mataberrant posts ante 50
Enzooo56 posts ante 50
P1xel7 posts ante 50
Jibaro posts small blind 200
GBG57018 posts big blind 400
Dealt to P1xel7 [Kc 4d]
*** PRE-FLOP *** 
mataberrant raises 400 to 800
Enzooo56 folds
P1xel7 folds
Jibaro folds
GBG57018 folds
mataberrant collected 1650 from pot
*** SUMMARY ***
Total pot 1650 | No rake
Seat 2: mataberrant won 1650


Winamax Poker - Tournament "SKENIGMA Payant A" buyIn: 1.80€ + 0.20€ level: 6 - HandId: #3069735365515411458-57-1701117708 - Holdem no limit (50/200/400) - 2023/11/27 20:41:48 UTC
Table: 'SKENIGMA Payant A(714728461)#01' 6-max (real money) Seat #6 is the button
Seat 1: GBG57018 (23556)
Seat 2: mataberrant (26120)
Seat 3: Enzooo56 (21171)
Seat 4: P1xel7 (20990)
Seat 6: Jibaro (8358)
*** ANTE/BLINDS ***
GBG57018 posts ante 50
mataberrant posts ante 50
Enzooo56 posts ante 50
P1xel7 posts ante 50
Jibaro posts ante 50
GBG57018 posts small blind 200
mataberrant posts big blind 400
Dealt to P1xel7 [Td Ah]
*** PRE-FLOP *** 
Enzooo56 raises 500 to 900
P1xel7 calls 900
Jibaro folds
GBG57018 folds
mataberrant folds
*** FLOP *** [6c Qd 5s]
Enzooo56 checks
P1xel7 checks
*** TURN *** [6c Qd 5s][Kh]
Enzooo56 checks
P1xel7 bets 928
Enzooo56 folds
P1xel7 collected 3578 from pot
*** SUMMARY ***
Total pot 3578 | No rake
Board: [6c Qd 5s Kh]
Seat 4: P1xel7 won 3578


Winamax Poker - Tournament "SKENIGMA Payant A" buyIn: 1.80€ + 0.20€ level: 6 - HandId: #3069735365515411458-58-1701117751 - Holdem no limit (50/200/400) - 2023/11/27 20:42:31 UTC
Table: 'SKENIGMA Payant A(714728461)#01' 6-max (real money) Seat #1 is the button
Seat 1: GBG57018 (23306)
Seat 2: mataberrant (25670)
Seat 3: Enzooo56 (20221)
Seat 4: P1xel7 (22690)
Seat 6: Jibaro (8308)
*** ANTE/BLINDS ***
mataberrant posts ante 50
Enzooo56 posts ante 50
GBG57018 posts ante 50
P1xel7 posts ante 50
Jibaro posts ante 50
mataberrant posts small blind 200
Enzooo56 posts big blind 400
Dealt to P1xel7 [Jh 5s]
*** PRE-FLOP *** 
P1xel7 folds
Jibaro folds
GBG57018 raises 600 to 1000
mataberrant calls 800
Enzooo56 folds
*** FLOP *** [3c 7s As]
mataberrant checks
GBG57018 checks
*** TURN *** [3c 7s As][3s]
mataberrant bets 1128
GBG57018 folds
mataberrant collected 3778 from pot
*** SUMMARY ***
Total pot 3778 | No rake
Board: [3c 7s As 3s]
Seat 2: mataberrant (small blind) won 3778


Winamax Poker - Tournament "SKENIGMA Payant A" buyIn: 1.80€ + 0.20€ level: 6 - HandId: #3069735365515411458-59-1701117801 - Holdem no limit (50/200/400) - 2023/11/27 20:43:21 UTC
Table: 'SKENIGMA Payant A(714728461)#01' 6-max (real money) Seat #2 is the button
Seat 1: GBG57018 (22256)
Seat 2: mataberrant (27270)
Seat 3: Enzooo56 (19771)
Seat 4: P1xel7 (22640)
Seat 6: Jibaro (8258)
*** ANTE/BLINDS ***
Enzooo56 posts ante 50
P1xel7 posts ante 50
GBG57018 posts ante 50
mataberrant posts ante 50
Jibaro posts ante 50
Enzooo56 posts small blind 200
P1xel7 posts big blind 400
Dealt to P1xel7 [7c 4d]
*** PRE-FLOP *** 
Jibaro raises 400 to 800
GBG57018 folds
mataberrant folds
Enzooo56 folds
P1xel7 folds
Jibaro collected 1650 from pot
*** SUMMARY ***
Total pot 1650 | No rake
Seat 6: Jibaro won 1650


Winamax Poker - Tournament "SKENIGMA Payant A" buyIn: 1.80€ + 0.20€ level: 6 - HandId: #3069735365515411458-60-1701117826 - Holdem no limit (50/200/400) - 2023/11/27 20:43:46 UTC
Table: 'SKENIGMA Payant A(714728461)#01' 6-max (real money) Seat #3 is the button
Seat 1: GBG57018 (22206)
Seat 2: mataberrant (27220)
Seat 3: Enzooo56 (19521)
Seat 4: P1xel7 (22190)
Seat 6: Jibaro (9058)
*** ANTE/BLINDS ***
P1xel7 posts ante 50
Jibaro posts ante 50
GBG57018 posts ante 50
mataberrant posts ante 50
Enzooo56 posts ante 50
P1xel7 posts small blind 200
Jibaro posts big blind 400
Dealt to P1xel7 [5s Ah]
*** PRE-FLOP *** 
GBG57018 folds
mataberrant raises 400 to 800
Enzooo56 folds
P1xel7 folds
Jibaro calls 400
*** FLOP *** [Ad 8h 4d]
Jibaro checks
mataberrant checks
*** TURN *** [Ad 8h 4d][3s]
Jibaro checks
mataberrant bets 713
Jibaro folds
mataberrant collected 2763 from pot
*** SUMMARY ***
Total pot 2763 | No rake
Board: [Ad 8h 4d 3s]
Seat 2: mataberrant won 2763


Winamax Poker - Tournament "SKENIGMA Payant A" buyIn: 1.80€ + 0.20€ level: 6 - HandId: #3069735365515411458-61-1701117867 - Holdem no limit (50/200/400) - 2023/11/27 20:44:27 UTC
Table: 'SKENIGMA Payant A(714728461)#01' 6-max (real money) Seat #4 is the button
Seat 1: GBG57018 (22156)
Seat 2: mataberrant (28420)
Seat 3: Enzooo56 (19471)
Seat 4: P1xel7 (21940)
Seat 6: Jibaro (8208)
*** ANTE/BLINDS ***
Jibaro posts ante 50
GBG57018 posts ante 50
mataberrant posts ante 50
Enzooo56 posts ante 50
P1xel7 posts ante 50
Jibaro posts small blind 200
GBG57018 posts big blind 400
Dealt to P1xel7 [4s 3c]
*** PRE-FLOP *** 
mataberrant folds
Enzooo56 folds
P1xel7 folds
Jibaro raises 7758 to 8158 and is all-in
GBG57018 folds
Jibaro collected 8808 from pot
*** SUMMARY ***
Total pot 8808 | No rake
Seat 6: Jibaro (small blind) won 8808


Winamax Poker - Tournament "SKENIGMA Payant A" buyIn: 1.80€ + 0.20€ level: 6 - HandId: #3069735365515411458-62-1701117898 - Holdem no limit (50/200/400) - 2023/11/27 20:44:58 UTC
Table: 'SKENIGMA Payant A(714728461)#01' 6-max (real money) Seat #6 is the button
Seat 1: GBG57018 (21706)
Seat 2: mataberrant (28370)
Seat 3: Enzooo56 (19421)
Seat 4: P1xel7 (21890)
Seat 6: Jibaro (8808)
*** ANTE/BLINDS ***
GBG57018 posts ante 50
mataberrant posts ante 50
Enzooo56 posts ante 50
P1xel7 posts ante 50
Jibaro posts ante 50
GBG57018 posts small blind 200
mataberrant posts big blind 400
Dealt to P1xel7 [5c 6d]
*** PRE-FLOP *** 
Enzooo56 folds
P1xel7 folds
Jibaro folds
GBG57018 raises 600 to 1000
mataberrant folds
GBG57018 collected 1650 from pot
*** SUMMARY ***
Total pot 1650 | No rake
Seat 1: GBG57018 (small blind) won 1650


Winamax Poker - Tournament "SKENIGMA Payant A" buyIn: 1.80€ + 0.20€ level: 6 - HandId: #3069735365515411458-63-1701117919 - Holdem no limit (50/200/400) - 2023/11/27 20:45:19 UTC
Table: 'SKENIGMA Payant A(714728461)#01' 6-max (real money) Seat #1 is the button
Seat 1: GBG57018 (22306)
Seat 2: mataberrant (27920)
Seat 3: Enzooo56 (19371)
Seat 4: P1xel7 (21840)
Seat 6: Jibaro (8758)
*** ANTE/BLINDS ***
mataberrant posts ante 50
Enzooo56 posts ante 50
GBG57018 posts ante 50
P1xel7 posts ante 50
Jibaro posts ante 50
mataberrant posts small blind 200
Enzooo56 posts big blind 400
Dealt to P1xel7 [Ks Qc]
*** PRE-FLOP *** 
P1xel7 raises 600 to 1000
Jibaro folds
GBG57018 folds
mataberrant folds
Enzooo56 raises 1500 to 2500
P1xel7 calls 1500
*** FLOP *** [Th 5s Ah]
Enzooo56 checks
P1xel7 bets 1908
Enzooo56 calls 1908
*** TURN *** [Th 5s Ah][Jc]
Enzooo56 checks
P1xel7 checks
*** RIVER *** [Th 5s Ah Jc][9c]
Enzooo56 bets 3243
P1xel7 raises 6255 to 9498
Enzooo56 folds
P1xel7 collected 22007 from pot
*** SUMMARY ***
Total pot 22007 | No rake
Board: [Th 5s Ah Jc 9c]
Seat 4: P1xel7 won 22007


Winamax Poker - Tournament "SKENIGMA Payant A" buyIn: 1.80€ + 0.20€ level: 6 - HandId: #3069735365515411458-64-1701118049 - Holdem no limit (50/200/400) - 2023/11/27 20:47:29 UTC
Table: 'SKENIGMA Payant A(714728461)#01' 6-max (real money) Seat #2 is the button
Seat 1: GBG57018 (22256)
Seat 2: mataberrant (27670)
Seat 3: Enzooo56 (11670)
Seat 4: P1xel7 (29891)
Seat 6: Jibaro (8708)
*** ANTE/BLINDS ***
Enzooo56 posts ante 50
P1xel7 posts ante 50
GBG57018 posts ante 50
mataberrant posts ante 50
Jibaro posts ante 50
Enzooo56 posts small blind 200
P1xel7 posts big blind 400
Dealt to P1xel7 [2d As]
*** PRE-FLOP *** 
Jibaro folds
GBG57018 folds
mataberrant folds
Enzooo56 folds
P1xel7 collected 850 from pot
*** SUMMARY ***
Total pot 850 | No rake
Seat 4: P1xel7 (big blind) won 850


Winamax Poker - Tournament "SKENIGMA Payant A" buyIn: 1.80€ + 0.20€ level: 6 - HandId: #3069735365515411458-65-1701118062 - Holdem no limit (50/200/400) - 2023/11/27 20:47:42 UTC
Table: 'SKENIGMA Payant A(714728461)#01' 6-max (real money) Seat #3 is the button
Seat 1: GBG57018 (22206)
Seat 2: mataberrant (27620)
Seat 3: Enzooo56 (11420)
Seat 4: P1xel7 (30291)
Seat 6: Jibaro (8658)
*** ANTE/BLINDS ***
P1xel7 posts ante 50
Jibaro posts ante 50
GBG57018 posts ante 50
mataberrant posts ante 50
Enzooo56 posts ante 50
P1xel7 posts small blind 200
Jibaro posts big blind 400
Dealt to P1xel7 [Ad Ah]
*** PRE-FLOP *** 
GBG57018 folds
mataberrant raises 400 to 800
Enzooo56 calls 800
P1xel7 raises 2200 to 3000
Jibaro folds
mataberrant folds
Enzooo56 folds
P1xel7 collected 5250 from pot
*** SUMMARY ***
Total pot 5250 | No rake
Seat 4: P1xel7 (small blind) won 5250


Winamax Poker - Tournament "SKENIGMA Payant A" buyIn: 1.80€ + 0.20€ level: 7 - HandId: #3069735365515411458-66-1701118108 - Holdem no limit (60/250/500) - 2023/11/27 20:48:28 UTC
Table: 'SKENIGMA Payant A(714728461)#01' 6-max (real money) Seat #4 is the button
Seat 1: GBG57018 (22156)
Seat 2: mataberrant (26770)
Seat 3: Enzooo56 (10570)
Seat 4: P1xel7 (32491)
Seat 6: Jibaro (8208)
*** ANTE/BLINDS ***
Jibaro posts ante 60
GBG57018 posts ante 60
mataberrant posts ante 60
Enzooo56 posts ante 60
P1xel7 posts ante 60
Jibaro posts small blind 250
GBG57018 posts big blind 500
Dealt to P1xel7 [Qd Kh]
*** PRE-FLOP *** 
mataberrant raises 500 to 1000
Enzooo56 folds
P1xel7 calls 1000
Jibaro folds
GBG57018 folds
*** FLOP *** [4s 8h Ah]
mataberrant bets 763
P1xel7 folds
mataberrant collected 3813 from pot
*** SUMMARY ***
Total pot 3813 | No rake
Board: [4s 8h Ah]
Seat 2: mataberrant won 3813


Winamax Poker - Tournament "SKENIGMA Payant A" buyIn: 1.80€ + 0.20€ level: 7 - HandId: #3069735365515411458-67-1701118139 - Holdem no limit (60/250/500) - 2023/11/27 20:48:59 UTC
Table: 'SKENIGMA Payant A(714728461)#01' 6-max (real money) Seat #6 is the button
Seat 1: GBG57018 (21596)
Seat 2: mataberrant (28760)
Seat 3: Enzooo56 (10510)
Seat 4: P1xel7 (31431)
Seat 6: Jibaro (7898)
*** ANTE/BLINDS ***
GBG57018 posts ante 60
mataberrant posts ante 60
Enzooo56 posts ante 60
P1xel7 posts ante 60
Jibaro posts ante 60
GBG57018 posts small blind 250
mataberrant posts big blind 500
Dealt to P1xel7 [Qd Ad]
*** PRE-FLOP *** 
Enzooo56 folds
P1xel7 raises 1000 to 1500
Jibaro raises 6338 to 7838 and is all-in
GBG57018 folds
mataberrant folds
P1xel7 calls 6338
*** FLOP *** [9d Ac Ts]
*** TURN *** [9d Ac Ts][8s]
*** RIVER *** [9d Ac Ts 8s][Kc]
*** SHOW DOWN ***
Jibaro shows [Jc As] (One pair : Aces)
P1xel7 shows [Qd Ad] (One pair : Aces)
P1xel7 collected 16726 from pot
*** SUMMARY ***
Total pot 16726 | No rake
Board: [9d Ac Ts 8s Kc]
Seat 4: P1xel7 showed [Qd Ad] and won 16726 with One pair : Aces
Seat 6: Jibaro (button) showed [Jc As] and lost with One pair : Aces


Winamax Poker - Tournament "SKENIGMA Payant A" buyIn: 1.80€ + 0.20€ level: 7 - HandId: #3069735365515411458-68-1701118168 - Holdem no limit (60/250/500) - 2023/11/27 20:49:28 UTC
Table: 'SKENIGMA Payant A(714728461)#01' 6-max (real money) Seat #1 is the button
Seat 1: GBG57018 (21286)
Seat 2: mataberrant (28200)
Seat 3: Enzooo56 (10450)
Seat 4: P1xel7 (40259)
*** ANTE/BLINDS ***
mataberrant posts ante 60
Enzooo56 posts ante 60
GBG57018 posts ante 60
P1xel7 posts ante 60
mataberrant posts small blind 250
Enzooo56 posts big blind 500
Dealt to P1xel7 [4d 6s]
*** PRE-FLOP *** 
P1xel7 folds
GBG57018 folds
mataberrant folds
Enzooo56 collected 990 from pot
*** SUMMARY ***
Total pot 990 | No rake
Seat 3: Enzooo56 (big blind) won 990


Winamax Poker - Tournament "SKENIGMA Payant A" buyIn: 1.80€ + 0.20€ level: 7 - HandId: #3069735365515411458-69-1701118179 - Holdem no limit (60/250/500) - 2023/11/27 20:49:39 UTC
Table: 'SKENIGMA Payant A(714728461)#01' 6-max (real money) Seat #2 is the button
Seat 1: GBG57018 (21226)
Seat 2: mataberrant (27890)
Seat 3: Enzooo56 (10880)
Seat 4: P1xel7 (40199)
*** ANTE/BLINDS ***
Enzooo56 posts ante 60
P1xel7 posts ante 60
GBG57018 posts ante 60
mataberrant posts ante 60
Enzooo56 posts small blind 250
P1xel7 posts big blind 500
Dealt to P1xel7 [7d 2h]
*** PRE-FLOP *** 
GBG57018 folds
mataberrant folds
Enzooo56 folds
P1xel7 collected 990 from pot
*** SUMMARY ***
Total pot 990 | No rake
Seat 4: P1xel7 (big blind) won 990


Winamax Poker - Tournament "SKENIGMA Payant A" buyIn: 1.80€ + 0.20€ level: 7 - HandId: #3069735365515411458-70-1701118203 - Holdem no limit (60/250/500) - 2023/11/27 20:50:03 UTC
Table: 'SKENIGMA Payant A(714728461)#01' 6-max (real money) Seat #3 is the button
Seat 1: GBG57018 (21166)
Seat 2: mataberrant (27830)
Seat 3: Enzooo56 (10570)
Seat 4: P1xel7 (40629)
*** ANTE/BLINDS ***
P1xel7 posts ante 60
GBG57018 posts ante 60
mataberrant posts ante 60
Enzooo56 posts ante 60
P1xel7 posts small blind 250
GBG57018 posts big blind 500
Dealt to P1xel7 [9c 3h]
*** PRE-FLOP *** 
mataberrant folds
Enzooo56 raises 500 to 1000
P1xel7 folds
GBG57018 calls 500
*** FLOP *** [Ah Ad 4s]
GBG57018 checks
Enzooo56 bets 872
GBG57018 folds
Enzooo56 collected 3362 from pot
*** SUMMARY ***
Total pot 3362 | No rake
Board: [Ah Ad 4s]
Seat 3: Enzooo56 (button) won 3362


Winamax Poker - Tournament "SKENIGMA Payant A" buyIn: 1.80€ + 0.20€ level: 7 - HandId: #3069735365515411458-71-1701118250 - Holdem no limit (60/250/500) - 2023/11/27 20:50:50 UTC
Table: 'SKENIGMA Payant A(714728461)#01' 6-max (real money) Seat #4 is the button
Seat 1: GBG57018 (20106)
Seat 2: mataberrant (27770)
Seat 3: Enzooo56 (12000)
Seat 4: P1xel7 (40319)
*** ANTE/BLINDS ***
GBG57018 posts ante 60
mataberrant posts ante 60
Enzooo56 posts ante 60
P1xel7 posts ante 60
GBG57018 posts small blind 250
mataberrant posts big blind 500
Dealt to P1xel7 [2h 3s]
*** PRE-FLOP *** 
Enzooo56 folds
P1xel7 folds
GBG57018 raises 750 to 1250
mataberrant folds
GBG57018 collected 1990 from pot
*** SUMMARY ***
Total pot 1990 | No rake
Seat 1: GBG57018 (small blind) won 1990


Winamax Poker - Tournament "SKENIGMA Payant A" buyIn: 1.80€ + 0.20€ level: 7 - HandId: #3069735365515411458-72-1701118287 - Holdem no limit (60/250/500) - 2023/11/27 20:51:27 UTC
Table: 'SKENIGMA Payant A(714728461)#01' 6-max (real money) Seat #1 is the button
Seat 1: GBG57018 (20786)
Seat 2: mataberrant (27210)
Seat 3: Enzooo56 (11940)
Seat 4: P1xel7 (40259)
*** ANTE/BLINDS ***
mataberrant posts ante 60
Enzooo56 posts ante 60
GBG57018 posts ante 60
P1xel7 posts ante 60
mataberrant posts small blind 250
Enzooo56 posts big blind 500
Dealt to P1xel7 [4c Th]
*** PRE-FLOP *** 
P1xel7 folds
GBG57018 folds
mataberrant folds
Enzooo56 collected 990 from pot
*** SUMMARY ***
Total pot 990 | No rake
Seat 3: Enzooo56 (big blind) won 990


Winamax Poker - Tournament "SKENIGMA Payant A" buyIn: 1.80€ + 0.20€ level: 7 - HandId: #3069735365515411458-73-1701118302 - Holdem no limit (60/250/500) - 2023/11/27 20:51:42 UTC
Table: 'SKENIGMA Payant A(714728461)#01' 6-max (real money) Seat #2 is the button
Seat 1: GBG57018 (20726)
Seat 2: mataberrant (26900)
Seat 3: Enzooo56 (12370)
Seat 4: P1xel7 (40199)
*** ANTE/BLINDS ***
Enzooo56 posts ante 60
P1xel7 posts ante 60
GBG57018 posts ante 60
mataberrant posts ante 60
Enzooo56 posts small blind 250
P1xel7 posts big blind 500
Dealt to P1xel7 [Qh 3c]
*** PRE-FLOP *** 
GBG57018 folds
mataberrant raises 500 to 1000
Enzooo56 folds
P1xel7 folds
mataberrant collected 1990 from pot
*** SUMMARY ***
Total pot 1990 | No rake
Seat 2: mataberrant (button) won 1990


Winamax Poker - Tournament "SKENIGMA Payant A" buyIn: 1.80€ + 0.20€ level: 7 - HandId: #3069735365515411458-74-1701118332 - Holdem no limit (60/250/500) - 2023/11/27 20:52:12 UTC
Table: 'SKENIGMA Payant A(714728461)#01' 6-max (real money) Seat #3 is the button
Seat 1: GBG57018 (20666)
Seat 2: mataberrant (27830)
Seat 3: Enzooo56 (12060)
Seat 4: P1xel7 (39639)
*** ANTE/BLINDS ***
P1xel7 posts ante 60
GBG57018 posts ante 60
mataberrant posts ante 60
Enzooo56 posts ante 60
P1xel7 posts small blind 250
GBG57018 posts big blind 500
Dealt to P1xel7 [8h Ks]
*** PRE-FLOP *** 
mataberrant raises 750 to 1250
Enzooo56 folds
P1xel7 folds
GBG57018 calls 750
*** FLOP *** [Jh 7h 8c]
GBG57018 checks
mataberrant bets 1047
GBG57018 folds
mataberrant collected 4037 from pot
*** SUMMARY ***
Total pot 4037 | No rake
Board: [Jh 7h 8c]
Seat 2: mataberrant won 4037


Winamax Poker - Tournament "SKENIGMA Payant A" buyIn: 1.80€ + 0.20€ level: 7 - HandId: #3069735365515411458-75-1701118383 - Holdem no limit (60/250/500) - 2023/11/27 20:53:03 UTC
Table: 'SKENIGMA Payant A(714728461)#01' 6-max (real money) Seat #4 is the button
Seat 1: GBG57018 (19356)
Seat 2: mataberrant (29510)
Seat 3: Enzooo56 (12000)
Seat 4: P1xel7 (39329)
*** ANTE/BLINDS ***
GBG57018 posts ante 60
mataberrant posts ante 60
Enzooo56 posts ante 60
P1xel7 posts ante 60
GBG57018 posts small blind 250
mataberrant posts big blind 500
Dealt to P1xel7 [Kd 4c]
*** PRE-FLOP *** 
Enzooo56 folds
P1xel7 raises 600 to 1100
GBG57018 folds
mataberrant calls 600
*** FLOP *** [8d 7c Td]
mataberrant checks
P1xel7 bets 942
mataberrant folds
P1xel7 collected 3632 from pot
*** SUMMARY ***
Total pot 3632 | No rake
Board: [8d 7c Td]
Seat 4: P1xel7 (button) won 3632


Winamax Poker - Tournament "SKENIGMA Payant A" buyIn: 1.80€ + 0.20€ level: 7 - HandId: #3069735365515411458-76-1701118408 - Holdem no limit (60/250/500) - 2023/11/27 20:53:28 UTC
Table: 'SKENIGMA Payant A(714728461)#01' 6-max (real money) Seat #1 is the button
Seat 1: GBG57018 (19046)
Seat 2: mataberrant (28350)
Seat 3: Enzooo56 (11940)
Seat 4: P1xel7 (40859)
*** ANTE/BLINDS ***
mataberrant posts ante 60
Enzooo56 posts ante 60
GBG57018 posts ante 60
P1xel7 posts ante 60
mataberrant posts small blind 250
Enzooo56 posts big blind 500
Dealt to P1xel7 [Ad 2h]
*** PRE-FLOP *** 
P1xel7 folds
GBG57018 folds
mataberrant calls 250
Enzooo56 checks
*** FLOP *** [6d Ts Jd]
mataberrant checks
Enzooo56 bets 500
mataberrant calls 500
*** TURN *** [6d Ts Jd][4d]
mataberrant checks
Enzooo56 bets 784
mataberrant calls 784
*** RIVER *** [6d Ts Jd 4d][6s]
mataberrant checks
Enzooo56 bets 1333
mataberrant calls 1333
*** SHOW DOWN ***
Enzooo56 shows [Tc 7d] (Two pairs : Tens and 6)
mataberrant shows [9c Js] (Two pairs : Jacks and 6)
mataberrant collected 6474 from pot
*** SUMMARY ***
Total pot 6474 | No rake
Board: [6d Ts Jd 4d 6s]
Seat 2: mataberrant (small blind) showed [9c Js] and won 6474 with Two pairs : Jacks and 6
Seat 3: Enzooo56 (big blind) showed [Tc 7d] and lost with Two pairs : Tens and 6


Winamax Poker - Tournament "SKENIGMA Payant A" buyIn: 1.80€ + 0.20€ level: 7 - HandId: #3069735365515411458-77-1701118485 - Holdem no limit (60/250/500) - 2023/11/27 20:54:45 UTC
Table: 'SKENIGMA Payant A(714728461)#01' 6-max (real money) Seat #2 is the button
Seat 1: GBG57018 (18986)
Seat 2: mataberrant (31647)
Seat 3: Enzooo56 (8763)
Seat 4: P1xel7 (40799)
*** ANTE/BLINDS ***
Enzooo56 posts ante 60
P1xel7 posts ante 60
GBG57018 posts ante 60
mataberrant posts ante 60
Enzooo56 posts small blind 250
P1xel7 posts big blind 500
Dealt to P1xel7 [9c 7h]
*** PRE-FLOP *** 
GBG57018 folds
mataberrant folds
Enzooo56 raises 8203 to 8703 and is all-in
P1xel7 folds
Enzooo56 collected 9443 from pot
*** SUMMARY ***
Total pot 9443 | No rake
Seat 3: Enzooo56 (small blind) won 9443


Winamax Poker - Tournament "SKENIGMA Payant A" buyIn: 1.80€ + 0.20€ level: 7 - HandId: #3069735365515411458-78-1701118861 - Holdem no limit (60/250/500) - 2023/11/27 21:01:01 UTC
Table: 'SKENIGMA Payant A(714728461)#01' 6-max (real money) Seat #3 is the button
Seat 1: GBG57018 (18926)
Seat 2: mataberrant (31587)
Seat 3: Enzooo56 (9443)
Seat 4: P1xel7 (40239)
*** ANTE/BLINDS ***
P1xel7 posts ante 60
GBG57018 posts ante 60
mataberrant posts ante 60
Enzooo56 posts ante 60
P1xel7 posts small blind 250
GBG57018 posts big blind 500
Dealt to P1xel7 [Qc 3d]
*** PRE-FLOP *** 
mataberrant folds
Enzooo56 folds
P1xel7 folds
GBG57018 collected 990 from pot
*** SUMMARY ***
Total pot 990 | No rake
Seat 1: GBG57018 (big blind) won 990


Winamax Poker - Tournament "SKENIGMA Payant A" buyIn: 1.80€ + 0.20€ level: 8 - HandId: #3069735365515411458-79-1701118938 - Holdem no limit (80/300/600) - 2023/11/27 21:02:18 UTC
Table: 'SKENIGMA Payant A(714728461)#01' 6-max (real money) Seat #4 is the button
Seat 1: GBG57018 (19356)
Seat 2: mataberrant (31527)
Seat 3: Enzooo56 (9383)
Seat 4: P1xel7 (39929)
*** ANTE/BLINDS ***
GBG57018 posts ante 80
mataberrant posts ante 80
Enzooo56 posts ante 80
P1xel7 posts ante 80
GBG57018 posts small blind 300
mataberrant posts big blind 600
Dealt to P1xel7 [9c Tc]
*** PRE-FLOP *** 
Enzooo56 folds
P1xel7 raises 1200 to 1800
GBG57018 folds
mataberrant folds
P1xel7 collected 3020 from pot
*** SUMMARY ***
Total pot 3020 | No rake
Seat 4: P1xel7 (button) won 3020


Winamax Poker - Tournament "SKENIGMA Payant A" buyIn: 1.80€ + 0.20€ level: 8 - HandId: #3069735365515411458-80-1701118981 - Holdem no limit (80/300/600) - 2023/11/27 21:03:01 UTC
Table: 'SKENIGMA Payant A(714728461)#01' 6-max (real money) Seat #1 is the button
Seat 1: GBG57018 (18976)
Seat 2: mataberrant (30847)
Seat 3: Enzooo56 (9303)
Seat 4: P1xel7 (41069)
*** ANTE/BLINDS ***
mataberrant posts ante 80
Enzooo56 posts ante 80
GBG57018 posts ante 80
P1xel7 posts ante 80
mataberrant posts small blind 300
Enzooo56 posts big blind 600
Dealt to P1xel7 [Jc 7s]
*** PRE-FLOP *** 
P1xel7 folds
GBG57018 folds
mataberrant raises 600 to 1200
Enzooo56 folds
mataberrant collected 2120 from pot
*** SUMMARY ***
Total pot 2120 | No rake
Seat 2: mataberrant (small blind) won 2120


Winamax Poker - Tournament "SKENIGMA Payant A" buyIn: 1.80€ + 0.20€ level: 8 - HandId: #3069735365515411458-81-1701119007 - Holdem no limit (80/300/600) - 2023/11/27 21:03:27 UTC
Table: 'SKENIGMA Payant A(714728461)#01' 6-max (real money) Seat #2 is the button
Seat 1: GBG57018 (18896)
Seat 2: mataberrant (31687)
Seat 3: Enzooo56 (8623)
Seat 4: P1xel7 (40989)
*** ANTE/BLINDS ***
Enzooo56 posts ante 80
P1xel7 posts ante 80
GBG57018 posts ante 80
mataberrant posts ante 80
Enzooo56 posts small blind 300
P1xel7 posts big blind 600
Dealt to P1xel7 [Ac 8d]
*** PRE-FLOP *** 
GBG57018 folds
mataberrant calls 600
Enzooo56 folds
P1xel7 checks
*** FLOP *** [Kd Js 9c]
P1xel7 checks
mataberrant bets 1237
P1xel7 folds
mataberrant collected 3057 from pot
*** SUMMARY ***
Total pot 3057 | No rake
Board: [Kd Js 9c]
Seat 2: mataberrant (button) won 3057


Winamax Poker - Tournament "SKENIGMA Payant A" buyIn: 1.80€ + 0.20€ level: 8 - HandId: #3069735365515411458-82-1701119059 - Holdem no limit (80/300/600) - 2023/11/27 21:04:19 UTC
Table: 'SKENIGMA Payant A(714728461)#01' 6-max (real money) Seat #3 is the button
Seat 1: GBG57018 (18816)
Seat 2: mataberrant (32827)
Seat 3: Enzooo56 (8243)
Seat 4: P1xel7 (40309)
*** ANTE/BLINDS ***
P1xel7 posts ante 80
GBG57018 posts ante 80
mataberrant posts ante 80
Enzooo56 posts ante 80
P1xel7 posts small blind 300
GBG57018 posts big blind 600
Dealt to P1xel7 [4h Kc]
*** PRE-FLOP *** 
mataberrant folds
Enzooo56 raises 7563 to 8163 and is all-in
P1xel7 folds
GBG57018 calls 7563
*** FLOP *** [Ac 9c Qh]
*** TURN *** [Ac 9c Qh][3h]
*** RIVER *** [Ac 9c Qh 3h][9d]
*** SHOW DOWN ***
Enzooo56 shows [7s 7d] (Two pairs : 9 and 7)
GBG57018 shows [6s Ad] (Two pairs : Aces and 9)
GBG57018 collected 16946 from pot
*** SUMMARY ***
Total pot 16946 | No rake
Board: [Ac 9c Qh 3h 9d]
Seat 1: GBG57018 (big blind) showed [6s Ad] and won 16946 with Two pairs : Aces and 9
Seat 3: Enzooo56 (button) showed [7s 7d] and lost with Two pairs : 9 and 7


Winamax Poker - Tournament "SKENIGMA Payant A" buyIn: 1.80€ + 0.20€ level: -695534927 - HandId: #3069735365515411459-1-1701119157 - Holdem no limit (80/300/600) - 2023/11/27 21:05:57 UTC
Table: 'SKENIGMA Payant A(714728461)#02' 7-max (real money) Seat #3 is the button
Seat 1: Romanovitch1 (16869)
Seat 2: Tullochboy42 (13434)
Seat 3: P1xel7 (39929)
Seat 4: GBG57018 (27519)
Seat 5: mataberrant (32747)
Seat 6: archylamoula (35189)
Seat 7: Etisan (34313)
*** ANTE/BLINDS ***
GBG57018 posts ante 80
mataberrant posts ante 80
Romanovitch1 posts ante 80
Tullochboy42 posts ante 80
P1xel7 posts ante 80
archylamoula posts ante 80
Etisan posts ante 80
GBG57018 posts small blind 300
mataberrant posts big blind 600
Dealt to P1xel7 [8h Kc]
*** PRE-FLOP *** 
archylamoula calls 600
Etisan folds
Romanovitch1 folds
Tullochboy42 folds
P1xel7 folds
GBG57018 folds
mataberrant checks
*** FLOP *** [5s As Jh]
mataberrant bets 721
archylamoula calls 721
*** TURN *** [5s As Jh][2s]
mataberrant bets 1751
archylamoula calls 1751
*** RIVER *** [5s As Jh 2s][Th]
mataberrant bets 8804
archylamoula calls 8804
*** SHOW DOWN ***
archylamoula shows [Ad 8c] (One pair : Aces)
mataberrant shows [6s 9s] (Flush Ace high)
mataberrant collected 24612 from pot
*** SUMMARY ***
Total pot 24612 | No rake
Board: [5s As Jh 2s Th]
Seat 5: mataberrant (big blind) showed [6s 9s] and won 24612 with Flush Ace high
Seat 6: archylamoula showed [Ad 8c] and lost with One pair : Aces


Winamax Poker - Tournament "SKENIGMA Payant A" buyIn: 1.80€ + 0.20€ level: -695534927 - HandId: #3069735365515411459-2-1701119233 - Holdem no limit (80/300/600) - 2023/11/27 21:07:13 UTC
Table: 'SKENIGMA Payant A(714728461)#02' 7-max (real money) Seat #4 is the button
Seat 1: Romanovitch1 (16789)
Seat 2: Tullochboy42 (13354)
Seat 3: P1xel7 (39849)
Seat 4: GBG57018 (27139)
Seat 5: mataberrant (45403)
Seat 6: archylamoula (23233)
Seat 7: Etisan (34233)
*** ANTE/BLINDS ***
mataberrant posts ante 80
archylamoula posts ante 80
Romanovitch1 posts ante 80
Tullochboy42 posts ante 80
P1xel7 posts ante 80
GBG57018 posts ante 80
Etisan posts ante 80
mataberrant posts small blind 300
archylamoula posts big blind 600
Dealt to P1xel7 [Kc 2c]
*** PRE-FLOP *** 
Etisan folds
Romanovitch1 folds
Tullochboy42 folds
P1xel7 folds
GBG57018 folds
mataberrant raises 600 to 1200
archylamoula folds
mataberrant collected 2360 from pot
*** SUMMARY ***
Total pot 2360 | No rake
Seat 5: mataberrant (small blind) won 2360


Winamax Poker - Tournament "SKENIGMA Payant A" buyIn: 1.80€ + 0.20€ level: -695534927 - HandId: #3069735365515411459-3-1701119254 - Holdem no limit (80/300/600) - 2023/11/27 21:07:34 UTC
Table: 'SKENIGMA Payant A(714728461)#02' 7-max (real money) Seat #5 is the button
Seat 1: Romanovitch1 (16709)
Seat 2: Tullochboy42 (13274)
Seat 3: P1xel7 (39769)
Seat 4: GBG57018 (27059)
Seat 5: mataberrant (46483)
Seat 6: archylamoula (22553)
Seat 7: Etisan (34153)
*** ANTE/BLINDS ***
archylamoula posts ante 80
Etisan posts ante 80
Romanovitch1 posts ante 80
Tullochboy42 posts ante 80
P1xel7 posts ante 80
GBG57018 posts ante 80
mataberrant posts ante 80
archylamoula posts small blind 300
Etisan posts big blind 600
Dealt to P1xel7 [Tc 3s]
*** PRE-FLOP *** 
Romanovitch1 raises 900 to 1500
Tullochboy42 folds
P1xel7 folds
GBG57018 folds
mataberrant calls 1500
archylamoula folds
Etisan folds
*** FLOP *** [Ts 3c 8d]
Romanovitch1 bets 1472
mataberrant calls 1472
*** TURN *** [Ts 3c 8d][7c]
Romanovitch1 bets 4813
mataberrant calls 4813
*** RIVER *** [Ts 3c 8d 7c][2c]
Romanovitch1 checks
mataberrant bets 38618 and is all-in
Romanovitch1 folds
mataberrant collected 55648 from pot
*** SUMMARY ***
Total pot 55648 | No rake
Board: [Ts 3c 8d 7c 2c]
Seat 5: mataberrant (button) won 55648


Winamax Poker - Tournament "SKENIGMA Payant A" buyIn: 1.80€ + 0.20€ level: -695534927 - HandId: #3069735365515411459-4-1701119331 - Holdem no limit (80/300/600) - 2023/11/27 21:08:51 UTC
Table: 'SKENIGMA Payant A(714728461)#02' 7-max (real money) Seat #6 is the button
Seat 1: Romanovitch1 (8844)
Seat 2: Tullochboy42 (13194)
Seat 3: P1xel7 (39689)
Seat 4: GBG57018 (26979)
Seat 5: mataberrant (55648)
Seat 6: archylamoula (22173)
Seat 7: Etisan (33473)
*** ANTE/BLINDS ***
Etisan posts ante 80
Romanovitch1 posts ante 80
Tullochboy42 posts ante 80
P1xel7 posts ante 80
GBG57018 posts ante 80
mataberrant posts ante 80
archylamoula posts ante 80
Etisan posts small blind 300
Romanovitch1 posts big blind 600
Dealt to P1xel7 [Qh 3s]
*** PRE-FLOP *** 
Tullochboy42 folds
P1xel7 folds
GBG57018 folds
mataberrant folds
archylamoula calls 600
Etisan raises 600 to 1200
Romanovitch1 calls 600
archylamoula calls 600
*** FLOP *** [8c Ts Js]
Etisan checks
Romanovitch1 checks
archylamoula checks
*** TURN *** [8c Ts Js][9h]
Etisan bets 2080
Romanovitch1 folds
archylamoula calls 2080
*** RIVER *** [8c Ts Js 9h][4s]
Etisan checks
archylamoula bets 5408
Etisan folds
archylamoula collected 13728 from pot
*** SUMMARY ***
Total pot 13728 | No rake
Board: [8c Ts Js 9h 4s]
Seat 6: archylamoula (button) won 13728


Winamax Poker - Tournament "SKENIGMA Payant A" buyIn: 1.80€ + 0.20€ level: 9 - HandId: #3069735365515411459-5-1701119425 - Holdem no limit (100/400/800) - 2023/11/27 21:10:25 UTC
Table: 'SKENIGMA Payant A(714728461)#02' 7-max (real money) Seat #7 is the button
Seat 1: Romanovitch1 (7564)
Seat 2: Tullochboy42 (13114)
Seat 3: P1xel7 (39609)
Seat 4: GBG57018 (26899)
Seat 5: mataberrant (55568)
Seat 6: archylamoula (27133)
Seat 7: Etisan (30113)
*** ANTE/BLINDS ***
Romanovitch1 posts ante 100
Tullochboy42 posts ante 100
P1xel7 posts ante 100
GBG57018 posts ante 100
mataberrant posts ante 100
archylamoula posts ante 100
Etisan posts ante 100
Romanovitch1 posts small blind 400
Tullochboy42 posts big blind 800
Dealt to P1xel7 [8d Jh]
*** PRE-FLOP *** 
P1xel7 folds
GBG57018 folds
mataberrant folds
archylamoula calls 800
Etisan folds
Romanovitch1 folds
Tullochboy42 checks
*** FLOP *** [4d Kc Ts]
Tullochboy42 checks
archylamoula checks
*** TURN *** [4d Kc Ts][5d]
Tullochboy42 checks
archylamoula checks
*** RIVER *** [4d Kc Ts 5d][Tc]
Tullochboy42 checks
archylamoula bets 800
Tullochboy42 folds
archylamoula collected 3500 from pot
*** SUMMARY ***
Total pot 3500 | No rake
Board: [4d Kc Ts 5d Tc]
Seat 6: archylamoula won 3500


Winamax Poker - Tournament "SKENIGMA Payant A" buyIn: 1.80€ + 0.20€ level: 9 - HandId: #3069735365515411459-6-1701119471 - Holdem no limit (100/400/800) - 2023/11/27 21:11:11 UTC
Table: 'SKENIGMA Payant A(714728461)#02' 7-max (real money) Seat #1 is the button
Seat 1: Romanovitch1 (7064)
Seat 2: Tullochboy42 (12214)
Seat 3: P1xel7 (39509)
Seat 4: GBG57018 (26799)
Seat 5: mataberrant (55468)
Seat 6: archylamoula (28933)
Seat 7: Etisan (30013)
*** ANTE/BLINDS ***
Tullochboy42 posts ante 100
P1xel7 posts ante 100
Romanovitch1 posts ante 100
GBG57018 posts ante 100
mataberrant posts ante 100
archylamoula posts ante 100
Etisan posts ante 100
Tullochboy42 posts small blind 400
P1xel7 posts big blind 800
Dealt to P1xel7 [Ad 9s]
*** PRE-FLOP *** 
GBG57018 folds
mataberrant raises 800 to 1600
archylamoula calls 1600
Etisan folds
Romanovitch1 folds
Tullochboy42 folds
P1xel7 calls 800
*** FLOP *** [9h 3d Kc]
P1xel7 checks
mataberrant checks
archylamoula checks
*** TURN *** [9h 3d Kc][2d]
P1xel7 bets 2065
mataberrant calls 2065
archylamoula folds
*** RIVER *** [9h 3d Kc 2d][Td]
P1xel7 bets 3511
mataberrant raises 5111 to 8622
P1xel7 folds
mataberrant collected 22163 from pot
*** SUMMARY ***
Total pot 22163 | No rake
Board: [9h 3d Kc 2d Td]
Seat 5: mataberrant won 22163


Winamax Poker - Tournament "SKENIGMA Payant A" buyIn: 1.80€ + 0.20€ level: 9 - HandId: #3069735365515411459-7-1701119536 - Holdem no limit (100/400/800) - 2023/11/27 21:12:16 UTC
Table: 'SKENIGMA Payant A(714728461)#02' 7-max (real money) Seat #2 is the button
Seat 1: Romanovitch1 (6964)
Seat 2: Tullochboy42 (11714)
Seat 3: P1xel7 (32233)
Seat 4: GBG57018 (26699)
Seat 5: mataberrant (65244)
Seat 6: archylamoula (27233)
Seat 7: Etisan (29913)
*** ANTE/BLINDS ***
P1xel7 posts ante 100
GBG57018 posts ante 100
Romanovitch1 posts ante 100
Tullochboy42 posts ante 100
mataberrant posts ante 100
archylamoula posts ante 100
Etisan posts ante 100
P1xel7 posts small blind 400
GBG57018 posts big blind 800
Dealt to P1xel7 [7c As]
*** PRE-FLOP *** 
mataberrant folds
archylamoula folds
Etisan raises 800 to 1600
Romanovitch1 folds
Tullochboy42 raises 10014 to 11614 and is all-in
P1xel7 folds
GBG57018 folds
Etisan folds
Tullochboy42 collected 15114 from pot
*** SUMMARY ***
Total pot 15114 | No rake
Seat 2: Tullochboy42 (button) won 15114


Winamax Poker - Tournament "SKENIGMA Payant A" buyIn: 1.80€ + 0.20€ level: 9 - HandId: #3069735365515411459-8-1701119574 - Holdem no limit (100/400/800) - 2023/11/27 21:12:54 UTC
Table: 'SKENIGMA Payant A(714728461)#02' 7-max (real money) Seat #3 is the button
Seat 1: Romanovitch1 (6864)
Seat 2: Tullochboy42 (15114)
Seat 3: P1xel7 (31733)
Seat 4: GBG57018 (25799)
Seat 5: mataberrant (65144)
Seat 6: archylamoula (27133)
Seat 7: Etisan (28213)
*** ANTE/BLINDS ***
GBG57018 posts ante 100
mataberrant posts ante 100
Romanovitch1 posts ante 100
Tullochboy42 posts ante 100
P1xel7 posts ante 100
archylamoula posts ante 100
Etisan posts ante 100
GBG57018 posts small blind 400
mataberrant posts big blind 800
Dealt to P1xel7 [6c 2c]
*** PRE-FLOP *** 
archylamoula folds
Etisan folds
Romanovitch1 folds
Tullochboy42 folds
P1xel7 folds
GBG57018 folds
mataberrant collected 1900 from pot
*** SUMMARY ***
Total pot 1900 | No rake
Seat 5: mataberrant (big blind) won 1900


Winamax Poker - Tournament "SKENIGMA Payant A" buyIn: 1.80€ + 0.20€ level: 9 - HandId: #3069735365515411459-9-1701119587 - Holdem no limit (100/400/800) - 2023/11/27 21:13:07 UTC
Table: 'SKENIGMA Payant A(714728461)#02' 7-max (real money) Seat #4 is the button
Seat 1: Romanovitch1 (6764)
Seat 2: Tullochboy42 (15014)
Seat 3: P1xel7 (31633)
Seat 4: GBG57018 (25299)
Seat 5: mataberrant (66144)
Seat 6: archylamoula (27033)
Seat 7: Etisan (28113)
*** ANTE/BLINDS ***
mataberrant posts ante 100
archylamoula posts ante 100
Romanovitch1 posts ante 100
Tullochboy42 posts ante 100
P1xel7 posts ante 100
GBG57018 posts ante 100
Etisan posts ante 100
mataberrant posts small blind 400
archylamoula posts big blind 800
Dealt to P1xel7 [Jc 6d]
*** PRE-FLOP *** 
Etisan raises 800 to 1600
Romanovitch1 folds
Tullochboy42 folds
P1xel7 folds
GBG57018 folds
mataberrant folds
archylamoula calls 800
*** FLOP *** [Ks 5h 9s]
archylamoula bets 800
Etisan folds
archylamoula collected 5100 from pot
*** SUMMARY ***
Total pot 5100 | No rake
Board: [Ks 5h 9s]
Seat 6: archylamoula (big blind) won 5100


Winamax Poker - Tournament "SKENIGMA Payant A" buyIn: 1.80€ + 0.20€ level: 9 - HandId: #3069735365515411459-10-1701119619 - Holdem no limit (100/400/800) - 2023/11/27 21:13:39 UTC
Table: 'SKENIGMA Payant A(714728461)#02' 7-max (real money) Seat #5 is the button
Seat 1: Romanovitch1 (6664)
Seat 2: Tullochboy42 (14914)
Seat 3: P1xel7 (31533)
Seat 4: GBG57018 (25199)
Seat 5: mataberrant (65644)
Seat 6: archylamoula (29633)
Seat 7: Etisan (26413)
*** ANTE/BLINDS ***
archylamoula posts ante 100
Etisan posts ante 100
Romanovitch1 posts ante 100
Tullochboy42 posts ante 100
P1xel7 posts ante 100
GBG57018 posts ante 100
mataberrant posts ante 100
archylamoula posts small blind 400
Etisan posts big blind 800
Dealt to P1xel7 [7d Qs]
*** PRE-FLOP *** 
Romanovitch1 folds
Tullochboy42 folds
P1xel7 folds
GBG57018 raises 800 to 1600
mataberrant folds
archylamoula calls 1200
Etisan calls 800
*** FLOP *** [Ad 4d 6c]
archylamoula checks
Etisan checks
GBG57018 bets 1775
archylamoula folds
Etisan calls 1775
*** TURN *** [Ad 4d 6c][7c]
Etisan checks
GBG57018 bets 4525
Etisan calls 4525
*** RIVER *** [Ad 4d 6c 7c][Tc]
Etisan bets 6335
GBG57018 folds
Etisan collected 24435 from pot
*** SUMMARY ***
Total pot 24435 | No rake
Board: [Ad 4d 6c 7c Tc]
Seat 7: Etisan (big blind) won 24435


Winamax Poker - Tournament "SKENIGMA Payant A" buyIn: 1.80€ + 0.20€ level: 9 - HandId: #3069735365515411459-11-1701119731 - Holdem no limit (100/400/800) - 2023/11/27 21:15:31 UTC
Table: 'SKENIGMA Payant A(714728461)#02' 7-max (real money) Seat #6 is the button
Seat 1: Romanovitch1 (6564)
Seat 2: Tullochboy42 (14814)
Seat 3: P1xel7 (31433)
Seat 4: GBG57018 (17199)
Seat 5: mataberrant (65544)
Seat 6: archylamoula (27933)
Seat 7: Etisan (36513)
*** ANTE/BLINDS ***
Etisan posts ante 100
Romanovitch1 posts ante 100
Tullochboy42 posts ante 100
P1xel7 posts ante 100
GBG57018 posts ante 100
mataberrant posts ante 100
archylamoula posts ante 100
Etisan posts small blind 400
Romanovitch1 posts big blind 800
Dealt to P1xel7 [Ah 3h]
*** PRE-FLOP *** 
Tullochboy42 folds
P1xel7 folds
GBG57018 folds
mataberrant folds
archylamoula raises 800 to 1600
Etisan folds
Romanovitch1 folds
archylamoula collected 3500 from pot
*** SUMMARY ***
Total pot 3500 | No rake
Seat 6: archylamoula (button) won 3500


Winamax Poker - Tournament "SKENIGMA Payant A" buyIn: 1.80€ + 0.20€ level: 9 - HandId: #3069735365515411459-12-1701119751 - Holdem no limit (100/400/800) - 2023/11/27 21:15:51 UTC
Table: 'SKENIGMA Payant A(714728461)#02' 7-max (real money) Seat #7 is the button
Seat 1: Romanovitch1 (5664)
Seat 2: Tullochboy42 (14714)
Seat 3: P1xel7 (31333)
Seat 4: GBG57018 (17099)
Seat 5: mataberrant (65444)
Seat 6: archylamoula (29733)
Seat 7: Etisan (36013)
*** ANTE/BLINDS ***
Romanovitch1 posts ante 100
Tullochboy42 posts ante 100
P1xel7 posts ante 100
GBG57018 posts ante 100
mataberrant posts ante 100
archylamoula posts ante 100
Etisan posts ante 100
Romanovitch1 posts small blind 400
Tullochboy42 posts big blind 800
Dealt to P1xel7 [3d 4c]
*** PRE-FLOP *** 
P1xel7 folds
GBG57018 folds
mataberrant folds
archylamoula folds
Etisan folds
Romanovitch1 folds
Tullochboy42 collected 1900 from pot
*** SUMMARY ***
Total pot 1900 | No rake
Seat 2: Tullochboy42 (big blind) won 1900


Winamax Poker - Tournament "SKENIGMA Payant A" buyIn: 1.80€ + 0.20€ level: 9 - HandId: #3069735365515411459-13-1701119781 - Holdem no limit (100/400/800) - 2023/11/27 21:16:21 UTC
Table: 'SKENIGMA Payant A(714728461)#02' 7-max (real money) Seat #1 is the button
Seat 1: Romanovitch1 (5164)
Seat 2: Tullochboy42 (15714)
Seat 3: P1xel7 (31233)
Seat 4: GBG57018 (16999)
Seat 5: mataberrant (65344)
Seat 6: archylamoula (29633)
Seat 7: Etisan (35913)
*** ANTE/BLINDS ***
Tullochboy42 posts ante 100
P1xel7 posts ante 100
Romanovitch1 posts ante 100
GBG57018 posts ante 100
mataberrant posts ante 100
archylamoula posts ante 100
Etisan posts ante 100
Tullochboy42 posts small blind 400
P1xel7 posts big blind 800
Dealt to P1xel7 [9h Qh]
*** PRE-FLOP *** 
GBG57018 folds
mataberrant raises 800 to 1600
archylamoula folds
Etisan folds
Romanovitch1 folds
Tullochboy42 folds
P1xel7 calls 800
*** FLOP *** [Jh 9c Ks]
P1xel7 checks
mataberrant bets 1505
P1xel7 calls 1505
*** TURN *** [Jh 9c Ks][Qc]
P1xel7 checks
mataberrant checks
*** RIVER *** [Jh 9c Ks Qc][2d]
P1xel7 bets 3655
mataberrant folds
P1xel7 collected 10965 from pot
*** SUMMARY ***
Total pot 10965 | No rake
Board: [Jh 9c Ks Qc 2d]
Seat 3: P1xel7 (big blind) won 10965


Winamax Poker - Tournament "SKENIGMA Payant A" buyIn: 1.80€ + 0.20€ level: 9 - HandId: #3069735365515411459-14-1701119823 - Holdem no limit (100/400/800) - 2023/11/27 21:17:03 UTC
Table: 'SKENIGMA Payant A(714728461)#02' 7-max (real money) Seat #2 is the button
Seat 1: Romanovitch1 (5064)
Seat 2: Tullochboy42 (15214)
Seat 3: P1xel7 (35338)
Seat 4: GBG57018 (16899)
Seat 5: mataberrant (62139)
Seat 6: archylamoula (29533)
Seat 7: Etisan (35813)
*** ANTE/BLINDS ***
P1xel7 posts ante 100
GBG57018 posts ante 100
Romanovitch1 posts ante 100
Tullochboy42 posts ante 100
mataberrant posts ante 100
archylamoula posts ante 100
Etisan posts ante 100
P1xel7 posts small blind 400
GBG57018 posts big blind 800
Dealt to P1xel7 [Td Js]
*** PRE-FLOP *** 
mataberrant raises 800 to 1600
archylamoula calls 1600
Etisan raises 800 to 2400
Romanovitch1 raises 2564 to 4964 and is all-in
Tullochboy42 folds
P1xel7 folds
GBG57018 folds
mataberrant folds
archylamoula calls 3364
Etisan calls 2564
*** FLOP *** [5h Tc 4c]
archylamoula checks
Etisan checks
*** TURN *** [5h Tc 4c][Jh]
archylamoula checks
Etisan checks
*** RIVER *** [5h Tc 4c Jh][2h]
archylamoula checks
Etisan checks
*** SHOW DOWN ***
archylamoula shows [6d Kd] (High card : King)
Etisan shows [6c As] (High card : Ace)
Romanovitch1 shows [9s 9c] (One pair : 9)
Romanovitch1 collected 18392 from pot
*** SUMMARY ***
Total pot 18392 | No rake
Board: [5h Tc 4c Jh 2h]
Seat 1: Romanovitch1 showed [9s 9c] and won 18392 with One pair : 9
Seat 6: archylamoula showed [6d Kd] and lost with High card : King
Seat 7: Etisan showed [6c As] and lost with High card : Ace


Winamax Poker - Tournament "SKENIGMA Payant A" buyIn: 1.80€ + 0.20€ level: 10 - HandId: #3069735365515411459-15-1701119896 - Holdem no limit (120/500/1000) - 2023/11/27 21:18:16 UTC
Table: 'SKENIGMA Payant A(714728461)#02' 7-max (real money) Seat #3 is the button
Seat 1: Romanovitch1 (18392)
Seat 2: Tullochboy42 (15114)
Seat 3: P1xel7 (34838)
Seat 4: GBG57018 (15999)
Seat 5: mataberrant (60439)
Seat 6: archylamoula (24469)
Seat 7: Etisan (30749)
*** ANTE/BLINDS ***
GBG57018 posts ante 120
mataberrant posts ante 120
Romanovitch1 posts ante 120
Tullochboy42 posts ante 120
P1xel7 posts ante 120
archylamoula posts ante 120
Etisan posts ante 120
GBG57018 posts small blind 500
mataberrant posts big blind 1000
Dealt to P1xel7 [5h 9d]
*** PRE-FLOP *** 
archylamoula calls 1000
Etisan folds
Romanovitch1 folds
Tullochboy42 folds
P1xel7 folds
GBG57018 folds
mataberrant checks
*** FLOP *** [Jc Ks Qd]
mataberrant checks
archylamoula checks
*** TURN *** [Jc Ks Qd][5s]
mataberrant checks
archylamoula bets 1000
mataberrant folds
archylamoula collected 4340 from pot
*** SUMMARY ***
Total pot 4340 | No rake
Board: [Jc Ks Qd 5s]
Seat 6: archylamoula won 4340


Winamax Poker - Tournament "SKENIGMA Payant A" buyIn: 1.80€ + 0.20€ level: 10 - HandId: #3069735365515411459-16-1701119930 - Holdem no limit (120/500/1000) - 2023/11/27 21:18:50 UTC
Table: 'SKENIGMA Payant A(714728461)#02' 7-max (real money) Seat #4 is the button
Seat 1: Romanovitch1 (18272)
Seat 2: Tullochboy42 (14994)
Seat 3: P1xel7 (34718)
Seat 4: GBG57018 (15379)
Seat 5: mataberrant (59319)
Seat 6: archylamoula (26689)
Seat 7: Etisan (30629)
*** ANTE/BLINDS ***
mataberrant posts ante 120
archylamoula posts ante 120
Romanovitch1 posts ante 120
Tullochboy42 posts ante 120
P1xel7 posts ante 120
GBG57018 posts ante 120
Etisan posts ante 120
mataberrant posts small blind 500
archylamoula posts big blind 1000
Dealt to P1xel7 [3d 8d]
*** PRE-FLOP *** 
Etisan calls 1000
Romanovitch1 folds
Tullochboy42 folds
P1xel7 folds
GBG57018 folds
mataberrant folds
archylamoula checks
*** FLOP *** [Kd Ah Qd]
archylamoula checks
Etisan checks
*** TURN *** [Kd Ah Qd][9h]
archylamoula checks
Etisan checks
*** RIVER *** [Kd Ah Qd 9h][Ad]
archylamoula bets 1000
Etisan folds
archylamoula collected 4340 from pot
*** SUMMARY ***
Total pot 4340 | No rake
Board: [Kd Ah Qd 9h Ad]
Seat 6: archylamoula (big blind) won 4340


Winamax Poker - Tournament "SKENIGMA Payant A" buyIn: 1.80€ + 0.20€ level: 10 - HandId: #3069735365515411459-17-1701119995 - Holdem no limit (120/500/1000) - 2023/11/27 21:19:55 UTC
Table: 'SKENIGMA Payant A(714728461)#02' 7-max (real money) Seat #5 is the button
Seat 1: Romanovitch1 (18152)
Seat 2: Tullochboy42 (14874)
Seat 3: P1xel7 (34598)
Seat 4: GBG57018 (15259)
Seat 5: mataberrant (58699)
Seat 6: archylamoula (28909)
Seat 7: Etisan (29509)
*** ANTE/BLINDS ***
archylamoula posts ante 120
Etisan posts ante 120
Romanovitch1 posts ante 120
Tullochboy42 posts ante 120
P1xel7 posts ante 120
GBG57018 posts ante 120
mataberrant posts ante 120
archylamoula posts small blind 500
Etisan posts big blind 1000
Dealt to P1xel7 [2s 3d]
*** PRE-FLOP *** 
Romanovitch1 raises 1000 to 2000
Tullochboy42 folds
P1xel7 folds
GBG57018 folds
mataberrant folds
archylamoula folds
Etisan calls 1000
*** FLOP *** [Ts Qh 3c]
Etisan checks
Romanovitch1 bets 1762
Etisan calls 1762
*** TURN *** [Ts Qh 3c][6d]
Etisan checks
Romanovitch1 bets 2925
Etisan calls 2925
*** RIVER *** [Ts Qh 3c 6d][7s]
Etisan bets 11771
Romanovitch1 calls 11345 and is all-in
*** SHOW DOWN ***
Romanovitch1 shows [Qs Kd] (One pair : Queens)
Etisan shows [7d 7c] (Trips of 7)
Etisan collected 37830 from pot
*** SUMMARY ***
Total pot 37830 | No rake
Board: [Ts Qh 3c 6d 7s]
Seat 1: Romanovitch1 showed [Qs Kd] and lost with One pair : Queens
Seat 7: Etisan (big blind) showed [7d 7c] and won 37830 with Trips of 7


Winamax Poker - Tournament "SKENIGMA Payant A" buyIn: 1.80€ + 0.20€ level: 10 - HandId: #3069735365515411459-18-1701120154 - Holdem no limit (120/500/1000) - 2023/11/27 21:22:34 UTC
Table: 'SKENIGMA Payant A(714728461)#02' 7-max (real money) Seat #6 is the button
Seat 2: Tullochboy42 (14754)
Seat 3: P1xel7 (34478)
Seat 4: GBG57018 (15139)
Seat 5: mataberrant (58579)
Seat 6: archylamoula (28289)
Seat 7: Etisan (48761)
*** ANTE/BLINDS ***
Etisan posts ante 120
Tullochboy42 posts ante 120
P1xel7 posts ante 120
GBG57018 posts ante 120
mataberrant posts ante 120
archylamoula posts ante 120
Etisan posts small blind 500
Tullochboy42 posts big blind 1000
Dealt to P1xel7 [Td 2c]
*** PRE-FLOP *** 
P1xel7 folds
GBG57018 folds
mataberrant raises 1000 to 2000
archylamoula folds
Etisan calls 1500
Tullochboy42 calls 1000
*** FLOP *** [Th Qs 4c]
Etisan checks
Tullochboy42 checks
mataberrant checks
*** TURN *** [Th Qs 4c][Ah]
Etisan checks
Tullochboy42 bets 2500
mataberrant folds
Etisan folds
Tullochboy42 collected 9220 from pot
*** SUMMARY ***
Total pot 9220 | No rake
Board: [Th Qs 4c Ah]
Seat 2: Tullochboy42 (big blind) won 9220


Winamax Poker - Tournament "SKENIGMA Payant A" buyIn: 1.80€ + 0.20€ level: 10 - HandId: #3069735365515411459-19-1701120238 - Holdem no limit (120/500/1000) - 2023/11/27 21:23:58 UTC
Table: 'SKENIGMA Payant A(714728461)#02' 7-max (real money) Seat #7 is the button
Seat 2: Tullochboy42 (19354)
Seat 3: P1xel7 (34358)
Seat 4: GBG57018 (15019)
Seat 5: mataberrant (56459)
Seat 6: archylamoula (28169)
Seat 7: Etisan (46641)
*** ANTE/BLINDS ***
Tullochboy42 posts ante 120
P1xel7 posts ante 120
GBG57018 posts ante 120
mataberrant posts ante 120
archylamoula posts ante 120
Etisan posts ante 120
Tullochboy42 posts small blind 500
P1xel7 posts big blind 1000
Dealt to P1xel7 [9c Kh]
*** PRE-FLOP *** 
GBG57018 folds
mataberrant folds
archylamoula folds
Etisan folds
Tullochboy42 folds
P1xel7 collected 2220 from pot
*** SUMMARY ***
Total pot 2220 | No rake
Seat 3: P1xel7 (big blind) won 2220


Winamax Poker - Tournament "SKENIGMA Payant A" buyIn: 1.80€ + 0.20€ level: 10 - HandId: #3069735365515411459-20-1701120290 - Holdem no limit (120/500/1000) - 2023/11/27 21:24:50 UTC
Table: 'SKENIGMA Payant A(714728461)#02' 7-max (real money) Seat #2 is the button
Seat 2: Tullochboy42 (18734)
Seat 3: P1xel7 (35458)
Seat 4: GBG57018 (14899)
Seat 5: mataberrant (56339)
Seat 6: archylamoula (28049)
Seat 7: Etisan (46521)
*** ANTE/BLINDS ***
P1xel7 posts ante 120
GBG57018 posts ante 120
Tullochboy42 posts ante 120
mataberrant posts ante 120
archylamoula posts ante 120
Etisan posts ante 120
P1xel7 posts small blind 500
GBG57018 posts big blind 1000
Dealt to P1xel7 [Ah 9d]
*** PRE-FLOP *** 
mataberrant folds
archylamoula calls 1000
Etisan folds
Tullochboy42 folds
P1xel7 raises 1500 to 2500
GBG57018 folds
archylamoula calls 1500
*** FLOP *** [5h 4c 6s]
P1xel7 checks
archylamoula bets 1000
P1xel7 folds
archylamoula collected 7720 from pot
*** SUMMARY ***
Total pot 7720 | No rake
Board: [5h 4c 6s]
Seat 6: archylamoula won 7720


Winamax Poker - Tournament "SKENIGMA Payant A" buyIn: 1.80€ + 0.20€ level: 11 - HandId: #3069735365515411459-21-1701120363 - Holdem no limit (160/600/1200) - 2023/11/27 21:26:03 UTC
Table: 'SKENIGMA Payant A(714728461)#02' 7-max (real money) Seat #3 is the button
Seat 2: Tullochboy42 (18614)
Seat 3: P1xel7 (32838)
Seat 4: GBG57018 (13779)
Seat 5: mataberrant (56219)
Seat 6: archylamoula (32149)
Seat 7: Etisan (46401)
*** ANTE/BLINDS ***
GBG57018 posts ante 160
mataberrant posts ante 160
Tullochboy42 posts ante 160
P1xel7 posts ante 160
archylamoula posts ante 160
Etisan posts ante 160
GBG57018 posts small blind 600
mataberrant posts big blind 1200
Dealt to P1xel7 [4h 9s]
*** PRE-FLOP *** 
archylamoula folds
Etisan folds
Tullochboy42 calls 1200
P1xel7 folds
GBG57018 raises 12419 to 13619 and is all-in
mataberrant folds
Tullochboy42 calls 12419
*** FLOP *** [Jh 4s Ah]
*** TURN *** [Jh 4s Ah][Th]
*** RIVER *** [Jh 4s Ah Th][6s]
*** SHOW DOWN ***
Tullochboy42 shows [Kc Kd] (One pair : Kings)
GBG57018 shows [Ad 6h] (Two pairs : Aces and 6)
GBG57018 collected 29398 from pot
*** SUMMARY ***
Total pot 29398 | No rake
Board: [Jh 4s Ah Th 6s]
Seat 2: Tullochboy42 showed [Kc Kd] and lost with One pair : Kings
Seat 4: GBG57018 (small blind) showed [Ad 6h] and won 29398 with Two pairs : Aces and 6


Winamax Poker - Tournament "SKENIGMA Payant A" buyIn: 1.80€ + 0.20€ level: 11 - HandId: #3069735365515411459-22-1701120410 - Holdem no limit (160/600/1200) - 2023/11/27 21:26:50 UTC
Table: 'SKENIGMA Payant A(714728461)#02' 7-max (real money) Seat #4 is the button
Seat 2: Tullochboy42 (4835)
Seat 3: P1xel7 (32678)
Seat 4: GBG57018 (29398)
Seat 5: mataberrant (54859)
Seat 6: archylamoula (31989)
Seat 7: Etisan (46241)
*** ANTE/BLINDS ***
mataberrant posts ante 160
archylamoula posts ante 160
Tullochboy42 posts ante 160
P1xel7 posts ante 160
GBG57018 posts ante 160
Etisan posts ante 160
mataberrant posts small blind 600
archylamoula posts big blind 1200
Dealt to P1xel7 [2s Qs]
*** PRE-FLOP *** 
Etisan raises 1200 to 2400
Tullochboy42 raises 2275 to 4675 and is all-in
P1xel7 folds
GBG57018 folds
mataberrant folds
archylamoula folds
Etisan calls 2275
*** FLOP *** [9h Th 5h]
*** TURN *** [9h Th 5h][As]
*** RIVER *** [9h Th 5h As][4h]
*** SHOW DOWN ***
Etisan shows [Kd 9s] (One pair : 9)
Tullochboy42 shows [Tc Ks] (One pair : Tens)
Tullochboy42 collected 12110 from pot
*** SUMMARY ***
Total pot 12110 | No rake
Board: [9h Th 5h As 4h]
Seat 2: Tullochboy42 showed [Tc Ks] and won 12110 with One pair : Tens
Seat 7: Etisan showed [Kd 9s] and lost with One pair : 9


Winamax Poker - Tournament "SKENIGMA Payant A" buyIn: 1.80€ + 0.20€ level: 11 - HandId: #3069735365515411459-23-1701120433 - Holdem no limit (160/600/1200) - 2023/11/27 21:27:13 UTC
Table: 'SKENIGMA Payant A(714728461)#02' 7-max (real money) Seat #5 is the button
Seat 2: Tullochboy42 (12110)
Seat 3: P1xel7 (32518)
Seat 4: GBG57018 (29238)
Seat 5: mataberrant (54099)
Seat 6: archylamoula (30629)
Seat 7: Etisan (41406)
*** ANTE/BLINDS ***
archylamoula posts ante 160
Etisan posts ante 160
Tullochboy42 posts ante 160
P1xel7 posts ante 160
GBG57018 posts ante 160
mataberrant posts ante 160
archylamoula posts small blind 600
Etisan posts big blind 1200
Dealt to P1xel7 [9c Ks]
*** PRE-FLOP *** 
Tullochboy42 folds
P1xel7 folds
GBG57018 raises 1200 to 2400
mataberrant folds
archylamoula calls 1800
Etisan calls 1200
*** FLOP *** [Jc Th Td]
archylamoula checks
Etisan checks
GBG57018 checks
*** TURN *** [Jc Th Td][8c]
archylamoula checks
Etisan checks
GBG57018 bets 2856
archylamoula calls 2856
Etisan folds
*** RIVER *** [Jc Th Td 8c][Kh]
archylamoula checks
GBG57018 checks
*** SHOW DOWN ***
GBG57018 shows [6h 7h] (One pair : Tens)
archylamoula shows [Ac 4c] (One pair : Tens)
archylamoula collected 13872 from pot
*** SUMMARY ***
Total pot 13872 | No rake
Board: [Jc Th Td 8c Kh]
Seat 4: GBG57018 showed [6h 7h] and lost with One pair : Tens
Seat 6: archylamoula (small blind) showed [Ac 4c] and won 13872 with One pair : Tens


Winamax Poker - Tournament "SKENIGMA Payant A" buyIn: 1.80€ + 0.20€ level: 11 - HandId: #3069735365515411459-24-1701120542 - Holdem no limit (160/600/1200) - 2023/11/27 21:29:02 UTC
Table: 'SKENIGMA Payant A(714728461)#02' 7-max (real money) Seat #6 is the button
Seat 2: Tullochboy42 (11950)
Seat 3: P1xel7 (32358)
Seat 4: GBG57018 (23822)
Seat 5: mataberrant (53939)
Seat 6: archylamoula (39085)
Seat 7: Etisan (38846)
*** ANTE/BLINDS ***
Etisan posts ante 160
Tullochboy42 posts ante 160
P1xel7 posts ante 160
GBG57018 posts ante 160
mataberrant posts ante 160
archylamoula posts ante 160
Etisan posts small blind 600
Tullochboy42 posts big blind 1200
Dealt to P1xel7 [7h 3c]
*** PRE-FLOP *** 
P1xel7 folds
GBG57018 folds
mataberrant raises 1200 to 2400
archylamoula folds
Etisan raises 1800 to 4200
Tullochboy42 folds
mataberrant raises 1800 to 6000
Etisan calls 1800
*** FLOP *** [3s Tc 2c]
Etisan checks
mataberrant checks
*** TURN *** [3s Tc 2c][5d]
Etisan checks
mataberrant bets 4740
Etisan calls 4740
*** RIVER *** [3s Tc 2c 5d][Js]
Etisan checks
mataberrant bets 11820
Etisan folds
mataberrant collected 35460 from pot
*** SUMMARY ***
Total pot 35460 | No rake
Board: [3s Tc 2c 5d Js]
Seat 5: mataberrant won 35460


Winamax Poker - Tournament "SKENIGMA Payant A" buyIn: 1.80€ + 0.20€ level: 11 - HandId: #3069735365515411459-25-1701120583 - Holdem no limit (160/600/1200) - 2023/11/27 21:29:43 UTC
Table: 'SKENIGMA Payant A(714728461)#02' 7-max (real money) Seat #7 is the button
Seat 2: Tullochboy42 (10590)
Seat 3: P1xel7 (32198)
Seat 4: GBG57018 (23662)
Seat 5: mataberrant (66679)
Seat 6: archylamoula (38925)
Seat 7: Etisan (27946)
*** ANTE/BLINDS ***
Tullochboy42 posts ante 160
P1xel7 posts ante 160
GBG57018 posts ante 160
mataberrant posts ante 160
archylamoula posts ante 160
Etisan posts ante 160
Tullochboy42 posts small blind 600
P1xel7 posts big blind 1200
Dealt to P1xel7 [2d Js]
*** PRE-FLOP *** 
GBG57018 folds
mataberrant folds
archylamoula folds
Etisan folds
Tullochboy42 raises 9230 to 10430 and is all-in
P1xel7 folds
Tullochboy42 collected 12590 from pot
*** SUMMARY ***
Total pot 12590 | No rake
Seat 2: Tullochboy42 (small blind) won 12590


Winamax Poker - Tournament "SKENIGMA Payant A" buyIn: 1.80€ + 0.20€ level: 11 - HandId: #3069735365515411459-26-1701120591 - Holdem no limit (160/600/1200) - 2023/11/27 21:29:51 UTC
Table: 'SKENIGMA Payant A(714728461)#02' 7-max (real money) Seat #2 is the button
Seat 2: Tullochboy42 (12590)
Seat 3: P1xel7 (30838)
Seat 4: GBG57018 (23502)
Seat 5: mataberrant (66519)
Seat 6: archylamoula (38765)
Seat 7: Etisan (27786)
*** ANTE/BLINDS ***
P1xel7 posts ante 160
GBG57018 posts ante 160
Tullochboy42 posts ante 160
mataberrant posts ante 160
archylamoula posts ante 160
Etisan posts ante 160
P1xel7 posts small blind 600
GBG57018 posts big blind 1200
Dealt to P1xel7 [Jd 4c]
*** PRE-FLOP *** 
mataberrant folds
archylamoula folds
Etisan folds
Tullochboy42 raises 11230 to 12430 and is all-in
P1xel7 folds
GBG57018 folds
Tullochboy42 collected 15190 from pot
*** SUMMARY ***
Total pot 15190 | No rake
Seat 2: Tullochboy42 (button) won 15190


Winamax Poker - Tournament "SKENIGMA Payant A" buyIn: 1.80€ + 0.20€ level: 11 - HandId: #3069735365515411459-27-1701120613 - Holdem no limit (160/600/1200) - 2023/11/27 21:30:13 UTC
Table: 'SKENIGMA Payant A(714728461)#02' 7-max (real money) Seat #3 is the button
Seat 2: Tullochboy42 (15190)
Seat 3: P1xel7 (30078)
Seat 4: GBG57018 (22142)
Seat 5: mataberrant (66359)
Seat 6: archylamoula (38605)
Seat 7: Etisan (27626)
*** ANTE/BLINDS ***
GBG57018 posts ante 160
mataberrant posts ante 160
Tullochboy42 posts ante 160
P1xel7 posts ante 160
archylamoula posts ante 160
Etisan posts ante 160
GBG57018 posts small blind 600
mataberrant posts big blind 1200
Dealt to P1xel7 [Kh Td]
*** PRE-FLOP *** 
archylamoula folds
Etisan folds
Tullochboy42 folds
P1xel7 raises 1800 to 3000
GBG57018 folds
mataberrant folds
P1xel7 collected 5760 from pot
*** SUMMARY ***
Total pot 5760 | No rake
Seat 3: P1xel7 (button) won 5760


Winamax Poker - Tournament "SKENIGMA Payant A" buyIn: 1.80€ + 0.20€ level: 11 - HandId: #3069735365515411459-28-1701120635 - Holdem no limit (160/600/1200) - 2023/11/27 21:30:35 UTC
Table: 'SKENIGMA Payant A(714728461)#02' 7-max (real money) Seat #4 is the button
Seat 2: Tullochboy42 (15030)
Seat 3: P1xel7 (32678)
Seat 4: GBG57018 (21382)
Seat 5: mataberrant (64999)
Seat 6: archylamoula (38445)
Seat 7: Etisan (27466)
*** ANTE/BLINDS ***
mataberrant posts ante 160
archylamoula posts ante 160
Tullochboy42 posts ante 160
P1xel7 posts ante 160
GBG57018 posts ante 160
Etisan posts ante 160
mataberrant posts small blind 600
archylamoula posts big blind 1200
Dealt to P1xel7 [2c 3c]
*** PRE-FLOP *** 
Etisan folds
Tullochboy42 folds
P1xel7 folds
GBG57018 folds
mataberrant calls 600
archylamoula checks
*** FLOP *** [8h 7c Qs]
mataberrant bets 1200
archylamoula calls 1200
*** TURN *** [8h 7c Qs][3d]
mataberrant bets 1200
archylamoula calls 1200
*** RIVER *** [8h 7c Qs 3d][4h]
mataberrant checks
archylamoula checks
*** SHOW DOWN ***
mataberrant shows [9c Js] (High card : Queen)
archylamoula shows [Td Tc] (One pair : Tens)
archylamoula collected 8160 from pot
*** SUMMARY ***
Total pot 8160 | No rake
Board: [8h 7c Qs 3d 4h]
Seat 5: mataberrant (small blind) showed [9c Js] and lost with High card : Queen
Seat 6: archylamoula (big blind) showed [Td Tc] and won 8160 with One pair : Tens


Winamax Poker - Tournament "SKENIGMA Payant A" buyIn: 1.80€ + 0.20€ level: 11 - HandId: #3069735365515411459-29-1701120656 - Holdem no limit (160/600/1200) - 2023/11/27 21:30:56 UTC
Table: 'SKENIGMA Payant A(714728461)#02' 7-max (real money) Seat #5 is the button
Seat 2: Tullochboy42 (14870)
Seat 3: P1xel7 (32518)
Seat 4: GBG57018 (21222)
Seat 5: mataberrant (61239)
Seat 6: archylamoula (42845)
Seat 7: Etisan (27306)
*** ANTE/BLINDS ***
archylamoula posts ante 160
Etisan posts ante 160
Tullochboy42 posts ante 160
P1xel7 posts ante 160
GBG57018 posts ante 160
mataberrant posts ante 160
archylamoula posts small blind 600
Etisan posts big blind 1200
Dealt to P1xel7 [2d Ts]
*** PRE-FLOP *** 
Tullochboy42 folds
P1xel7 folds
GBG57018 folds
mataberrant raises 1200 to 2400
archylamoula folds
Etisan calls 1200
*** FLOP *** [5s Qh 9d]
Etisan checks
mataberrant bets 1800
Etisan calls 1800
*** TURN *** [5s Qh 9d][9c]
Etisan checks
mataberrant bets 2400
Etisan folds
mataberrant collected 12360 from pot
*** SUMMARY ***
Total pot 12360 | No rake
Board: [5s Qh 9d 9c]
Seat 5: mataberrant (button) won 12360


Winamax Poker - Tournament "SKENIGMA Payant A" buyIn: 1.80€ + 0.20€ level: 11 - HandId: #3069735365515411459-30-1701120684 - Holdem no limit (160/600/1200) - 2023/11/27 21:31:24 UTC
Table: 'SKENIGMA Payant A(714728461)#02' 7-max (real money) Seat #6 is the button
Seat 2: Tullochboy42 (14710)
Seat 3: P1xel7 (32358)
Seat 4: GBG57018 (21062)
Seat 5: mataberrant (66839)
Seat 6: archylamoula (42085)
Seat 7: Etisan (22946)
*** ANTE/BLINDS ***
Etisan posts ante 160
Tullochboy42 posts ante 160
P1xel7 posts ante 160
GBG57018 posts ante 160
mataberrant posts ante 160
archylamoula posts ante 160
Etisan posts small blind 600
Tullochboy42 posts big blind 1200
Dealt to P1xel7 [As Ks]
*** PRE-FLOP *** 
P1xel7 raises 1800 to 3000
GBG57018 raises 17902 to 20902 and is all-in
mataberrant folds
archylamoula folds
Etisan folds
Tullochboy42 folds
P1xel7 calls 17902
*** FLOP *** [6c Ah 8s]
*** TURN *** [6c Ah 8s][Ad]
*** RIVER *** [6c Ah 8s Ad][3s]
*** SHOW DOWN ***
P1xel7 shows [As Ks] (Trips of Aces)
GBG57018 shows [8h 8c] (Full of 8 and Aces)
GBG57018 collected 44564 from pot
*** SUMMARY ***
Total pot 44564 | No rake
Board: [6c Ah 8s Ad 3s]
Seat 3: P1xel7 showed [As Ks] and lost with Trips of Aces
Seat 4: GBG57018 showed [8h 8c] and won 44564 with Full of 8 and Aces


Winamax Poker - Tournament "SKENIGMA Payant A" buyIn: 1.80€ + 0.20€ level: 11 - HandId: #3069735365515411459-31-1701120734 - Holdem no limit (160/600/1200) - 2023/11/27 21:32:14 UTC
Table: 'SKENIGMA Payant A(714728461)#02' 7-max (real money) Seat #7 is the button
Seat 2: Tullochboy42 (13350)
Seat 3: P1xel7 (11296)
Seat 4: GBG57018 (44564)
Seat 5: mataberrant (66679)
Seat 6: archylamoula (41925)
Seat 7: Etisan (22186)
*** ANTE/BLINDS ***
Tullochboy42 posts ante 160
P1xel7 posts ante 160
GBG57018 posts ante 160
mataberrant posts ante 160
archylamoula posts ante 160
Etisan posts ante 160
Tullochboy42 posts small blind 600
P1xel7 posts big blind 1200
Dealt to P1xel7 [9c 7c]
*** PRE-FLOP *** 
GBG57018 folds
mataberrant folds
archylamoula calls 1200
Etisan raises 1200 to 2400
Tullochboy42 folds
P1xel7 folds
archylamoula calls 1200
*** FLOP *** [As Jd Qc]
archylamoula checks
Etisan checks
*** TURN *** [As Jd Qc][Qd]
archylamoula checks
Etisan checks
*** RIVER *** [As Jd Qc Qd][3s]
archylamoula checks
Etisan bets 3780
archylamoula calls 3780
*** SHOW DOWN ***
archylamoula shows [7s Kd] (One pair : Queens)
Etisan shows [Kh Jc] (Two pairs : Queens and Jacks)
Etisan collected 15120 from pot
*** SUMMARY ***
Total pot 15120 | No rake
Board: [As Jd Qc Qd 3s]
Seat 6: archylamoula showed [7s Kd] and lost with One pair : Queens
Seat 7: Etisan (button) showed [Kh Jc] and won 15120 with Two pairs : Queens and Jacks


Winamax Poker - Tournament "SKENIGMA Payant A" buyIn: 1.80€ + 0.20€ level: 11 - HandId: #3069735365515411459-32-1701120792 - Holdem no limit (160/600/1200) - 2023/11/27 21:33:12 UTC
Table: 'SKENIGMA Payant A(714728461)#02' 7-max (real money) Seat #2 is the button
Seat 2: Tullochboy42 (12590)
Seat 3: P1xel7 (9936)
Seat 4: GBG57018 (44404)
Seat 5: mataberrant (66519)
Seat 6: archylamoula (35585)
Seat 7: Etisan (30966)
*** ANTE/BLINDS ***
P1xel7 posts ante 160
GBG57018 posts ante 160
Tullochboy42 posts ante 160
mataberrant posts ante 160
archylamoula posts ante 160
Etisan posts ante 160
P1xel7 posts small blind 600
GBG57018 posts big blind 1200
Dealt to P1xel7 [4h 9h]
*** PRE-FLOP *** 
mataberrant folds
archylamoula folds
Etisan folds
Tullochboy42 folds
P1xel7 folds
GBG57018 collected 2760 from pot
*** SUMMARY ***
Total pot 2760 | No rake
Seat 4: GBG57018 (big blind) won 2760


Winamax Poker - Tournament "SKENIGMA Payant A" buyIn: 1.80€ + 0.20€ level: 11 - HandId: #3069735365515411459-33-1701120802 - Holdem no limit (160/600/1200) - 2023/11/27 21:33:22 UTC
Table: 'SKENIGMA Payant A(714728461)#02' 7-max (real money) Seat #3 is the button
Seat 2: Tullochboy42 (12430)
Seat 3: P1xel7 (9176)
Seat 4: GBG57018 (45804)
Seat 5: mataberrant (66359)
Seat 6: archylamoula (35425)
Seat 7: Etisan (30806)
*** ANTE/BLINDS ***
GBG57018 posts ante 160
mataberrant posts ante 160
Tullochboy42 posts ante 160
P1xel7 posts ante 160
archylamoula posts ante 160
Etisan posts ante 160
GBG57018 posts small blind 600
mataberrant posts big blind 1200
Dealt to P1xel7 [Th Ts]
*** PRE-FLOP *** 
archylamoula calls 1200
Etisan calls 1200
Tullochboy42 folds
P1xel7 raises 7816 to 9016 and is all-in
GBG57018 folds
mataberrant folds
archylamoula folds
Etisan folds
P1xel7 collected 14176 from pot
*** SUMMARY ***
Total pot 14176 | No rake
Seat 3: P1xel7 (button) won 14176


Winamax Poker - Tournament "SKENIGMA Payant A" buyIn: 1.80€ + 0.20€ level: 11 - HandId: #3069735365515411459-34-1701120832 - Holdem no limit (160/600/1200) - 2023/11/27 21:33:52 UTC
Table: 'SKENIGMA Payant A(714728461)#02' 7-max (real money) Seat #4 is the button
Seat 2: Tullochboy42 (12270)
Seat 3: P1xel7 (14176)
Seat 4: GBG57018 (45044)
Seat 5: mataberrant (64999)
Seat 6: archylamoula (34065)
Seat 7: Etisan (29446)
*** ANTE/BLINDS ***
mataberrant posts ante 160
archylamoula posts ante 160
Tullochboy42 posts ante 160
P1xel7 posts ante 160
GBG57018 posts ante 160
Etisan posts ante 160
mataberrant posts small blind 600
archylamoula posts big blind 1200
Dealt to P1xel7 [Td 4s]
*** PRE-FLOP *** 
Etisan folds
Tullochboy42 folds
P1xel7 folds
GBG57018 folds
mataberrant raises 1200 to 2400
archylamoula calls 1200
*** FLOP *** [7c Th Ad]
mataberrant bets 1800
archylamoula raises 1800 to 3600
mataberrant calls 1800
*** TURN *** [7c Th Ad][Tc]
mataberrant checks
archylamoula bets 1200
mataberrant calls 1200
*** RIVER *** [7c Th Ad Tc][8s]
mataberrant bets 5376
archylamoula calls 5376
*** SHOW DOWN ***
mataberrant shows [Kd Kc] (Two pairs : Kings and Tens)
archylamoula shows [As 5d] (Two pairs : Aces and Tens)
archylamoula collected 26112 from pot
*** SUMMARY ***
Total pot 26112 | No rake
Board: [7c Th Ad Tc 8s]
Seat 5: mataberrant (small blind) showed [Kd Kc] and lost with Two pairs : Kings and Tens
Seat 6: archylamoula (big blind) showed [As 5d] and won 26112 with Two pairs : Aces and Tens


Winamax Poker - Tournament "SKENIGMA Payant A" buyIn: 1.80€ + 0.20€ level: 12 - HandId: #3069735365515411459-35-1701120867 - Holdem no limit (200/800/1600) - 2023/11/27 21:34:27 UTC
Table: 'SKENIGMA Payant A(714728461)#02' 7-max (real money) Seat #5 is the button
Seat 2: Tullochboy42 (12110)
Seat 3: P1xel7 (14016)
Seat 4: GBG57018 (44884)
Seat 5: mataberrant (52263)
Seat 6: archylamoula (47441)
Seat 7: Etisan (29286)
*** ANTE/BLINDS ***
archylamoula posts ante 200
Etisan posts ante 200
Tullochboy42 posts ante 200
P1xel7 posts ante 200
GBG57018 posts ante 200
mataberrant posts ante 200
archylamoula posts small blind 800
Etisan posts big blind 1600
Dealt to P1xel7 [4c 7c]
*** PRE-FLOP *** 
Tullochboy42 folds
P1xel7 folds
GBG57018 folds
mataberrant raises 1600 to 3200
archylamoula calls 2400
Etisan calls 1600
*** FLOP *** [8c 4d Qs]
archylamoula checks
Etisan bets 1600
mataberrant calls 1600
archylamoula folds
*** TURN *** [8c 4d Qs][8h]
Etisan checks
mataberrant checks
*** RIVER *** [8c 4d Qs 8h][9s]
Etisan bets 4900
mataberrant raises 42363 to 47263 and is all-in
Etisan folds
mataberrant collected 66163 from pot
*** SUMMARY ***
Total pot 66163 | No rake
Board: [8c 4d Qs 8h 9s]
Seat 5: mataberrant (button) won 66163


Winamax Poker - Tournament "SKENIGMA Payant A" buyIn: 1.80€ + 0.20€ level: 12 - HandId: #3069735365515411459-36-1701120963 - Holdem no limit (200/800/1600) - 2023/11/27 21:36:03 UTC
Table: 'SKENIGMA Payant A(714728461)#02' 7-max (real money) Seat #6 is the button
Seat 2: Tullochboy42 (11910)
Seat 3: P1xel7 (13816)
Seat 4: GBG57018 (44684)
Seat 5: mataberrant (66163)
Seat 6: archylamoula (44041)
Seat 7: Etisan (19386)
*** ANTE/BLINDS ***
Etisan posts ante 200
Tullochboy42 posts ante 200
P1xel7 posts ante 200
GBG57018 posts ante 200
mataberrant posts ante 200
archylamoula posts ante 200
Etisan posts small blind 800
Tullochboy42 posts big blind 1600
Dealt to P1xel7 [3c 5c]
*** PRE-FLOP *** 
P1xel7 folds
GBG57018 folds
mataberrant raises 2400 to 4000
archylamoula folds
Etisan folds
Tullochboy42 folds
mataberrant collected 7600 from pot
*** SUMMARY ***
Total pot 7600 | No rake
Seat 5: mataberrant won 7600


Winamax Poker - Tournament "SKENIGMA Payant A" buyIn: 1.80€ + 0.20€ level: 12 - HandId: #3069735365515411459-37-1701120981 - Holdem no limit (200/800/1600) - 2023/11/27 21:36:21 UTC
Table: 'SKENIGMA Payant A(714728461)#02' 7-max (real money) Seat #7 is the button
Seat 2: Tullochboy42 (10110)
Seat 3: P1xel7 (13616)
Seat 4: GBG57018 (44484)
Seat 5: mataberrant (69563)
Seat 6: archylamoula (43841)
Seat 7: Etisan (18386)
*** ANTE/BLINDS ***
Tullochboy42 posts ante 200
P1xel7 posts ante 200
GBG57018 posts ante 200
mataberrant posts ante 200
archylamoula posts ante 200
Etisan posts ante 200
Tullochboy42 posts small blind 800
P1xel7 posts big blind 1600
Dealt to P1xel7 [Ah Ts]
*** PRE-FLOP *** 
GBG57018 folds
mataberrant raises 1600 to 3200
archylamoula folds
Etisan folds
Tullochboy42 folds
P1xel7 raises 10216 to 13416 and is all-in
mataberrant calls 10216
*** FLOP *** [Td 3s 3h]
*** TURN *** [Td 3s 3h][2s]
*** RIVER *** [Td 3s 3h 2s][5h]
*** SHOW DOWN ***
mataberrant shows [Kh Jd] (One pair : 3)
P1xel7 shows [Ah Ts] (Two pairs : Tens and 3)
P1xel7 collected 28832 from pot
*** SUMMARY ***
Total pot 28832 | No rake
Board: [Td 3s 3h 2s 5h]
Seat 3: P1xel7 (big blind) showed [Ah Ts] and won 28832 with Two pairs : Tens and 3
Seat 5: mataberrant showed [Kh Jd] and lost with One pair : 3


Winamax Poker - Tournament "SKENIGMA Payant A" buyIn: 1.80€ + 0.20€ level: 12 - HandId: #3069735365515411459-38-1701121018 - Holdem no limit (200/800/1600) - 2023/11/27 21:36:58 UTC
Table: 'SKENIGMA Payant A(714728461)#02' 7-max (real money) Seat #2 is the button
Seat 2: Tullochboy42 (9110)
Seat 3: P1xel7 (28832)
Seat 4: GBG57018 (44284)
Seat 5: mataberrant (55947)
Seat 6: archylamoula (43641)
Seat 7: Etisan (18186)
*** ANTE/BLINDS ***
P1xel7 posts ante 200
GBG57018 posts ante 200
Tullochboy42 posts ante 200
mataberrant posts ante 200
archylamoula posts ante 200
Etisan posts ante 200
P1xel7 posts small blind 800
GBG57018 posts big blind 1600
Dealt to P1xel7 [Jd Kc]
*** PRE-FLOP *** 
mataberrant calls 1600
archylamoula calls 1600
Etisan folds
Tullochboy42 folds
P1xel7 raises 5600 to 7200
GBG57018 folds
mataberrant folds
archylamoula calls 5600
*** FLOP *** [Tc Ac 3c]
P1xel7 bets 6580
archylamoula folds
P1xel7 collected 25380 from pot
*** SUMMARY ***
Total pot 25380 | No rake
Board: [Tc Ac 3c]
Seat 3: P1xel7 (small blind) won 25380


Winamax Poker - Tournament "SKENIGMA Payant A" buyIn: 1.80€ + 0.20€ level: 12 - HandId: #3069735365515411459-39-1701121065 - Holdem no limit (200/800/1600) - 2023/11/27 21:37:45 UTC
Table: 'SKENIGMA Payant A(714728461)#02' 7-max (real money) Seat #3 is the button
Seat 2: Tullochboy42 (8910)
Seat 3: P1xel7 (40232)
Seat 4: GBG57018 (42484)
Seat 5: mataberrant (54147)
Seat 6: archylamoula (36241)
Seat 7: Etisan (17986)
*** ANTE/BLINDS ***
GBG57018 posts ante 200
mataberrant posts ante 200
Tullochboy42 posts ante 200
P1xel7 posts ante 200
archylamoula posts ante 200
Etisan posts ante 200
GBG57018 posts small blind 800
mataberrant posts big blind 1600
Dealt to P1xel7 [Kh Kc]
*** PRE-FLOP *** 
archylamoula calls 1600
Etisan folds
Tullochboy42 folds
P1xel7 raises 4800 to 6400
GBG57018 folds
mataberrant folds
archylamoula calls 4800
*** FLOP *** [7d Ks 6s]
archylamoula bets 1600
P1xel7 calls 1600
*** TURN *** [7d Ks 6s][4d]
archylamoula bets 1600
P1xel7 raises 10600 to 12200
archylamoula calls 10600
*** RIVER *** [7d Ks 6s 4d][4c]
archylamoula bets 15841 and is all-in
P1xel7 calls 15841
*** SHOW DOWN ***
archylamoula shows [9c 9s] (Two pairs : 9 and 4)
P1xel7 shows [Kh Kc] (Full of Kings and 4)
P1xel7 collected 75682 from pot
*** SUMMARY ***
Total pot 75682 | No rake
Board: [7d Ks 6s 4d 4c]
Seat 3: P1xel7 (button) showed [Kh Kc] and won 75682 with Full of Kings and 4
Seat 6: archylamoula showed [9c 9s] and lost with Two pairs : 9 and 4


Winamax Poker - Tournament "SKENIGMA Payant A" buyIn: 1.80€ + 0.20€ level: 12 - HandId: #3069735365515411459-40-1701121112 - Holdem no limit (200/800/1600) - 2023/11/27 21:38:32 UTC
Table: 'SKENIGMA Payant A(714728461)#02' 7-max (real money) Seat #4 is the button
Seat 2: Tullochboy42 (8710)
Seat 3: P1xel7 (79673)
Seat 4: GBG57018 (41484)
Seat 5: mataberrant (52347)
Seat 7: Etisan (17786)
*** ANTE/BLINDS ***
mataberrant posts ante 200
Etisan posts ante 200
Tullochboy42 posts ante 200
P1xel7 posts ante 200
GBG57018 posts ante 200
mataberrant posts small blind 800
Etisan posts big blind 1600
Dealt to P1xel7 [3c Ts]
*** PRE-FLOP *** 
Tullochboy42 folds
P1xel7 folds
GBG57018 raises 1600 to 3200
mataberrant folds
Etisan calls 1600
*** FLOP *** [8c Tc Qd]
Etisan checks
GBG57018 bets 3300
Etisan folds
GBG57018 collected 11500 from pot
*** SUMMARY ***
Total pot 11500 | No rake
Board: [8c Tc Qd]
Seat 4: GBG57018 (button) won 11500


Winamax Poker - Tournament "SKENIGMA Payant A" buyIn: 1.80€ + 0.20€ level: 12 - HandId: #3069735365515411459-41-1701121142 - Holdem no limit (200/800/1600) - 2023/11/27 21:39:02 UTC
Table: 'SKENIGMA Payant A(714728461)#02' 7-max (real money) Seat #5 is the button
Seat 2: Tullochboy42 (8510)
Seat 3: P1xel7 (79473)
Seat 4: GBG57018 (46284)
Seat 5: mataberrant (51347)
Seat 7: Etisan (14386)
*** ANTE/BLINDS ***
Etisan posts ante 200
Tullochboy42 posts ante 200
P1xel7 posts ante 200
GBG57018 posts ante 200
mataberrant posts ante 200
Etisan posts small blind 800
Tullochboy42 posts big blind 1600
Dealt to P1xel7 [3s 8c]
*** PRE-FLOP *** 
P1xel7 folds
GBG57018 folds
mataberrant folds
Etisan folds
Tullochboy42 collected 3400 from pot
*** SUMMARY ***
Total pot 3400 | No rake
Seat 2: Tullochboy42 (big blind) won 3400


Winamax Poker - Tournament "SKENIGMA Payant A" buyIn: 1.80€ + 0.20€ level: 12 - HandId: #3069735365515411459-42-1701121149 - Holdem no limit (200/800/1600) - 2023/11/27 21:39:09 UTC
Table: 'SKENIGMA Payant A(714728461)#02' 7-max (real money) Seat #7 is the button
Seat 2: Tullochboy42 (10110)
Seat 3: P1xel7 (79273)
Seat 4: GBG57018 (46084)
Seat 5: mataberrant (51147)
Seat 7: Etisan (13386)
*** ANTE/BLINDS ***
Tullochboy42 posts ante 200
P1xel7 posts ante 200
GBG57018 posts ante 200
mataberrant posts ante 200
Etisan posts ante 200
Tullochboy42 posts small blind 800
P1xel7 posts big blind 1600
Dealt to P1xel7 [4d 6h]
*** PRE-FLOP *** 
GBG57018 folds
mataberrant folds
Etisan folds
Tullochboy42 raises 8310 to 9910 and is all-in
P1xel7 folds
Tullochboy42 collected 12510 from pot
*** SUMMARY ***
Total pot 12510 | No rake
Seat 2: Tullochboy42 (small blind) won 12510


Winamax Poker - Tournament "SKENIGMA Payant A" buyIn: 1.80€ + 0.20€ level: 12 - HandId: #3069735365515411459-43-1701121170 - Holdem no limit (200/800/1600) - 2023/11/27 21:39:30 UTC
Table: 'SKENIGMA Payant A(714728461)#02' 7-max (real money) Seat #2 is the button
Seat 2: Tullochboy42 (12510)
Seat 3: P1xel7 (77473)
Seat 4: GBG57018 (45884)
Seat 5: mataberrant (50947)
Seat 7: Etisan (13186)
*** ANTE/BLINDS ***
P1xel7 posts ante 200
GBG57018 posts ante 200
Tullochboy42 posts ante 200
mataberrant posts ante 200
Etisan posts ante 200
P1xel7 posts small blind 800
GBG57018 posts big blind 1600
Dealt to P1xel7 [5c 6s]
*** PRE-FLOP *** 
mataberrant raises 1600 to 3200
Etisan folds
Tullochboy42 folds
P1xel7 folds
GBG57018 folds
mataberrant collected 6600 from pot
*** SUMMARY ***
Total pot 6600 | No rake
Seat 5: mataberrant won 6600


Winamax Poker - Tournament "SKENIGMA Payant A" buyIn: 1.80€ + 0.20€ level: 12 - HandId: #3069735365515411459-44-1701121182 - Holdem no limit (200/800/1600) - 2023/11/27 21:39:42 UTC
Table: 'SKENIGMA Payant A(714728461)#02' 7-max (real money) Seat #3 is the button
Seat 2: Tullochboy42 (12310)
Seat 3: P1xel7 (76473)
Seat 4: GBG57018 (44084)
Seat 5: mataberrant (54147)
Seat 7: Etisan (12986)
*** ANTE/BLINDS ***
GBG57018 posts ante 200
mataberrant posts ante 200
Tullochboy42 posts ante 200
P1xel7 posts ante 200
Etisan posts ante 200
GBG57018 posts small blind 800
mataberrant posts big blind 1600
Dealt to P1xel7 [6s Js]
*** PRE-FLOP *** 
Etisan folds
Tullochboy42 folds
P1xel7 folds
GBG57018 folds
mataberrant collected 3400 from pot
*** SUMMARY ***
Total pot 3400 | No rake
Seat 5: mataberrant (big blind) won 3400


Winamax Poker - Tournament "SKENIGMA Payant A" buyIn: 1.80€ + 0.20€ level: 12 - HandId: #3069735365515411459-45-1701121191 - Holdem no limit (200/800/1600) - 2023/11/27 21:39:51 UTC
Table: 'SKENIGMA Payant A(714728461)#02' 7-max (real money) Seat #4 is the button
Seat 2: Tullochboy42 (12110)
Seat 3: P1xel7 (76273)
Seat 4: GBG57018 (43084)
Seat 5: mataberrant (55747)
Seat 7: Etisan (12786)
*** ANTE/BLINDS ***
mataberrant posts ante 200
Etisan posts ante 200
Tullochboy42 posts ante 200
P1xel7 posts ante 200
GBG57018 posts ante 200
mataberrant posts small blind 800
Etisan posts big blind 1600
Dealt to P1xel7 [Ah Tc]
*** PRE-FLOP *** 
Tullochboy42 raises 10310 to 11910 and is all-in
P1xel7 folds
GBG57018 folds
mataberrant folds
Etisan folds
Tullochboy42 collected 15310 from pot
*** SUMMARY ***
Total pot 15310 | No rake
Seat 2: Tullochboy42 won 15310


Winamax Poker - Tournament "SKENIGMA Payant A" buyIn: 1.80€ + 0.20€ level: 12 - HandId: #3069735365515411459-46-1701121208 - Holdem no limit (200/800/1600) - 2023/11/27 21:40:08 UTC
Table: 'SKENIGMA Payant A(714728461)#02' 7-max (real money) Seat #5 is the button
Seat 2: Tullochboy42 (15310)
Seat 3: P1xel7 (76073)
Seat 4: GBG57018 (42884)
Seat 5: mataberrant (54747)
Seat 7: Etisan (10986)
*** ANTE/BLINDS ***
Etisan posts ante 200
Tullochboy42 posts ante 200
P1xel7 posts ante 200
GBG57018 posts ante 200
mataberrant posts ante 200
Etisan posts small blind 800
Tullochboy42 posts big blind 1600
Dealt to P1xel7 [Td 5s]
*** PRE-FLOP *** 
P1xel7 folds
GBG57018 raises 1600 to 3200
mataberrant folds
Etisan folds
Tullochboy42 folds
GBG57018 collected 6600 from pot
*** SUMMARY ***
Total pot 6600 | No rake
Seat 4: GBG57018 won 6600


Winamax Poker - Tournament "SKENIGMA Payant A" buyIn: 1.80€ + 0.20€ level: 12 - HandId: #3069735365515411459-47-1701121226 - Holdem no limit (200/800/1600) - 2023/11/27 21:40:26 UTC
Table: 'SKENIGMA Payant A(714728461)#02' 7-max (real money) Seat #7 is the button
Seat 2: Tullochboy42 (13510)
Seat 3: P1xel7 (75873)
Seat 4: GBG57018 (46084)
Seat 5: mataberrant (54547)
Seat 7: Etisan (9986)
*** ANTE/BLINDS ***
Tullochboy42 posts ante 200
P1xel7 posts ante 200
GBG57018 posts ante 200
mataberrant posts ante 200
Etisan posts ante 200
Tullochboy42 posts small blind 800
P1xel7 posts big blind 1600
Dealt to P1xel7 [Qc Jh]
*** PRE-FLOP *** 
GBG57018 raises 1600 to 3200
mataberrant folds
Etisan raises 6586 to 9786 and is all-in
Tullochboy42 folds
P1xel7 folds
GBG57018 calls 6586
*** FLOP *** [8h 7h 9d]
*** TURN *** [8h 7h 9d][7s]
*** RIVER *** [8h 7h 9d 7s][6s]
*** SHOW DOWN ***
Etisan shows [3h 3d] (Two pairs : 7 and 3)
GBG57018 shows [Ad 6h] (Two pairs : 7 and 6)
GBG57018 collected 22972 from pot
*** SUMMARY ***
Total pot 22972 | No rake
Board: [8h 7h 9d 7s 6s]
Seat 4: GBG57018 showed [Ad 6h] and won 22972 with Two pairs : 7 and 6
Seat 7: Etisan (button) showed [3h 3d] and lost with Two pairs : 7 and 3


Winamax Poker - Tournament "SKENIGMA Payant A" buyIn: 1.80€ + 0.20€ level: 12 - HandId: #3069735365515411459-48-1701121252 - Holdem no limit (200/800/1600) - 2023/11/27 21:40:52 UTC
Table: 'SKENIGMA Payant A(714728461)#02' 7-max (real money) Seat #2 is the button
Seat 2: Tullochboy42 (12510)
Seat 3: P1xel7 (74073)
Seat 4: GBG57018 (59070)
Seat 5: mataberrant (54347)
*** ANTE/BLINDS ***
P1xel7 posts ante 200
GBG57018 posts ante 200
Tullochboy42 posts ante 200
mataberrant posts ante 200
P1xel7 posts small blind 800
GBG57018 posts big blind 1600
Dealt to P1xel7 [8d 5h]
*** PRE-FLOP *** 
mataberrant raises 1600 to 3200
Tullochboy42 raises 9110 to 12310 and is all-in
P1xel7 folds
GBG57018 calls 10710
mataberrant folds
*** FLOP *** [7c As Js]
*** TURN *** [7c As Js][Qc]
*** RIVER *** [7c As Js Qc][4s]
*** SHOW DOWN ***
Tullochboy42 shows [Ac 8h] (One pair : Aces)
GBG57018 shows [Ah Jh] (Two pairs : Aces and Jacks)
GBG57018 collected 29420 from pot
*** SUMMARY ***
Total pot 29420 | No rake
Board: [7c As Js Qc 4s]
Seat 2: Tullochboy42 (button) showed [Ac 8h] and lost with One pair : Aces
Seat 4: GBG57018 (big blind) showed [Ah Jh] and won 29420 with Two pairs : Aces and Jacks


Winamax Poker - Tournament "SKENIGMA Payant A" buyIn: 1.80€ + 0.20€ level: 12 - HandId: #3069735365515411459-49-1701121275 - Holdem no limit (200/800/1600) - 2023/11/27 21:41:15 UTC
Table: 'SKENIGMA Payant A(714728461)#02' 7-max (real money) Seat #3 is the button
Seat 3: P1xel7 (73073)
Seat 4: GBG57018 (75980)
Seat 5: mataberrant (50947)
*** ANTE/BLINDS ***
GBG57018 posts ante 200
mataberrant posts ante 200
P1xel7 posts ante 200
GBG57018 posts small blind 800
mataberrant posts big blind 1600
Dealt to P1xel7 [Kc 2s]
*** PRE-FLOP *** 
P1xel7 raises 2400 to 4000
GBG57018 folds
mataberrant folds
P1xel7 collected 7000 from pot
*** SUMMARY ***
Total pot 7000 | No rake
Seat 3: P1xel7 (button) won 7000


Winamax Poker - Tournament "SKENIGMA Payant A" buyIn: 1.80€ + 0.20€ level: 12 - HandId: #3069735365515411459-50-1701121294 - Holdem no limit (200/800/1600) - 2023/11/27 21:41:34 UTC
Table: 'SKENIGMA Payant A(714728461)#02' 7-max (real money) Seat #4 is the button
Seat 3: P1xel7 (75873)
Seat 4: GBG57018 (74980)
Seat 5: mataberrant (49147)
*** ANTE/BLINDS ***
mataberrant posts ante 200
P1xel7 posts ante 200
GBG57018 posts ante 200
mataberrant posts small blind 800
P1xel7 posts big blind 1600
Dealt to P1xel7 [9h 3c]
*** PRE-FLOP *** 
GBG57018 raises 1600 to 3200
mataberrant calls 2400
P1xel7 folds
*** FLOP *** [Th As 4d]
mataberrant checks
GBG57018 checks
*** TURN *** [Th As 4d][Tc]
mataberrant bets 3010
GBG57018 folds
mataberrant collected 11610 from pot
*** SUMMARY ***
Total pot 11610 | No rake
Board: [Th As 4d Tc]
Seat 5: mataberrant (small blind) won 11610


Winamax Poker - Tournament "SKENIGMA Payant A" buyIn: 1.80€ + 0.20€ level: 12 - HandId: #3069735365515411459-51-1701121308 - Holdem no limit (200/800/1600) - 2023/11/27 21:41:48 UTC
Table: 'SKENIGMA Payant A(714728461)#02' 7-max (real money) Seat #5 is the button
Seat 3: P1xel7 (74073)
Seat 4: GBG57018 (71580)
Seat 5: mataberrant (54347)
*** ANTE/BLINDS ***
P1xel7 posts ante 200
GBG57018 posts ante 200
mataberrant posts ante 200
P1xel7 posts small blind 800
GBG57018 posts big blind 1600
Dealt to P1xel7 [3h 9s]
*** PRE-FLOP *** 
mataberrant folds
P1xel7 folds
GBG57018 collected 3000 from pot
*** SUMMARY ***
Total pot 3000 | No rake
Seat 4: GBG57018 (big blind) won 3000


Winamax Poker - Tournament "SKENIGMA Payant A" buyIn: 1.80€ + 0.20€ level: 12 - HandId: #3069735365515411459-52-1701121314 - Holdem no limit (200/800/1600) - 2023/11/27 21:41:54 UTC
Table: 'SKENIGMA Payant A(714728461)#02' 7-max (real money) Seat #3 is the button
Seat 3: P1xel7 (73073)
Seat 4: GBG57018 (72780)
Seat 5: mataberrant (54147)
*** ANTE/BLINDS ***
GBG57018 posts ante 200
mataberrant posts ante 200
P1xel7 posts ante 200
GBG57018 posts small blind 800
mataberrant posts big blind 1600
Dealt to P1xel7 [Jd Qd]
*** PRE-FLOP *** 
P1xel7 raises 2400 to 4000
GBG57018 folds
mataberrant calls 2400
*** FLOP *** [9d Ts 4h]
mataberrant checks
P1xel7 checks
*** TURN *** [9d Ts 4h][7c]
mataberrant checks
P1xel7 bets 3290
mataberrant calls 3290
*** RIVER *** [9d Ts 4h 7c][3d]
mataberrant checks
P1xel7 checks
*** SHOW DOWN ***
P1xel7 shows [Jd Qd] (High card : Queen)
mataberrant shows [3c 3s] (Trips of 3)
mataberrant collected 15980 from pot
*** SUMMARY ***
Total pot 15980 | No rake
Board: [9d Ts 4h 7c 3d]
Seat 3: P1xel7 (button) showed [Jd Qd] and lost with High card : Queen
Seat 5: mataberrant (big blind) showed [3c 3s] and won 15980 with Trips of 3


Winamax Poker - Tournament "SKENIGMA Payant A" buyIn: 1.80€ + 0.20€ level: 13 - HandId: #3069735365515411459-53-1701121363 - Holdem no limit (250/1000/2000) - 2023/11/27 21:42:43 UTC
Table: 'SKENIGMA Payant A(714728461)#02' 7-max (real money) Seat #4 is the button
Seat 3: P1xel7 (65583)
Seat 4: GBG57018 (71780)
Seat 5: mataberrant (62637)
*** ANTE/BLINDS ***
mataberrant posts ante 250
P1xel7 posts ante 250
GBG57018 posts ante 250
mataberrant posts small blind 1000
P1xel7 posts big blind 2000
Dealt to P1xel7 [4d As]
*** PRE-FLOP *** 
GBG57018 raises 2000 to 4000
mataberrant folds
P1xel7 calls 2000
*** FLOP *** [Tc Th Qd]
P1xel7 checks
GBG57018 checks
*** TURN *** [Tc Th Qd][5h]
P1xel7 bets 3413
GBG57018 calls 3413
*** RIVER *** [Tc Th Qd 5h][2s]
P1xel7 bets 10774
GBG57018 folds
P1xel7 collected 27350 from pot
*** SUMMARY ***
Total pot 27350 | No rake
Board: [Tc Th Qd 5h 2s]
Seat 3: P1xel7 (big blind) won 27350


Winamax Poker - Tournament "SKENIGMA Payant A" buyIn: 1.80€ + 0.20€ level: 13 - HandId: #3069735365515411459-54-1701121417 - Holdem no limit (250/1000/2000) - 2023/11/27 21:43:37 UTC
Table: 'SKENIGMA Payant A(714728461)#02' 7-max (real money) Seat #5 is the button
Seat 3: P1xel7 (74496)
Seat 4: GBG57018 (64117)
Seat 5: mataberrant (61387)
*** ANTE/BLINDS ***
P1xel7 posts ante 250
GBG57018 posts ante 250
mataberrant posts ante 250
P1xel7 posts small blind 1000
GBG57018 posts big blind 2000
Dealt to P1xel7 [9d 9h]
*** PRE-FLOP *** 
mataberrant folds
P1xel7 raises 3000 to 5000
GBG57018 folds
P1xel7 collected 7750 from pot
*** SUMMARY ***
Total pot 7750 | No rake
Seat 3: P1xel7 (small blind) won 7750


Winamax Poker - Tournament "SKENIGMA Payant A" buyIn: 1.80€ + 0.20€ level: 13 - HandId: #3069735365515411459-55-1701121424 - Holdem no limit (250/1000/2000) - 2023/11/27 21:43:44 UTC
Table: 'SKENIGMA Payant A(714728461)#02' 7-max (real money) Seat #3 is the button
Seat 3: P1xel7 (76996)
Seat 4: GBG57018 (61867)
Seat 5: mataberrant (61137)
*** ANTE/BLINDS ***
GBG57018 posts ante 250
mataberrant posts ante 250
P1xel7 posts ante 250
GBG57018 posts small blind 1000
mataberrant posts big blind 2000
Dealt to P1xel7 [9d 8d]
*** PRE-FLOP *** 
P1xel7 raises 3000 to 5000
GBG57018 folds
mataberrant folds
P1xel7 collected 8750 from pot
*** SUMMARY ***
Total pot 8750 | No rake
Seat 3: P1xel7 (button) won 8750


Winamax Poker - Tournament "SKENIGMA Payant A" buyIn: 1.80€ + 0.20€ level: 13 - HandId: #3069735365515411459-56-1701121431 - Holdem no limit (250/1000/2000) - 2023/11/27 21:43:51 UTC
Table: 'SKENIGMA Payant A(714728461)#02' 7-max (real money) Seat #4 is the button
Seat 3: P1xel7 (80496)
Seat 4: GBG57018 (60617)
Seat 5: mataberrant (58887)
*** ANTE/BLINDS ***
mataberrant posts ante 250
P1xel7 posts ante 250
GBG57018 posts ante 250
mataberrant posts small blind 1000
P1xel7 posts big blind 2000
Dealt to P1xel7 [7d 6h]
*** PRE-FLOP *** 
GBG57018 raises 2000 to 4000
mataberrant folds
P1xel7 calls 2000
*** FLOP *** [2d Kh 6s]
P1xel7 checks
GBG57018 bets 3413
P1xel7 calls 3413
*** TURN *** [2d Kh 6s][Jd]
P1xel7 checks
GBG57018 bets 8288
P1xel7 folds
GBG57018 collected 24864 from pot
*** SUMMARY ***
Total pot 24864 | No rake
Board: [2d Kh 6s Jd]
Seat 4: GBG57018 (button) won 24864


Winamax Poker - Tournament "SKENIGMA Payant A" buyIn: 1.80€ + 0.20€ level: 13 - HandId: #3069735365515411459-57-1701121453 - Holdem no limit (250/1000/2000) - 2023/11/27 21:44:13 UTC
Table: 'SKENIGMA Payant A(714728461)#02' 7-max (real money) Seat #5 is the button
Seat 3: P1xel7 (72833)
Seat 4: GBG57018 (69530)
Seat 5: mataberrant (57637)
*** ANTE/BLINDS ***
P1xel7 posts ante 250
GBG57018 posts ante 250
mataberrant posts ante 250
P1xel7 posts small blind 1000
GBG57018 posts big blind 2000
Dealt to P1xel7 [2d 6d]
*** PRE-FLOP *** 
mataberrant raises 2000 to 4000
P1xel7 folds
GBG57018 calls 2000
*** FLOP *** [7c As 3h]
GBG57018 checks
mataberrant bets 3413
GBG57018 folds
mataberrant collected 13163 from pot
*** SUMMARY ***
Total pot 13163 | No rake
Board: [7c As 3h]
Seat 5: mataberrant (button) won 13163


Winamax Poker - Tournament "SKENIGMA Payant A" buyIn: 1.80€ + 0.20€ level: 13 - HandId: #3069735365515411459-58-1701121487 - Holdem no limit (250/1000/2000) - 2023/11/27 21:44:47 UTC
Table: 'SKENIGMA Payant A(714728461)#02' 7-max (real money) Seat #3 is the button
Seat 3: P1xel7 (71583)
Seat 4: GBG57018 (65280)
Seat 5: mataberrant (63137)
*** ANTE/BLINDS ***
GBG57018 posts ante 250
mataberrant posts ante 250
P1xel7 posts ante 250
GBG57018 posts small blind 1000
mataberrant posts big blind 2000
Dealt to P1xel7 [Th Ks]
*** PRE-FLOP *** 
P1xel7 raises 3000 to 5000
GBG57018 folds
mataberrant folds
P1xel7 collected 8750 from pot
*** SUMMARY ***
Total pot 8750 | No rake
Seat 3: P1xel7 (button) won 8750


Winamax Poker - Tournament "SKENIGMA Payant A" buyIn: 1.80€ + 0.20€ level: 13 - HandId: #3069735365515411459-59-1701121496 - Holdem no limit (250/1000/2000) - 2023/11/27 21:44:56 UTC
Table: 'SKENIGMA Payant A(714728461)#02' 7-max (real money) Seat #4 is the button
Seat 3: P1xel7 (75083)
Seat 4: GBG57018 (64030)
Seat 5: mataberrant (60887)
*** ANTE/BLINDS ***
mataberrant posts ante 250
P1xel7 posts ante 250
GBG57018 posts ante 250
mataberrant posts small blind 1000
P1xel7 posts big blind 2000
Dealt to P1xel7 [Th Tc]
*** PRE-FLOP *** 
GBG57018 raises 2000 to 4000
mataberrant calls 3000
P1xel7 raises 11000 to 15000
GBG57018 raises 48780 to 63780 and is all-in
mataberrant folds
P1xel7 calls 48780
*** FLOP *** [Ks Jc Qc]
*** TURN *** [Ks Jc Qc][6h]
*** RIVER *** [Ks Jc Qc 6h][Td]
*** SHOW DOWN ***
P1xel7 shows [Th Tc] (Trips of Tens)
GBG57018 shows [Kc Ad] (Straight Ace high)
GBG57018 collected 132310 from pot
*** SUMMARY ***
Total pot 132310 | No rake
Board: [Ks Jc Qc 6h Td]
Seat 3: P1xel7 (big blind) showed [Th Tc] and lost with Trips of Tens
Seat 4: GBG57018 (button) showed [Kc Ad] and won 132310 with Straight Ace high


Winamax Poker - Tournament "SKENIGMA Payant A" buyIn: 1.80€ + 0.20€ level: 13 - HandId: #3069735365515411459-60-1701121532 - Holdem no limit (250/1000/2000) - 2023/11/27 21:45:32 UTC
Table: 'SKENIGMA Payant A(714728461)#02' 7-max (real money) Seat #5 is the button
Seat 3: P1xel7 (11053)
Seat 4: GBG57018 (132310)
Seat 5: mataberrant (56637)
*** ANTE/BLINDS ***
P1xel7 posts ante 250
GBG57018 posts ante 250
mataberrant posts ante 250
P1xel7 posts small blind 1000
GBG57018 posts big blind 2000
Dealt to P1xel7 [5d 2d]
*** PRE-FLOP *** 
mataberrant raises 2000 to 4000
P1xel7 folds
GBG57018 folds
mataberrant collected 7750 from pot
*** SUMMARY ***
Total pot 7750 | No rake
Seat 5: mataberrant (button) won 7750


Winamax Poker - Tournament "SKENIGMA Payant A" buyIn: 1.80€ + 0.20€ level: 13 - HandId: #3069735365515411459-61-1701121540 - Holdem no limit (250/1000/2000) - 2023/11/27 21:45:40 UTC
Table: 'SKENIGMA Payant A(714728461)#02' 7-max (real money) Seat #3 is the button
Seat 3: P1xel7 (9803)
Seat 4: GBG57018 (130060)
Seat 5: mataberrant (60137)
*** ANTE/BLINDS ***
GBG57018 posts ante 250
mataberrant posts ante 250
P1xel7 posts ante 250
GBG57018 posts small blind 1000
mataberrant posts big blind 2000
Dealt to P1xel7 [Qd Ah]
*** PRE-FLOP *** 
P1xel7 raises 7553 to 9553 and is all-in
GBG57018 folds
mataberrant calls 7553
*** FLOP *** [3d 4s 4h]
*** TURN *** [3d 4s 4h][7d]
*** RIVER *** [3d 4s 4h 7d][Td]
*** SHOW DOWN ***
mataberrant shows [As 5h] (One pair : 4)
P1xel7 shows [Qd Ah] (One pair : 4)
P1xel7 collected 20856 from pot
*** SUMMARY ***
Total pot 20856 | No rake
Board: [3d 4s 4h 7d Td]
Seat 3: P1xel7 (button) showed [Qd Ah] and won 20856 with One pair : 4
Seat 5: mataberrant (big blind) showed [As 5h] and lost with One pair : 4


Winamax Poker - Tournament "SKENIGMA Payant A" buyIn: 1.80€ + 0.20€ level: 13 - HandId: #3069735365515411459-62-1701121554 - Holdem no limit (250/1000/2000) - 2023/11/27 21:45:54 UTC
Table: 'SKENIGMA Payant A(714728461)#02' 7-max (real money) Seat #4 is the button
Seat 3: P1xel7 (20856)
Seat 4: GBG57018 (128810)
Seat 5: mataberrant (50334)
*** ANTE/BLINDS ***
mataberrant posts ante 250
P1xel7 posts ante 250
GBG57018 posts ante 250
mataberrant posts small blind 1000
P1xel7 posts big blind 2000
Dealt to P1xel7 [5d 7c]
*** PRE-FLOP *** 
GBG57018 folds
mataberrant calls 1000
P1xel7 checks
*** FLOP *** [As 8c 6d]
mataberrant checks
P1xel7 bets 18606 and is all-in
mataberrant folds
P1xel7 collected 23356 from pot
*** SUMMARY ***
Total pot 23356 | No rake
Board: [As 8c 6d]
Seat 3: P1xel7 (big blind) won 23356


Winamax Poker - Tournament "SKENIGMA Payant A" buyIn: 1.80€ + 0.20€ level: 13 - HandId: #3069735365515411459-63-1701121575 - Holdem no limit (250/1000/2000) - 2023/11/27 21:46:15 UTC
Table: 'SKENIGMA Payant A(714728461)#02' 7-max (real money) Seat #5 is the button
Seat 3: P1xel7 (23356)
Seat 4: GBG57018 (128560)
Seat 5: mataberrant (48084)
*** ANTE/BLINDS ***
P1xel7 posts ante 250
GBG57018 posts ante 250
mataberrant posts ante 250
P1xel7 posts small blind 1000
GBG57018 posts big blind 2000
Dealt to P1xel7 [9c 9s]
*** PRE-FLOP *** 
mataberrant folds
P1xel7 raises 21106 to 23106 and is all-in
GBG57018 folds
P1xel7 collected 25856 from pot
*** SUMMARY ***
Total pot 25856 | No rake
Seat 3: P1xel7 (small blind) won 25856


Winamax Poker - Tournament "SKENIGMA Payant A" buyIn: 1.80€ + 0.20€ level: 13 - HandId: #3069735365515411459-64-1701121584 - Holdem no limit (250/1000/2000) - 2023/11/27 21:46:24 UTC
Table: 'SKENIGMA Payant A(714728461)#02' 7-max (real money) Seat #3 is the button
Seat 3: P1xel7 (25856)
Seat 4: GBG57018 (126310)
Seat 5: mataberrant (47834)
*** ANTE/BLINDS ***
GBG57018 posts ante 250
mataberrant posts ante 250
P1xel7 posts ante 250
GBG57018 posts small blind 1000
mataberrant posts big blind 2000
Dealt to P1xel7 [Jd 9c]
*** PRE-FLOP *** 
P1xel7 folds
GBG57018 folds
mataberrant collected 3750 from pot
*** SUMMARY ***
Total pot 3750 | No rake
Seat 5: mataberrant (big blind) won 3750


Winamax Poker - Tournament "SKENIGMA Payant A" buyIn: 1.80€ + 0.20€ level: 13 - HandId: #3069735365515411459-65-1701121590 - Holdem no limit (250/1000/2000) - 2023/11/27 21:46:30 UTC
Table: 'SKENIGMA Payant A(714728461)#02' 7-max (real money) Seat #4 is the button
Seat 3: P1xel7 (25606)
Seat 4: GBG57018 (125060)
Seat 5: mataberrant (49334)
*** ANTE/BLINDS ***
mataberrant posts ante 250
P1xel7 posts ante 250
GBG57018 posts ante 250
mataberrant posts small blind 1000
P1xel7 posts big blind 2000
Dealt to P1xel7 [Kh 7c]
*** PRE-FLOP *** 
GBG57018 folds
mataberrant calls 1000
P1xel7 checks
*** FLOP *** [5d 9d Js]
mataberrant bets 3000
P1xel7 folds
mataberrant collected 7750 from pot
*** SUMMARY ***
Total pot 7750 | No rake
Board: [5d 9d Js]
Seat 5: mataberrant (small blind) won 7750


Winamax Poker - Tournament "SKENIGMA Payant A" buyIn: 1.80€ + 0.20€ level: 13 - HandId: #3069735365515411459-66-1701121604 - Holdem no limit (250/1000/2000) - 2023/11/27 21:46:44 UTC
Table: 'SKENIGMA Payant A(714728461)#02' 7-max (real money) Seat #5 is the button
Seat 3: P1xel7 (23356)
Seat 4: GBG57018 (124810)
Seat 5: mataberrant (51834)
*** ANTE/BLINDS ***
P1xel7 posts ante 250
GBG57018 posts ante 250
mataberrant posts ante 250
P1xel7 posts small blind 1000
GBG57018 posts big blind 2000
Dealt to P1xel7 [Ts Kc]
*** PRE-FLOP *** 
mataberrant raises 3000 to 5000
P1xel7 folds
GBG57018 calls 3000
*** FLOP *** [6h 6d 3c]
GBG57018 checks
mataberrant bets 3938
GBG57018 calls 3938
*** TURN *** [6h 6d 3c][2d]
GBG57018 checks
mataberrant bets 6869
GBG57018 calls 6869
*** RIVER *** [6h 6d 3c 2d][Tc]
GBG57018 checks
mataberrant checks
*** SHOW DOWN ***
GBG57018 shows [8c Kh] (One pair : 6)
mataberrant shows [Ah Qc] (One pair : 6)
mataberrant collected 33364 from pot
*** SUMMARY ***
Total pot 33364 | No rake
Board: [6h 6d 3c 2d Tc]
Seat 4: GBG57018 (big blind) showed [8c Kh] and lost with One pair : 6
Seat 5: mataberrant (button) showed [Ah Qc] and won 33364 with One pair : 6


Winamax Poker - Tournament "SKENIGMA Payant A" buyIn: 1.80€ + 0.20€ level: 13 - HandId: #3069735365515411459-67-1701121633 - Holdem no limit (250/1000/2000) - 2023/11/27 21:47:13 UTC
Table: 'SKENIGMA Payant A(714728461)#02' 7-max (real money) Seat #3 is the button
Seat 3: P1xel7 (22106)
Seat 4: GBG57018 (108753)
Seat 5: mataberrant (69141)
*** ANTE/BLINDS ***
GBG57018 posts ante 250
mataberrant posts ante 250
P1xel7 posts ante 250
GBG57018 posts small blind 1000
mataberrant posts big blind 2000
Dealt to P1xel7 [3h Td]
*** PRE-FLOP *** 
P1xel7 folds
GBG57018 folds
mataberrant collected 3750 from pot
*** SUMMARY ***
Total pot 3750 | No rake
Seat 5: mataberrant (big blind) won 3750


Winamax Poker - Tournament "SKENIGMA Payant A" buyIn: 1.80€ + 0.20€ level: 13 - HandId: #3069735365515411459-68-1701121637 - Holdem no limit (250/1000/2000) - 2023/11/27 21:47:17 UTC
Table: 'SKENIGMA Payant A(714728461)#02' 7-max (real money) Seat #4 is the button
Seat 3: P1xel7 (21856)
Seat 4: GBG57018 (107503)
Seat 5: mataberrant (70641)
*** ANTE/BLINDS ***
mataberrant posts ante 250
P1xel7 posts ante 250
GBG57018 posts ante 250
mataberrant posts small blind 1000
P1xel7 posts big blind 2000
Dealt to P1xel7 [7c Kh]
*** PRE-FLOP *** 
GBG57018 folds
mataberrant calls 1000
P1xel7 checks
*** FLOP *** [9d 6d 4c]
mataberrant checks
P1xel7 checks
*** TURN *** [9d 6d 4c][Td]
mataberrant bets 2000
P1xel7 folds
mataberrant collected 6750 from pot
*** SUMMARY ***
Total pot 6750 | No rake
Board: [9d 6d 4c Td]
Seat 5: mataberrant (small blind) won 6750


Winamax Poker - Tournament "SKENIGMA Payant A" buyIn: 1.80€ + 0.20€ level: 13 - HandId: #3069735365515411459-69-1701121653 - Holdem no limit (250/1000/2000) - 2023/11/27 21:47:33 UTC
Table: 'SKENIGMA Payant A(714728461)#02' 7-max (real money) Seat #5 is the button
Seat 3: P1xel7 (19606)
Seat 4: GBG57018 (107253)
Seat 5: mataberrant (73141)
*** ANTE/BLINDS ***
P1xel7 posts ante 250
GBG57018 posts ante 250
mataberrant posts ante 250
P1xel7 posts small blind 1000
GBG57018 posts big blind 2000
Dealt to P1xel7 [4s 5s]
*** PRE-FLOP *** 
mataberrant raises 2000 to 4000
P1xel7 folds
GBG57018 calls 2000
*** FLOP *** [4c 6d Jd]
GBG57018 checks
mataberrant checks
*** TURN *** [4c 6d Jd][3h]
GBG57018 bets 4875
mataberrant raises 5875 to 10750
GBG57018 folds
mataberrant collected 25375 from pot
*** SUMMARY ***
Total pot 25375 | No rake
Board: [4c 6d Jd 3h]
Seat 5: mataberrant (button) won 25375


Winamax Poker - Tournament "SKENIGMA Payant A" buyIn: 1.80€ + 0.20€ level: 13 - HandId: #3069735365515411459-70-1701121718 - Holdem no limit (250/1000/2000) - 2023/11/27 21:48:38 UTC
Table: 'SKENIGMA Payant A(714728461)#02' 7-max (real money) Seat #3 is the button
Seat 3: P1xel7 (18356)
Seat 4: GBG57018 (98128)
Seat 5: mataberrant (83516)
*** ANTE/BLINDS ***
GBG57018 posts ante 250
mataberrant posts ante 250
P1xel7 posts ante 250
GBG57018 posts small blind 1000
mataberrant posts big blind 2000
Dealt to P1xel7 [6d 6c]
*** PRE-FLOP *** 
P1xel7 raises 16106 to 18106 and is all-in
GBG57018 folds
mataberrant folds
P1xel7 collected 21856 from pot
*** SUMMARY ***
Total pot 21856 | No rake
Seat 3: P1xel7 (button) won 21856


Winamax Poker - Tournament "SKENIGMA Payant A" buyIn: 1.80€ + 0.20€ level: 13 - HandId: #3069735365515411459-71-1701121728 - Holdem no limit (250/1000/2000) - 2023/11/27 21:48:48 UTC
Table: 'SKENIGMA Payant A(714728461)#02' 7-max (real money) Seat #4 is the button
Seat 3: P1xel7 (21856)
Seat 4: GBG57018 (96878)
Seat 5: mataberrant (81266)
*** ANTE/BLINDS ***
mataberrant posts ante 250
P1xel7 posts ante 250
GBG57018 posts ante 250
mataberrant posts small blind 1000
P1xel7 posts big blind 2000
Dealt to P1xel7 [2s 9s]
*** PRE-FLOP *** 
GBG57018 folds
mataberrant calls 1000
P1xel7 checks
*** FLOP *** [Qd 8s 3h]
mataberrant bets 2000
P1xel7 folds
mataberrant collected 6750 from pot
*** SUMMARY ***
Total pot 6750 | No rake
Board: [Qd 8s 3h]
Seat 5: mataberrant (small blind) won 6750


Winamax Poker - Tournament "SKENIGMA Payant A" buyIn: 1.80€ + 0.20€ level: 13 - HandId: #3069735365515411459-72-1701121737 - Holdem no limit (250/1000/2000) - 2023/11/27 21:48:57 UTC
Table: 'SKENIGMA Payant A(714728461)#02' 7-max (real money) Seat #5 is the button
Seat 3: P1xel7 (19606)
Seat 4: GBG57018 (96628)
Seat 5: mataberrant (83766)
*** ANTE/BLINDS ***
P1xel7 posts ante 250
GBG57018 posts ante 250
mataberrant posts ante 250
P1xel7 posts small blind 1000
GBG57018 posts big blind 2000
Dealt to P1xel7 [5h 5d]
*** PRE-FLOP *** 
mataberrant raises 2000 to 4000
P1xel7 raises 15356 to 19356 and is all-in
GBG57018 folds
mataberrant calls 15356
*** FLOP *** [Qs Ks Jd]
*** TURN *** [Qs Ks Jd][Jc]
*** RIVER *** [Qs Ks Jd Jc][6c]
*** SHOW DOWN ***
mataberrant shows [Ad 3d] (One pair : Jacks)
P1xel7 shows [5h 5d] (Two pairs : Jacks and 5)
P1xel7 collected 41462 from pot
*** SUMMARY ***
Total pot 41462 | No rake
Board: [Qs Ks Jd Jc 6c]
Seat 3: P1xel7 (small blind) showed [5h 5d] and won 41462 with Two pairs : Jacks and 5
Seat 5: mataberrant (button) showed [Ad 3d] and lost with One pair : Jacks


Winamax Poker - Tournament "SKENIGMA Payant A" buyIn: 1.80€ + 0.20€ level: 13 - HandId: #3069735365515411459-73-1701121752 - Holdem no limit (250/1000/2000) - 2023/11/27 21:49:12 UTC
Table: 'SKENIGMA Payant A(714728461)#02' 7-max (real money) Seat #3 is the button
Seat 3: P1xel7 (41462)
Seat 4: GBG57018 (94378)
Seat 5: mataberrant (64160)
*** ANTE/BLINDS ***
GBG57018 posts ante 250
mataberrant posts ante 250
P1xel7 posts ante 250
GBG57018 posts small blind 1000
mataberrant posts big blind 2000
Dealt to P1xel7 [3c 7h]
*** PRE-FLOP *** 
P1xel7 folds
GBG57018 raises 2000 to 4000
mataberrant calls 2000
*** FLOP *** [9h Qh As]
GBG57018 bets 4375
mataberrant folds
GBG57018 collected 13125 from pot
*** SUMMARY ***
Total pot 13125 | No rake
Board: [9h Qh As]
Seat 4: GBG57018 (small blind) won 13125


Winamax Poker - Tournament "SKENIGMA Payant A" buyIn: 1.80€ + 0.20€ level: 13 - HandId: #3069735365515411459-74-1701121765 - Holdem no limit (250/1000/2000) - 2023/11/27 21:49:25 UTC
Table: 'SKENIGMA Payant A(714728461)#02' 7-max (real money) Seat #4 is the button
Seat 3: P1xel7 (41212)
Seat 4: GBG57018 (98878)
Seat 5: mataberrant (59910)
*** ANTE/BLINDS ***
mataberrant posts ante 250
P1xel7 posts ante 250
GBG57018 posts ante 250
mataberrant posts small blind 1000
P1xel7 posts big blind 2000
Dealt to P1xel7 [6d 8s]
*** PRE-FLOP *** 
GBG57018 raises 2000 to 4000
mataberrant calls 3000
P1xel7 folds
*** FLOP *** [4c 3c Kd]
mataberrant checks
GBG57018 checks
*** TURN *** [4c 3c Kd][Ac]
mataberrant bets 4000
GBG57018 calls 4000
*** RIVER *** [4c 3c Kd Ac][5c]
mataberrant checks
GBG57018 bets 4688
mataberrant folds
GBG57018 collected 23438 from pot
*** SUMMARY ***
Total pot 23438 | No rake
Board: [4c 3c Kd Ac 5c]
Seat 4: GBG57018 (button) won 23438


Winamax Poker - Tournament "SKENIGMA Payant A" buyIn: 1.80€ + 0.20€ level: 14 - HandId: #3069735365515411459-75-1701121807 - Holdem no limit (300/1250/2500) - 2023/11/27 21:50:07 UTC
Table: 'SKENIGMA Payant A(714728461)#02' 7-max (real money) Seat #5 is the button
Seat 3: P1xel7 (38962)
Seat 4: GBG57018 (109378)
Seat 5: mataberrant (51660)
*** ANTE/BLINDS ***
P1xel7 posts ante 300
GBG57018 posts ante 300
mataberrant posts ante 300
P1xel7 posts small blind 1250
GBG57018 posts big blind 2500
Dealt to P1xel7 [5s 7d]
*** PRE-FLOP *** 
mataberrant folds
P1xel7 folds
GBG57018 collected 4650 from pot
*** SUMMARY ***
Total pot 4650 | No rake
Seat 4: GBG57018 (big blind) won 4650


Winamax Poker - Tournament "SKENIGMA Payant A" buyIn: 1.80€ + 0.20€ level: 14 - HandId: #3069735365515411459-76-1701121815 - Holdem no limit (300/1250/2500) - 2023/11/27 21:50:15 UTC
Table: 'SKENIGMA Payant A(714728461)#02' 7-max (real money) Seat #3 is the button
Seat 3: P1xel7 (37412)
Seat 4: GBG57018 (111228)
Seat 5: mataberrant (51360)
*** ANTE/BLINDS ***
GBG57018 posts ante 300
mataberrant posts ante 300
P1xel7 posts ante 300
GBG57018 posts small blind 1250
mataberrant posts big blind 2500
Dealt to P1xel7 [Ah 4s]
*** PRE-FLOP *** 
P1xel7 folds
GBG57018 folds
mataberrant collected 4650 from pot
*** SUMMARY ***
Total pot 4650 | No rake
Seat 5: mataberrant (big blind) won 4650


Winamax Poker - Tournament "SKENIGMA Payant A" buyIn: 1.80€ + 0.20€ level: 14 - HandId: #3069735365515411459-77-1701121823 - Holdem no limit (300/1250/2500) - 2023/11/27 21:50:23 UTC
Table: 'SKENIGMA Payant A(714728461)#02' 7-max (real money) Seat #4 is the button
Seat 3: P1xel7 (37112)
Seat 4: GBG57018 (109678)
Seat 5: mataberrant (53210)
*** ANTE/BLINDS ***
mataberrant posts ante 300
P1xel7 posts ante 300
GBG57018 posts ante 300
mataberrant posts small blind 1250
P1xel7 posts big blind 2500
Dealt to P1xel7 [Jc 4h]
*** PRE-FLOP *** 
GBG57018 raises 2500 to 5000
mataberrant folds
P1xel7 folds
GBG57018 collected 9650 from pot
*** SUMMARY ***
Total pot 9650 | No rake
Seat 4: GBG57018 (button) won 9650


Winamax Poker - Tournament "SKENIGMA Payant A" buyIn: 1.80€ + 0.20€ level: 14 - HandId: #3069735365515411459-78-1701121829 - Holdem no limit (300/1250/2500) - 2023/11/27 21:50:29 UTC
Table: 'SKENIGMA Payant A(714728461)#02' 7-max (real money) Seat #5 is the button
Seat 3: P1xel7 (34312)
Seat 4: GBG57018 (114028)
Seat 5: mataberrant (51660)
*** ANTE/BLINDS ***
P1xel7 posts ante 300
GBG57018 posts ante 300
mataberrant posts ante 300
P1xel7 posts small blind 1250
GBG57018 posts big blind 2500
Dealt to P1xel7 [Ah Qc]
*** PRE-FLOP *** 
mataberrant folds
P1xel7 raises 3750 to 6250
GBG57018 folds
P1xel7 collected 9650 from pot
*** SUMMARY ***
Total pot 9650 | No rake
Seat 3: P1xel7 (small blind) won 9650


Winamax Poker - Tournament "SKENIGMA Payant A" buyIn: 1.80€ + 0.20€ level: 14 - HandId: #3069735365515411459-79-1701121836 - Holdem no limit (300/1250/2500) - 2023/11/27 21:50:36 UTC
Table: 'SKENIGMA Payant A(714728461)#02' 7-max (real money) Seat #3 is the button
Seat 3: P1xel7 (37412)
Seat 4: GBG57018 (111228)
Seat 5: mataberrant (51360)
*** ANTE/BLINDS ***
GBG57018 posts ante 300
mataberrant posts ante 300
P1xel7 posts ante 300
GBG57018 posts small blind 1250
mataberrant posts big blind 2500
Dealt to P1xel7 [Tc Ts]
*** PRE-FLOP *** 
P1xel7 raises 3000 to 5500
GBG57018 folds
mataberrant calls 3000
*** FLOP *** [6c 6h 7c]
mataberrant bets 3750
P1xel7 raises 27862 to 31612 and is all-in
mataberrant folds
P1xel7 collected 48512 from pot
*** SUMMARY ***
Total pot 48512 | No rake
Board: [6c 6h 7c]
Seat 3: P1xel7 (button) won 48512


Winamax Poker - Tournament "SKENIGMA Payant A" buyIn: 1.80€ + 0.20€ level: 14 - HandId: #3069735365515411459-80-1701121860 - Holdem no limit (300/1250/2500) - 2023/11/27 21:51:00 UTC
Table: 'SKENIGMA Payant A(714728461)#02' 7-max (real money) Seat #4 is the button
Seat 3: P1xel7 (48512)
Seat 4: GBG57018 (109678)
Seat 5: mataberrant (41810)
*** ANTE/BLINDS ***
mataberrant posts ante 300
P1xel7 posts ante 300
GBG57018 posts ante 300
mataberrant posts small blind 1250
P1xel7 posts big blind 2500
Dealt to P1xel7 [5d 4c]
*** PRE-FLOP *** 
GBG57018 raises 2500 to 5000
mataberrant raises 36510 to 41510 and is all-in
P1xel7 folds
GBG57018 folds
mataberrant collected 49910 from pot
*** SUMMARY ***
Total pot 49910 | No rake
Seat 5: mataberrant (small blind) won 49910


Winamax Poker - Tournament "SKENIGMA Payant A" buyIn: 1.80€ + 0.20€ level: 14 - HandId: #3069735365515411459-81-1701121869 - Holdem no limit (300/1250/2500) - 2023/11/27 21:51:09 UTC
Table: 'SKENIGMA Payant A(714728461)#02' 7-max (real money) Seat #5 is the button
Seat 3: P1xel7 (45712)
Seat 4: GBG57018 (104378)
Seat 5: mataberrant (49910)
*** ANTE/BLINDS ***
P1xel7 posts ante 300
GBG57018 posts ante 300
mataberrant posts ante 300
P1xel7 posts small blind 1250
GBG57018 posts big blind 2500
Dealt to P1xel7 [2s 7d]
*** PRE-FLOP *** 
mataberrant raises 2500 to 5000
P1xel7 folds
GBG57018 calls 2500
*** FLOP *** [7c Qc Tc]
GBG57018 checks
mataberrant bets 3750
GBG57018 calls 3750
*** TURN *** [7c Qc Tc][Ac]
GBG57018 checks
mataberrant bets 6878
GBG57018 calls 6878
*** RIVER *** [7c Qc Tc Ac][Qh]
GBG57018 checks
mataberrant bets 21714
GBG57018 raises 66736 to 88450 and is all-in
mataberrant calls 12268 and is all-in
*** SHOW DOWN ***
GBG57018 shows [Jc 8s] (Flush Ace high)
mataberrant shows [Kc Qd] (Flush Ace high)
mataberrant collected 101370 from main pot
GBG57018 collected 54468 from side pot 1
*** SUMMARY ***
Total pot 155838 | No rake
Board: [7c Qc Tc Ac Qh]
Seat 4: GBG57018 (big blind) showed [Jc 8s] and won 54468 with Flush Ace high
Seat 5: mataberrant (button) showed [Kc Qd] and won 101370 with Flush Ace high


Winamax Poker - Tournament "SKENIGMA Payant A" buyIn: 1.80€ + 0.20€ level: 14 - HandId: #3069735365515411459-82-1701121902 - Holdem no limit (300/1250/2500) - 2023/11/27 21:51:42 UTC
Table: 'SKENIGMA Payant A(714728461)#02' 7-max (real money) Seat #3 is the button
Seat 3: P1xel7 (44162)
Seat 4: GBG57018 (54468)
Seat 5: mataberrant (101370)
*** ANTE/BLINDS ***
GBG57018 posts ante 300
mataberrant posts ante 300
P1xel7 posts ante 300
GBG57018 posts small blind 1250
mataberrant posts big blind 2500
Dealt to P1xel7 [8d Jc]
*** PRE-FLOP *** 
P1xel7 folds
GBG57018 folds
mataberrant collected 4650 from pot
*** SUMMARY ***
Total pot 4650 | No rake
Seat 5: mataberrant (big blind) won 4650


Winamax Poker - Tournament "SKENIGMA Payant A" buyIn: 1.80€ + 0.20€ level: 14 - HandId: #3069735365515411459-83-1701121908 - Holdem no limit (300/1250/2500) - 2023/11/27 21:51:48 UTC
Table: 'SKENIGMA Payant A(714728461)#02' 7-max (real money) Seat #4 is the button
Seat 3: P1xel7 (43862)
Seat 4: GBG57018 (52918)
Seat 5: mataberrant (103220)
*** ANTE/BLINDS ***
mataberrant posts ante 300
P1xel7 posts ante 300
GBG57018 posts ante 300
mataberrant posts small blind 1250
P1xel7 posts big blind 2500
Dealt to P1xel7 [6c Th]
*** PRE-FLOP *** 
GBG57018 raises 50118 to 52618 and is all-in
mataberrant folds
P1xel7 folds
GBG57018 collected 57268 from pot
*** SUMMARY ***
Total pot 57268 | No rake
Seat 4: GBG57018 (button) won 57268


Winamax Poker - Tournament "SKENIGMA Payant A" buyIn: 1.80€ + 0.20€ level: 14 - HandId: #3069735365515411459-84-1701121916 - Holdem no limit (300/1250/2500) - 2023/11/27 21:51:56 UTC
Table: 'SKENIGMA Payant A(714728461)#02' 7-max (real money) Seat #5 is the button
Seat 3: P1xel7 (41062)
Seat 4: GBG57018 (57268)
Seat 5: mataberrant (101670)
*** ANTE/BLINDS ***
P1xel7 posts ante 300
GBG57018 posts ante 300
mataberrant posts ante 300
P1xel7 posts small blind 1250
GBG57018 posts big blind 2500
Dealt to P1xel7 [5c 4h]
*** PRE-FLOP *** 
mataberrant raises 2500 to 5000
P1xel7 folds
GBG57018 raises 51968 to 56968 and is all-in
mataberrant folds
GBG57018 collected 64118 from pot
*** SUMMARY ***
Total pot 64118 | No rake
Seat 4: GBG57018 (big blind) won 64118


Winamax Poker - Tournament "SKENIGMA Payant A" buyIn: 1.80€ + 0.20€ level: 14 - HandId: #3069735365515411459-85-1701121941 - Holdem no limit (300/1250/2500) - 2023/11/27 21:52:21 UTC
Table: 'SKENIGMA Payant A(714728461)#02' 7-max (real money) Seat #3 is the button
Seat 3: P1xel7 (39512)
Seat 4: GBG57018 (64118)
Seat 5: mataberrant (96370)
*** ANTE/BLINDS ***
GBG57018 posts ante 300
mataberrant posts ante 300
P1xel7 posts ante 300
GBG57018 posts small blind 1250
mataberrant posts big blind 2500
Dealt to P1xel7 [9c Jc]
*** PRE-FLOP *** 
P1xel7 raises 3000 to 5500
GBG57018 folds
mataberrant folds
P1xel7 collected 10150 from pot
*** SUMMARY ***
Total pot 10150 | No rake
Seat 3: P1xel7 (button) won 10150


Winamax Poker - Tournament "SKENIGMA Payant A" buyIn: 1.80€ + 0.20€ level: 14 - HandId: #3069735365515411459-86-1701121952 - Holdem no limit (300/1250/2500) - 2023/11/27 21:52:32 UTC
Table: 'SKENIGMA Payant A(714728461)#02' 7-max (real money) Seat #4 is the button
Seat 3: P1xel7 (43862)
Seat 4: GBG57018 (62568)
Seat 5: mataberrant (93570)
*** ANTE/BLINDS ***
mataberrant posts ante 300
P1xel7 posts ante 300
GBG57018 posts ante 300
mataberrant posts small blind 1250
P1xel7 posts big blind 2500
Dealt to P1xel7 [9c Kh]
*** PRE-FLOP *** 
GBG57018 folds
mataberrant folds
P1xel7 collected 4650 from pot
*** SUMMARY ***
Total pot 4650 | No rake
Seat 3: P1xel7 (big blind) won 4650


Winamax Poker - Tournament "SKENIGMA Payant A" buyIn: 1.80€ + 0.20€ level: 14 - HandId: #3069735365515411459-87-1701121958 - Holdem no limit (300/1250/2500) - 2023/11/27 21:52:38 UTC
Table: 'SKENIGMA Payant A(714728461)#02' 7-max (real money) Seat #5 is the button
Seat 3: P1xel7 (45712)
Seat 4: GBG57018 (62268)
Seat 5: mataberrant (92020)
*** ANTE/BLINDS ***
P1xel7 posts ante 300
GBG57018 posts ante 300
mataberrant posts ante 300
P1xel7 posts small blind 1250
GBG57018 posts big blind 2500
Dealt to P1xel7 [7d 3d]
*** PRE-FLOP *** 
mataberrant folds
P1xel7 folds
GBG57018 collected 4650 from pot
*** SUMMARY ***
Total pot 4650 | No rake
Seat 4: GBG57018 (big blind) won 4650


Winamax Poker - Tournament "SKENIGMA Payant A" buyIn: 1.80€ + 0.20€ level: 14 - HandId: #3069735365515411459-88-1701121965 - Holdem no limit (300/1250/2500) - 2023/11/27 21:52:45 UTC
Table: 'SKENIGMA Payant A(714728461)#02' 7-max (real money) Seat #3 is the button
Seat 3: P1xel7 (44162)
Seat 4: GBG57018 (64118)
Seat 5: mataberrant (91720)
*** ANTE/BLINDS ***
GBG57018 posts ante 300
mataberrant posts ante 300
P1xel7 posts ante 300
GBG57018 posts small blind 1250
mataberrant posts big blind 2500
Dealt to P1xel7 [9d Qh]
*** PRE-FLOP *** 
P1xel7 folds
GBG57018 raises 61318 to 63818 and is all-in
mataberrant folds
GBG57018 collected 67218 from pot
*** SUMMARY ***
Total pot 67218 | No rake
Seat 4: GBG57018 (small blind) won 67218


Winamax Poker - Tournament "SKENIGMA Payant A" buyIn: 1.80€ + 0.20€ level: 14 - HandId: #3069735365515411459-89-1701121973 - Holdem no limit (300/1250/2500) - 2023/11/27 21:52:53 UTC
Table: 'SKENIGMA Payant A(714728461)#02' 7-max (real money) Seat #4 is the button
Seat 3: P1xel7 (43862)
Seat 4: GBG57018 (67218)
Seat 5: mataberrant (88920)
*** ANTE/BLINDS ***
mataberrant posts ante 300
P1xel7 posts ante 300
GBG57018 posts ante 300
mataberrant posts small blind 1250
P1xel7 posts big blind 2500
Dealt to P1xel7 [8d Kd]
*** PRE-FLOP *** 
GBG57018 calls 2500
mataberrant raises 3750 to 6250
P1xel7 folds
GBG57018 raises 60668 to 66918 and is all-in
mataberrant folds
GBG57018 collected 76568 from pot
*** SUMMARY ***
Total pot 76568 | No rake
Seat 4: GBG57018 (button) won 76568


Winamax Poker - Tournament "SKENIGMA Payant A" buyIn: 1.80€ + 0.20€ level: 14 - HandId: #3069735365515411459-90-1701121989 - Holdem no limit (300/1250/2500) - 2023/11/27 21:53:09 UTC
Table: 'SKENIGMA Payant A(714728461)#02' 7-max (real money) Seat #5 is the button
Seat 3: P1xel7 (41062)
Seat 4: GBG57018 (76568)
Seat 5: mataberrant (82370)
*** ANTE/BLINDS ***
P1xel7 posts ante 300
GBG57018 posts ante 300
mataberrant posts ante 300
P1xel7 posts small blind 1250
GBG57018 posts big blind 2500
Dealt to P1xel7 [Js 8d]
*** PRE-FLOP *** 
mataberrant folds
P1xel7 folds
GBG57018 collected 4650 from pot
*** SUMMARY ***
Total pot 4650 | No rake
Seat 4: GBG57018 (big blind) won 4650


Winamax Poker - Tournament "SKENIGMA Payant A" buyIn: 1.80€ + 0.20€ level: 14 - HandId: #3069735365515411459-91-1701121996 - Holdem no limit (300/1250/2500) - 2023/11/27 21:53:16 UTC
Table: 'SKENIGMA Payant A(714728461)#02' 7-max (real money) Seat #3 is the button
Seat 3: P1xel7 (39512)
Seat 4: GBG57018 (78418)
Seat 5: mataberrant (82070)
*** ANTE/BLINDS ***
GBG57018 posts ante 300
mataberrant posts ante 300
P1xel7 posts ante 300
GBG57018 posts small blind 1250
mataberrant posts big blind 2500
Dealt to P1xel7 [9h 3s]
*** PRE-FLOP *** 
P1xel7 folds
GBG57018 raises 2500 to 5000
mataberrant calls 2500
*** FLOP *** [Ac Kh 6c]
GBG57018 bets 3815
mataberrant calls 3815
*** TURN *** [Ac Kh 6c][4h]
GBG57018 bets 9265
mataberrant folds
GBG57018 collected 27795 from pot
*** SUMMARY ***
Total pot 27795 | No rake
Board: [Ac Kh 6c 4h]
Seat 4: GBG57018 (small blind) won 27795


Winamax Poker - Tournament "SKENIGMA Payant A" buyIn: 1.80€ + 0.20€ level: 14 - HandId: #3069735365515411459-92-1701122033 - Holdem no limit (300/1250/2500) - 2023/11/27 21:53:53 UTC
Table: 'SKENIGMA Payant A(714728461)#02' 7-max (real money) Seat #4 is the button
Seat 3: P1xel7 (39212)
Seat 4: GBG57018 (87833)
Seat 5: mataberrant (72955)
*** ANTE/BLINDS ***
mataberrant posts ante 300
P1xel7 posts ante 300
GBG57018 posts ante 300
mataberrant posts small blind 1250
P1xel7 posts big blind 2500
Dealt to P1xel7 [3d 6c]
*** PRE-FLOP *** 
GBG57018 folds
mataberrant raises 2500 to 5000
P1xel7 folds
mataberrant collected 8400 from pot
*** SUMMARY ***
Total pot 8400 | No rake
Seat 5: mataberrant (small blind) won 8400


Winamax Poker - Tournament "SKENIGMA Payant A" buyIn: 1.80€ + 0.20€ level: 14 - HandId: #3069735365515411459-93-1701122042 - Holdem no limit (300/1250/2500) - 2023/11/27 21:54:02 UTC
Table: 'SKENIGMA Payant A(714728461)#02' 7-max (real money) Seat #5 is the button
Seat 3: P1xel7 (36412)
Seat 4: GBG57018 (87533)
Seat 5: mataberrant (76055)
*** ANTE/BLINDS ***
P1xel7 posts ante 300
GBG57018 posts ante 300
mataberrant posts ante 300
P1xel7 posts small blind 1250
GBG57018 posts big blind 2500
Dealt to P1xel7 [5d Kd]
*** PRE-FLOP *** 
mataberrant raises 2500 to 5000
P1xel7 folds
GBG57018 folds
mataberrant collected 9650 from pot
*** SUMMARY ***
Total pot 9650 | No rake
Seat 5: mataberrant (button) won 9650


Winamax Poker - Tournament "SKENIGMA Payant A" buyIn: 1.80€ + 0.20€ level: 14 - HandId: #3069735365515411459-94-1701122057 - Holdem no limit (300/1250/2500) - 2023/11/27 21:54:17 UTC
Table: 'SKENIGMA Payant A(714728461)#02' 7-max (real money) Seat #3 is the button
Seat 3: P1xel7 (34862)
Seat 4: GBG57018 (84733)
Seat 5: mataberrant (80405)
*** ANTE/BLINDS ***
GBG57018 posts ante 300
mataberrant posts ante 300
P1xel7 posts ante 300
GBG57018 posts small blind 1250
mataberrant posts big blind 2500
Dealt to P1xel7 [3h 5d]
*** PRE-FLOP *** 
P1xel7 folds
GBG57018 folds
mataberrant collected 4650 from pot
*** SUMMARY ***
Total pot 4650 | No rake
Seat 5: mataberrant (big blind) won 4650


Winamax Poker - Tournament "SKENIGMA Payant A" buyIn: 1.80€ + 0.20€ level: 14 - HandId: #3069735365515411459-95-1701122064 - Holdem no limit (300/1250/2500) - 2023/11/27 21:54:24 UTC
Table: 'SKENIGMA Payant A(714728461)#02' 7-max (real money) Seat #4 is the button
Seat 3: P1xel7 (34562)
Seat 4: GBG57018 (83183)
Seat 5: mataberrant (82255)
*** ANTE/BLINDS ***
mataberrant posts ante 300
P1xel7 posts ante 300
GBG57018 posts ante 300
mataberrant posts small blind 1250
P1xel7 posts big blind 2500
Dealt to P1xel7 [Th 7h]
*** PRE-FLOP *** 
GBG57018 raises 2500 to 5000
mataberrant folds
P1xel7 folds
GBG57018 collected 9650 from pot
*** SUMMARY ***
Total pot 9650 | No rake
Seat 4: GBG57018 (button) won 9650


Winamax Poker - Tournament "SKENIGMA Payant A" buyIn: 1.80€ + 0.20€ level: 14 - HandId: #3069735365515411459-96-1701122076 - Holdem no limit (300/1250/2500) - 2023/11/27 21:54:36 UTC
Table: 'SKENIGMA Payant A(714728461)#02' 7-max (real money) Seat #5 is the button
Seat 3: P1xel7 (31762)
Seat 4: GBG57018 (87533)
Seat 5: mataberrant (80705)
*** ANTE/BLINDS ***
P1xel7 posts ante 300
GBG57018 posts ante 300
mataberrant posts ante 300
P1xel7 posts small blind 1250
GBG57018 posts big blind 2500
Dealt to P1xel7 [9h 6h]
*** PRE-FLOP *** 
mataberrant raises 2500 to 5000
P1xel7 folds
GBG57018 folds
mataberrant collected 9650 from pot
*** SUMMARY ***
Total pot 9650 | No rake
Seat 5: mataberrant (button) won 9650


Winamax Poker - Tournament "SKENIGMA Payant A" buyIn: 1.80€ + 0.20€ level: 14 - HandId: #3069735365515411459-97-1701122084 - Holdem no limit (300/1250/2500) - 2023/11/27 21:54:44 UTC
Table: 'SKENIGMA Payant A(714728461)#02' 7-max (real money) Seat #3 is the button
Seat 3: P1xel7 (30212)
Seat 4: GBG57018 (84733)
Seat 5: mataberrant (85055)
*** ANTE/BLINDS ***
GBG57018 posts ante 300
mataberrant posts ante 300
P1xel7 posts ante 300
GBG57018 posts small blind 1250
mataberrant posts big blind 2500
Dealt to P1xel7 [4c 6s]
*** PRE-FLOP *** 
P1xel7 folds
GBG57018 raises 2500 to 5000
mataberrant folds
GBG57018 collected 8400 from pot
*** SUMMARY ***
Total pot 8400 | No rake
Seat 4: GBG57018 (small blind) won 8400


Winamax Poker - Tournament "SKENIGMA Payant A" buyIn: 1.80€ + 0.20€ level: 14 - HandId: #3069735365515411459-98-1701122094 - Holdem no limit (300/1250/2500) - 2023/11/27 21:54:54 UTC
Table: 'SKENIGMA Payant A(714728461)#02' 7-max (real money) Seat #4 is the button
Seat 3: P1xel7 (29912)
Seat 4: GBG57018 (87833)
Seat 5: mataberrant (82255)
*** ANTE/BLINDS ***
mataberrant posts ante 300
P1xel7 posts ante 300
GBG57018 posts ante 300
mataberrant posts small blind 1250
P1xel7 posts big blind 2500
Dealt to P1xel7 [Ah Ac]
*** PRE-FLOP *** 
GBG57018 folds
mataberrant calls 1250
P1xel7 raises 3000 to 5500
mataberrant calls 3000
*** FLOP *** [6c 9s 9c]
mataberrant checks
P1xel7 bets 5950
mataberrant raises 70505 to 76455 and is all-in
P1xel7 calls 18162 and is all-in
*** TURN *** [6c 9s 9c][7h]
*** RIVER *** [6c 9s 9c 7h][8c]
*** SHOW DOWN ***
P1xel7 shows [Ah Ac] (Two pairs : Aces and 9)
mataberrant shows [Ts 6s] (Straight Ten high)
mataberrant collected 112467 from pot
*** SUMMARY ***
Total pot 112467 | No rake
Board: [6c 9s 9c 7h 8c]
Seat 3: P1xel7 (big blind) showed [Ah Ac] and lost with Two pairs : Aces and 9
Seat 5: mataberrant (small blind) showed [Ts 6s] and won 112467 with Straight Ten high


