Winamax Poker - Tournament "Starting Block WiPT - Déglingos" buyIn: 0€ + 0€ level: 1 - HandId: #3211145767871840257-1-1706122587 - Holdem no limit (10/20) - 2024/01/24 18:56:27 UTC
Table: 'Starting Block WiPT - Déglingos(747653136)#0' 6-max (real money) Seat #2 is the button
Seat 1: eirinn33 (500)
Seat 2: PRZ13 (500)
Seat 3: Teamtacooss (500)
Seat 4: Alexnya661oo (500)
Seat 5: P1xel7 (500)
Seat 6: Samoht_D (500)
*** ANTE/BLINDS ***
Teamtacooss posts small blind 10
Alexnya661oo posts big blind 20
Dealt to P1xel7 [8d Th]
*** PRE-FLOP *** 
P1xel7 folds
Samoht_D folds
eirinn33 raises 30 to 50
PRZ13 raises 450 to 500 and is all-in
Teamtacooss folds
Alexnya661oo folds
eirinn33 calls 450 and is all-in
*** FLOP *** [4c 7c 8c]
*** TURN *** [4c 7c 8c][3h]
*** RIVER *** [4c 7c 8c 3h][2h]
*** SHOW DOWN ***
eirinn33 shows [9h Ad] (High card : Ace)
PRZ13 shows [6c 8s] (One pair : 8)
PRZ13 collected 1030 from pot
*** SUMMARY ***
Total pot 1030 | No rake
Board: [4c 7c 8c 3h 2h]
Seat 1: eirinn33 showed [9h Ad] and lost with High card : Ace
Seat 2: PRZ13 (button) showed [6c 8s] and won 1030 with One pair : 8


Winamax Poker - Tournament "Starting Block WiPT - Déglingos" buyIn: 0€ + 0€ level: 1 - HandId: #3211145767871840257-2-1706122661 - Holdem no limit (10/20) - 2024/01/24 18:57:41 UTC
Table: 'Starting Block WiPT - Déglingos(747653136)#0' 6-max (real money) Seat #3 is the button
Seat 2: PRZ13 (1030)
Seat 3: Teamtacooss (490)
Seat 4: Alexnya661oo (480)
Seat 5: P1xel7 (500)
Seat 6: Samoht_D (500)
*** ANTE/BLINDS ***
Alexnya661oo posts small blind 10
P1xel7 posts big blind 20
Dealt to P1xel7 [7s 2c]
*** PRE-FLOP *** 
Samoht_D raises 480 to 500 and is all-in
PRZ13 raises 530 to 1030 and is all-in
Teamtacooss folds
Alexnya661oo calls 470 and is all-in
P1xel7 folds
*** FLOP *** [4s Qd 4c]
*** TURN *** [4s Qd 4c][Qc]
*** RIVER *** [4s Qd 4c Qc][8d]
*** SHOW DOWN ***
Alexnya661oo shows [Jc 7h] (Two pairs : Queens and 4)
Samoht_D shows [Ad Tc] (Two pairs : Queens and 4)
PRZ13 shows [Ah Qh] (Full of Queens and 4)
PRZ13 collected 2030 from pot
*** SUMMARY ***
Total pot 2030 | No rake
Board: [4s Qd 4c Qc 8d]
Seat 2: PRZ13 showed [Ah Qh] and won 2030 with Full of Queens and 4
Seat 4: Alexnya661oo (small blind) showed [Jc 7h] and lost with Two pairs : Queens and 4
Seat 6: Samoht_D showed [Ad Tc] and lost with Two pairs : Queens and 4


Winamax Poker - Tournament "Starting Block WiPT - Déglingos" buyIn: 0€ + 0€ level: 2 - HandId: #3211145767871840257-3-1706122677 - Holdem no limit (15/30) - 2024/01/24 18:57:57 UTC
Table: 'Starting Block WiPT - Déglingos(747653136)#0' 6-max (real money) Seat #4 is the button
Seat 2: PRZ13 (2030)
Seat 3: Teamtacooss (490)
Seat 5: P1xel7 (480)
*** ANTE/BLINDS ***
P1xel7 posts small blind 15
PRZ13 posts big blind 30
Dealt to P1xel7 [Ac 7s]
*** PRE-FLOP *** 
Teamtacooss calls 30
P1xel7 folds
PRZ13 checks
*** FLOP *** [9h Ad 4h]
PRZ13 bets 30
Teamtacooss calls 30
*** TURN *** [9h Ad 4h][5d]
PRZ13 bets 30
Teamtacooss calls 30
*** RIVER *** [9h Ad 4h 5d][Td]
PRZ13 bets 127
Teamtacooss folds
PRZ13 collected 322 from pot
*** SUMMARY ***
Total pot 322 | No rake
Board: [9h Ad 4h 5d Td]
Seat 2: PRZ13 (big blind) won 322


Winamax Poker - Tournament "Starting Block WiPT - Déglingos" buyIn: 0€ + 0€ level: 2 - HandId: #3211145767871840257-4-1706122721 - Holdem no limit (15/30) - 2024/01/24 18:58:41 UTC
Table: 'Starting Block WiPT - Déglingos(747653136)#0' 6-max (real money) Seat #5 is the button
Seat 2: PRZ13 (2135)
Seat 3: Teamtacooss (400)
Seat 5: P1xel7 (465)
*** ANTE/BLINDS ***
PRZ13 posts small blind 15
Teamtacooss posts big blind 30
Dealt to P1xel7 [8h 7c]
*** PRE-FLOP *** 
P1xel7 folds
PRZ13 raises 30 to 60
Teamtacooss folds
PRZ13 collected 90 from pot
*** SUMMARY ***
Total pot 90 | No rake
Seat 2: PRZ13 (small blind) won 90


Winamax Poker - Tournament "Starting Block WiPT - Déglingos" buyIn: 0€ + 0€ level: 2 - HandId: #3211145767871840257-5-1706122734 - Holdem no limit (15/30) - 2024/01/24 18:58:54 UTC
Table: 'Starting Block WiPT - Déglingos(747653136)#0' 6-max (real money) Seat #2 is the button
Seat 2: PRZ13 (2165)
Seat 3: Teamtacooss (370)
Seat 5: P1xel7 (465)
*** ANTE/BLINDS ***
Teamtacooss posts small blind 15
P1xel7 posts big blind 30
Dealt to P1xel7 [6h 8s]
*** PRE-FLOP *** 
PRZ13 calls 30
Teamtacooss folds
P1xel7 checks
*** FLOP *** [Ts 5c Ks]
P1xel7 checks
PRZ13 bets 45
P1xel7 folds
PRZ13 collected 120 from pot
*** SUMMARY ***
Total pot 120 | No rake
Board: [Ts 5c Ks]
Seat 2: PRZ13 (button) won 120


Winamax Poker - Tournament "Starting Block WiPT - Déglingos" buyIn: 0€ + 0€ level: 2 - HandId: #3211145767871840257-6-1706122753 - Holdem no limit (15/30) - 2024/01/24 18:59:13 UTC
Table: 'Starting Block WiPT - Déglingos(747653136)#0' 6-max (real money) Seat #3 is the button
Seat 2: PRZ13 (2210)
Seat 3: Teamtacooss (355)
Seat 5: P1xel7 (435)
*** ANTE/BLINDS ***
P1xel7 posts small blind 15
PRZ13 posts big blind 30
Dealt to P1xel7 [5s 3c]
*** PRE-FLOP *** 
Teamtacooss raises 325 to 355 and is all-in
P1xel7 folds
PRZ13 calls 325
*** FLOP *** [9h 3d Tc]
*** TURN *** [9h 3d Tc][Ts]
*** RIVER *** [9h 3d Tc Ts][7d]
*** SHOW DOWN ***
Teamtacooss shows [Ks Jh] (One pair : Tens)
PRZ13 shows [6h Th] (Trips of Tens)
PRZ13 collected 725 from pot
*** SUMMARY ***
Total pot 725 | No rake
Board: [9h 3d Tc Ts 7d]
Seat 2: PRZ13 (big blind) showed [6h Th] and won 725 with Trips of Tens
Seat 3: Teamtacooss (button) showed [Ks Jh] and lost with One pair : Tens


Winamax Poker - Tournament "Starting Block WiPT - Déglingos" buyIn: 0€ + 0€ level: 3 - HandId: #3211145767871840257-7-1706122777 - Holdem no limit (20/40) - 2024/01/24 18:59:37 UTC
Table: 'Starting Block WiPT - Déglingos(747653136)#0' 6-max (real money) Seat #2 is the button
Seat 2: PRZ13 (2580)
Seat 5: P1xel7 (420)
*** ANTE/BLINDS ***
PRZ13 posts small blind 20
P1xel7 posts big blind 40
Dealt to P1xel7 [8d Kc]
*** PRE-FLOP *** 
PRZ13 calls 20
P1xel7 checks
*** FLOP *** [6d Tc 3c]
P1xel7 checks
PRZ13 checks
*** TURN *** [6d Tc 3c][Js]
P1xel7 checks
PRZ13 checks
*** RIVER *** [6d Tc 3c Js][2s]
P1xel7 checks
PRZ13 checks
*** SHOW DOWN ***
PRZ13 shows [4s Qc] (High card : Queen)
P1xel7 shows [8d Kc] (High card : King)
P1xel7 collected 80 from pot
*** SUMMARY ***
Total pot 80 | No rake
Board: [6d Tc 3c Js 2s]
Seat 2: PRZ13 (small blind) (button) showed [4s Qc] and lost with High card : Queen
Seat 5: P1xel7 (big blind) showed [8d Kc] and won 80 with High card : King


Winamax Poker - Tournament "Starting Block WiPT - Déglingos" buyIn: 0€ + 0€ level: 3 - HandId: #3211145767871840257-8-1706122797 - Holdem no limit (20/40) - 2024/01/24 18:59:57 UTC
Table: 'Starting Block WiPT - Déglingos(747653136)#0' 6-max (real money) Seat #5 is the button
Seat 2: PRZ13 (2540)
Seat 5: P1xel7 (460)
*** ANTE/BLINDS ***
P1xel7 posts small blind 20
PRZ13 posts big blind 40
Dealt to P1xel7 [5s 2s]
*** PRE-FLOP *** 
P1xel7 folds
PRZ13 collected 60 from pot
*** SUMMARY ***
Total pot 60 | No rake
Seat 2: PRZ13 (big blind) won 60


Winamax Poker - Tournament "Starting Block WiPT - Déglingos" buyIn: 0€ + 0€ level: 3 - HandId: #3211145767871840257-9-1706122800 - Holdem no limit (20/40) - 2024/01/24 19:00:00 UTC
Table: 'Starting Block WiPT - Déglingos(747653136)#0' 6-max (real money) Seat #2 is the button
Seat 2: PRZ13 (2560)
Seat 5: P1xel7 (440)
*** ANTE/BLINDS ***
PRZ13 posts small blind 20
P1xel7 posts big blind 40
Dealt to P1xel7 [9c Th]
*** PRE-FLOP *** 
PRZ13 calls 20
P1xel7 checks
*** FLOP *** [5d 6d 8d]
P1xel7 checks
PRZ13 bets 40
P1xel7 folds
PRZ13 collected 120 from pot
*** SUMMARY ***
Total pot 120 | No rake
Board: [5d 6d 8d]
Seat 2: PRZ13 (small blind) (button) won 120


Winamax Poker - Tournament "Starting Block WiPT - Déglingos" buyIn: 0€ + 0€ level: 3 - HandId: #3211145767871840257-10-1706122841 - Holdem no limit (20/40) - 2024/01/24 19:00:41 UTC
Table: 'Starting Block WiPT - Déglingos(747653136)#0' 6-max (real money) Seat #5 is the button
Seat 2: PRZ13 (2600)
Seat 5: P1xel7 (400)
*** ANTE/BLINDS ***
P1xel7 posts small blind 20
PRZ13 posts big blind 40
Dealt to P1xel7 [Ac 7c]
*** PRE-FLOP *** 
P1xel7 raises 360 to 400 and is all-in
PRZ13 calls 360
*** FLOP *** [7d 3d 4h]
*** TURN *** [7d 3d 4h][7s]
*** RIVER *** [7d 3d 4h 7s][2d]
*** SHOW DOWN ***
PRZ13 shows [9c Jh] (One pair : 7)
P1xel7 shows [Ac 7c] (Trips of 7)
P1xel7 collected 800 from pot
*** SUMMARY ***
Total pot 800 | No rake
Board: [7d 3d 4h 7s 2d]
Seat 2: PRZ13 (big blind) showed [9c Jh] and lost with One pair : 7
Seat 5: P1xel7 (small blind) (button) showed [Ac 7c] and won 800 with Trips of 7


Winamax Poker - Tournament "Starting Block WiPT - Déglingos" buyIn: 0€ + 0€ level: 4 - HandId: #3211145767871840257-11-1706122857 - Holdem no limit (30/60) - 2024/01/24 19:00:57 UTC
Table: 'Starting Block WiPT - Déglingos(747653136)#0' 6-max (real money) Seat #2 is the button
Seat 2: PRZ13 (2200)
Seat 5: P1xel7 (800)
*** ANTE/BLINDS ***
PRZ13 posts small blind 30
P1xel7 posts big blind 60
Dealt to P1xel7 [Qs 8s]
*** PRE-FLOP *** 
PRZ13 raises 60 to 120
P1xel7 calls 60
*** FLOP *** [3s 5c 9h]
P1xel7 checks
PRZ13 checks
*** TURN *** [3s 5c 9h][3c]
P1xel7 checks
PRZ13 checks
*** RIVER *** [3s 5c 9h 3c][Qh]
P1xel7 bets 120
PRZ13 calls 120
*** SHOW DOWN ***
PRZ13 shows [Qc 4c] (Two pairs : Queens and 3)
P1xel7 shows [Qs 8s] (Two pairs : Queens and 3)
P1xel7 collected 240 from pot
PRZ13 collected 240 from pot
*** SUMMARY ***
Total pot 480 | No rake
Board: [3s 5c 9h 3c Qh]
Seat 2: PRZ13 (small blind) (button) showed [Qc 4c] and won 240 with Two pairs : Queens and 3
Seat 5: P1xel7 (big blind) showed [Qs 8s] and won 240 with Two pairs : Queens and 3


Winamax Poker - Tournament "Starting Block WiPT - Déglingos" buyIn: 0€ + 0€ level: 4 - HandId: #3211145767871840257-12-1706122885 - Holdem no limit (30/60) - 2024/01/24 19:01:25 UTC
Table: 'Starting Block WiPT - Déglingos(747653136)#0' 6-max (real money) Seat #5 is the button
Seat 2: PRZ13 (2200)
Seat 5: P1xel7 (800)
*** ANTE/BLINDS ***
P1xel7 posts small blind 30
PRZ13 posts big blind 60
Dealt to P1xel7 [Js 7s]
*** PRE-FLOP *** 
P1xel7 folds
PRZ13 collected 90 from pot
*** SUMMARY ***
Total pot 90 | No rake
Seat 2: PRZ13 (big blind) won 90


Winamax Poker - Tournament "Starting Block WiPT - Déglingos" buyIn: 0€ + 0€ level: 4 - HandId: #3211145767871840257-13-1706122889 - Holdem no limit (30/60) - 2024/01/24 19:01:29 UTC
Table: 'Starting Block WiPT - Déglingos(747653136)#0' 6-max (real money) Seat #2 is the button
Seat 2: PRZ13 (2230)
Seat 5: P1xel7 (770)
*** ANTE/BLINDS ***
PRZ13 posts small blind 30
P1xel7 posts big blind 60
Dealt to P1xel7 [Ks Th]
*** PRE-FLOP *** 
PRZ13 calls 30
P1xel7 raises 710 to 770 and is all-in
PRZ13 calls 710
*** FLOP *** [Jc Qs 7h]
*** TURN *** [Jc Qs 7h][6c]
*** RIVER *** [Jc Qs 7h 6c][Qd]
*** SHOW DOWN ***
P1xel7 shows [Ks Th] (One pair : Queens)
PRZ13 shows [7d 6h] (Two pairs : Queens and 7)
PRZ13 collected 1540 from pot
*** SUMMARY ***
Total pot 1540 | No rake
Board: [Jc Qs 7h 6c Qd]
Seat 2: PRZ13 (small blind) (button) showed [7d 6h] and won 1540 with Two pairs : Queens and 7
Seat 5: P1xel7 (big blind) showed [Ks Th] and lost with One pair : Queens


