Winamax Poker - Tournament "W SERIES GIANT KO - DAY 1" buyIn: 1.80€ + 0.20€ level: 2 - HandId: #3106533163543822514-28-1705349307 - Holdem no limit (14/60/120) - 2024/01/15 20:08:27 UTC
Table: 'W SERIES GIANT KO - DAY 1(723296116)#0177' 6-max (real money) Seat #6 is the button
Seat 1: Astaeth (27617, 1.35€ bounty)
Seat 2: Haizek (9684, 0.90€ bounty)
Seat 3: jos920 (9440, 0.90€ bounty)
Seat 4: P1xel7 (7689, 0.90€ bounty)
Seat 5: Lavanti (7153, 0.90€ bounty)
Seat 6: Mazel Bob (8731, 0.90€ bounty)
*** ANTE/BLINDS ***
Astaeth posts ante 14
Haizek posts ante 14
jos920 posts ante 14
P1xel7 posts ante 14
Lavanti posts ante 14
Mazel Bob posts ante 14
Astaeth posts small blind 60
Haizek posts big blind 120
Dealt to P1xel7 [9h Js]
*** PRE-FLOP *** 
jos920 folds
P1xel7 folds
Lavanti raises 157 to 277
Mazel Bob folds
Astaeth folds
Haizek calls 157
*** FLOP *** [Jh Jc Jd]
Haizek checks
Lavanti checks
*** TURN *** [Jh Jc Jd][9s]
Haizek checks
Lavanti checks
*** RIVER *** [Jh Jc Jd 9s][9d]
Haizek checks
Lavanti checks
*** SHOW DOWN ***
Haizek shows [Kc 8h] (Full of Jacks and 9)
Lavanti shows [Qh As] (Full of Jacks and 9)
Lavanti collected 349 from pot
Haizek collected 349 from pot
*** SUMMARY ***
Total pot 698 | No rake
Board: [Jh Jc Jd 9s 9d]
Seat 2: Haizek (big blind) showed [Kc 8h] and won 349 with Full of Jacks and 9
Seat 5: Lavanti showed [Qh As] and won 349 with Full of Jacks and 9


Winamax Poker - Tournament "W SERIES GIANT KO - DAY 1" buyIn: 1.80€ + 0.20€ level: 2 - HandId: #3106533163543822514-29-1705349369 - Holdem no limit (14/60/120) - 2024/01/15 20:09:29 UTC
Table: 'W SERIES GIANT KO - DAY 1(723296116)#0177' 6-max (real money) Seat #1 is the button
Seat 1: Astaeth (27543, 1.35€ bounty)
Seat 2: Haizek (9742, 0.90€ bounty)
Seat 3: jos920 (9426, 0.90€ bounty)
Seat 4: P1xel7 (7675, 0.90€ bounty)
Seat 5: Lavanti (7211, 0.90€ bounty)
Seat 6: Mazel Bob (8717, 0.90€ bounty)
*** ANTE/BLINDS ***
Haizek posts ante 14
jos920 posts ante 14
Astaeth posts ante 14
P1xel7 posts ante 14
Lavanti posts ante 14
Mazel Bob posts ante 14
Haizek posts small blind 60
jos920 posts big blind 120
Dealt to P1xel7 [Th 4h]
*** PRE-FLOP *** 
P1xel7 folds
Lavanti raises 120 to 240
Mazel Bob calls 240
Astaeth calls 240
Haizek raises 120 to 360
jos920 folds
Lavanti calls 120
Mazel Bob calls 120
Astaeth calls 120
*** FLOP *** [4d 2s 6h]
Haizek checks
Lavanti checks
Mazel Bob bets 2400
Astaeth folds
Haizek folds
Lavanti folds
Mazel Bob collected 4044 from pot
*** SUMMARY ***
Total pot 4044 | No rake
Board: [4d 2s 6h]
Seat 6: Mazel Bob won 4044


Winamax Poker - Tournament "W SERIES GIANT KO - DAY 1" buyIn: 1.80€ + 0.20€ level: 2 - HandId: #3106533163543822514-30-1705349476 - Holdem no limit (14/60/120) - 2024/01/15 20:11:16 UTC
Table: 'W SERIES GIANT KO - DAY 1(723296116)#0177' 6-max (real money) Seat #2 is the button
Seat 1: Astaeth (27169, 1.35€ bounty)
Seat 2: Haizek (9368, 0.90€ bounty)
Seat 3: jos920 (9292, 0.90€ bounty)
Seat 4: P1xel7 (7661, 0.90€ bounty)
Seat 5: Lavanti (6837, 0.90€ bounty)
Seat 6: Mazel Bob (9987, 0.90€ bounty)
*** ANTE/BLINDS ***
jos920 posts ante 14
P1xel7 posts ante 14
Astaeth posts ante 14
Haizek posts ante 14
Lavanti posts ante 14
Mazel Bob posts ante 14
jos920 posts small blind 60
P1xel7 posts big blind 120
Dealt to P1xel7 [4c 3c]
*** PRE-FLOP *** 
Lavanti folds
Mazel Bob folds
Astaeth raises 150 to 270
Haizek folds
jos920 folds
P1xel7 calls 150
*** FLOP *** [Th 7c As]
P1xel7 checks
Astaeth bets 239
P1xel7 folds
Astaeth collected 923 from pot
*** SUMMARY ***
Total pot 923 | No rake
Board: [Th 7c As]
Seat 1: Astaeth won 923


Winamax Poker - Tournament "W SERIES GIANT KO - DAY 1" buyIn: 1.80€ + 0.20€ level: 2 - HandId: #3106533163543822514-31-1705349532 - Holdem no limit (14/60/120) - 2024/01/15 20:12:12 UTC
Table: 'W SERIES GIANT KO - DAY 1(723296116)#0177' 6-max (real money) Seat #3 is the button
Seat 1: Astaeth (27569, 1.35€ bounty)
Seat 2: Haizek (9354, 0.90€ bounty)
Seat 3: jos920 (9218, 0.90€ bounty)
Seat 4: P1xel7 (7377, 0.90€ bounty)
Seat 5: Lavanti (6823, 0.90€ bounty)
Seat 6: Mazel Bob (9973, 0.90€ bounty)
*** ANTE/BLINDS ***
P1xel7 posts ante 14
Lavanti posts ante 14
Astaeth posts ante 14
Haizek posts ante 14
jos920 posts ante 14
Mazel Bob posts ante 14
P1xel7 posts small blind 60
Lavanti posts big blind 120
Dealt to P1xel7 [9c 4c]
*** PRE-FLOP *** 
Mazel Bob folds
Astaeth raises 150 to 270
Haizek folds
jos920 calls 270
P1xel7 folds
Lavanti calls 150
*** FLOP *** [Qs 7c 4d]
Lavanti checks
Astaeth checks
jos920 bets 288
Lavanti calls 288
Astaeth folds
*** TURN *** [Qs 7c 4d][Jc]
Lavanti checks
jos920 checks
*** RIVER *** [Qs 7c 4d Jc][Th]
Lavanti checks
jos920 checks
*** SHOW DOWN ***
Lavanti shows [9s 4s] (One pair : 4)
jos920 shows [Jh Kh] (One pair : Jacks)
jos920 collected 1530 from pot
*** SUMMARY ***
Total pot 1530 | No rake
Board: [Qs 7c 4d Jc Th]
Seat 3: jos920 (button) showed [Jh Kh] and won 1530 with One pair : Jacks
Seat 5: Lavanti (big blind) showed [9s 4s] and lost with One pair : 4


Winamax Poker - Tournament "W SERIES GIANT KO - DAY 1" buyIn: 1.80€ + 0.20€ level: 2 - HandId: #3106533163543822514-32-1705349623 - Holdem no limit (14/60/120) - 2024/01/15 20:13:43 UTC
Table: 'W SERIES GIANT KO - DAY 1(723296116)#0177' 6-max (real money) Seat #4 is the button
Seat 1: Astaeth (27285, 1.35€ bounty)
Seat 2: Haizek (9340, 0.90€ bounty)
Seat 3: jos920 (10176, 0.90€ bounty)
Seat 4: P1xel7 (7303, 0.90€ bounty)
Seat 5: Lavanti (6251, 0.90€ bounty)
Seat 6: Mazel Bob (9959, 0.90€ bounty)
*** ANTE/BLINDS ***
Lavanti posts ante 14
Mazel Bob posts ante 14
Astaeth posts ante 14
Haizek posts ante 14
jos920 posts ante 14
P1xel7 posts ante 14
Lavanti posts small blind 60
Mazel Bob posts big blind 120
Dealt to P1xel7 [Qh Ah]
*** PRE-FLOP *** 
Astaeth raises 120 to 240
Haizek folds
jos920 folds
P1xel7 raises 480 to 720
Lavanti folds
Mazel Bob folds
Astaeth calls 480
*** FLOP *** [4c Ks 9c]
Astaeth bets 596
P1xel7 folds
Astaeth collected 2300 from pot
*** SUMMARY ***
Total pot 2300 | No rake
Board: [4c Ks 9c]
Seat 1: Astaeth won 2300


Winamax Poker - Tournament "W SERIES GIANT KO - DAY 1" buyIn: 1.80€ + 0.20€ level: 2 - HandId: #3106533163543822514-33-1705349703 - Holdem no limit (14/60/120) - 2024/01/15 20:15:03 UTC
Table: 'W SERIES GIANT KO - DAY 1(723296116)#0177' 6-max (real money) Seat #5 is the button
Seat 1: Astaeth (28255, 1.35€ bounty)
Seat 3: jos920 (10162, 0.90€ bounty)
Seat 4: P1xel7 (6569, 0.90€ bounty)
Seat 5: Lavanti (6177, 0.90€ bounty)
Seat 6: Mazel Bob (9825, 0.90€ bounty)
*** ANTE/BLINDS ***
Mazel Bob posts ante 14
Astaeth posts ante 14
jos920 posts ante 14
P1xel7 posts ante 14
Lavanti posts ante 14
Mazel Bob posts small blind 60
Astaeth posts big blind 120
Dealt to P1xel7 [5s 3c]
*** PRE-FLOP *** 
jos920 raises 150 to 270
P1xel7 folds
Lavanti raises 330 to 600
Mazel Bob folds
Astaeth folds
jos920 calls 330
*** FLOP *** [8d 4c 8c]
jos920 checks
Lavanti bets 725
jos920 calls 725
*** TURN *** [8d 4c 8c][4s]
jos920 checks
Lavanti bets 1450
jos920 calls 1450
*** RIVER *** [8d 4c 8c 4s][Qc]
jos920 checks
Lavanti checks
*** SHOW DOWN ***
jos920 shows [5c 5h] (Two pairs : 8 and 5)
Lavanti shows [As Ac] (Two pairs : Aces and 8)
Lavanti collected 5800 from pot
*** SUMMARY ***
Total pot 5800 | No rake
Board: [8d 4c 8c 4s Qc]
Seat 3: jos920 showed [5c 5h] and lost with Two pairs : 8 and 5
Seat 5: Lavanti (button) showed [As Ac] and won 5800 with Two pairs : Aces and 8


Winamax Poker - Tournament "W SERIES GIANT KO - DAY 1" buyIn: 1.80€ + 0.20€ level: 2 - HandId: #3106533163543822514-34-1705349789 - Holdem no limit (14/60/120) - 2024/01/15 20:16:29 UTC
Table: 'W SERIES GIANT KO - DAY 1(723296116)#0177' 6-max (real money) Seat #6 is the button
Seat 1: Astaeth (28121, 1.35€ bounty)
Seat 2: ortegato93 (10000, 0.90€ bounty)
Seat 3: jos920 (7373, 0.90€ bounty)
Seat 4: P1xel7 (6555, 0.90€ bounty)
Seat 5: Lavanti (9188, 0.90€ bounty)
Seat 6: Mazel Bob (9751, 0.90€ bounty)
*** ANTE/BLINDS ***
Astaeth posts ante 14
ortegato93 posts ante 14
jos920 posts ante 14
P1xel7 posts ante 14
Lavanti posts ante 14
Mazel Bob posts ante 14
Astaeth posts small blind 60
ortegato93 posts big blind 120
Dealt to P1xel7 [Td Qd]
*** PRE-FLOP *** 
jos920 folds
P1xel7 raises 180 to 300
Lavanti folds
Mazel Bob folds
Astaeth folds
ortegato93 calls 180
*** FLOP *** [6d 9d 9c]
ortegato93 checks
P1xel7 checks
*** TURN *** [6d 9d 9c][6h]
ortegato93 checks
P1xel7 checks
*** RIVER *** [6d 9d 9c 6h][9h]
ortegato93 checks
P1xel7 bets 595
ortegato93 folds
P1xel7 collected 1339 from pot
*** SUMMARY ***
Total pot 1339 | No rake
Board: [6d 9d 9c 6h 9h]
Seat 4: P1xel7 won 1339


Winamax Poker - Tournament "W SERIES GIANT KO - DAY 1" buyIn: 1.80€ + 0.20€ level: 3 - HandId: #3106533163543822514-35-1705349856 - Holdem no limit (16/70/140) - 2024/01/15 20:17:36 UTC
Table: 'W SERIES GIANT KO - DAY 1(723296116)#0177' 6-max (real money) Seat #1 is the button
Seat 1: Astaeth (28047, 1.35€ bounty)
Seat 2: ortegato93 (9686, 0.90€ bounty)
Seat 3: jos920 (7359, 0.90€ bounty)
Seat 4: P1xel7 (6985, 0.90€ bounty)
Seat 5: Lavanti (9174, 0.90€ bounty)
Seat 6: Mazel Bob (9737, 0.90€ bounty)
*** ANTE/BLINDS ***
ortegato93 posts ante 16
jos920 posts ante 16
Astaeth posts ante 16
P1xel7 posts ante 16
Lavanti posts ante 16
Mazel Bob posts ante 16
ortegato93 posts small blind 70
jos920 posts big blind 140
Dealt to P1xel7 [6c 8d]
*** PRE-FLOP *** 
P1xel7 folds
Lavanti folds
Mazel Bob calls 140
Astaeth folds
ortegato93 calls 70
jos920 checks
*** FLOP *** [6s Qc Ad]
ortegato93 checks
jos920 checks
Mazel Bob bets 280
ortegato93 calls 280
jos920 folds
*** TURN *** [6s Qc Ad][4d]
ortegato93 checks
Mazel Bob checks
*** RIVER *** [6s Qc Ad 4d][Qd]
ortegato93 bets 861
Mazel Bob folds
ortegato93 collected 1937 from pot
*** SUMMARY ***
Total pot 1937 | No rake
Board: [6s Qc Ad 4d Qd]
Seat 2: ortegato93 (small blind) won 1937


Winamax Poker - Tournament "W SERIES GIANT KO - DAY 1" buyIn: 1.80€ + 0.20€ level: 3 - HandId: #3106533163543822514-36-1705349942 - Holdem no limit (16/70/140) - 2024/01/15 20:19:02 UTC
Table: 'W SERIES GIANT KO - DAY 1(723296116)#0177' 6-max (real money) Seat #2 is the button
Seat 1: Astaeth (28031, 1.35€ bounty)
Seat 2: ortegato93 (10326, 0.90€ bounty)
Seat 3: jos920 (7203, 0.90€ bounty)
Seat 4: P1xel7 (6969, 0.90€ bounty)
Seat 5: Lavanti (9158, 0.90€ bounty)
Seat 6: Mazel Bob (9301, 0.90€ bounty)
*** ANTE/BLINDS ***
jos920 posts ante 16
P1xel7 posts ante 16
Astaeth posts ante 16
ortegato93 posts ante 16
Lavanti posts ante 16
Mazel Bob posts ante 16
jos920 posts small blind 70
P1xel7 posts big blind 140
Dealt to P1xel7 [7c Tc]
*** PRE-FLOP *** 
Lavanti raises 140 to 280
Mazel Bob folds
Astaeth folds
ortegato93 folds
jos920 folds
P1xel7 calls 140
*** FLOP *** [3h 7h 2c]
P1xel7 checks
Lavanti bets 363
P1xel7 calls 363
*** TURN *** [3h 7h 2c][Jc]
P1xel7 checks
Lavanti checks
*** RIVER *** [3h 7h 2c Jc][5s]
P1xel7 checks
Lavanti checks
*** SHOW DOWN ***
Lavanti shows [Ah 8d] (High card : Ace)
P1xel7 shows [7c Tc] (One pair : 7)
P1xel7 collected 1452 from pot
*** SUMMARY ***
Total pot 1452 | No rake
Board: [3h 7h 2c Jc 5s]
Seat 4: P1xel7 (big blind) showed [7c Tc] and won 1452 with One pair : 7
Seat 5: Lavanti showed [Ah 8d] and lost with High card : Ace


Winamax Poker - Tournament "W SERIES GIANT KO - DAY 1" buyIn: 1.80€ + 0.20€ level: 3 - HandId: #3106533163543822514-37-1705350036 - Holdem no limit (16/70/140) - 2024/01/15 20:20:36 UTC
Table: 'W SERIES GIANT KO - DAY 1(723296116)#0177' 6-max (real money) Seat #3 is the button
Seat 1: Astaeth (28015, 1.35€ bounty)
Seat 2: ortegato93 (10310, 0.90€ bounty)
Seat 3: jos920 (7117, 0.90€ bounty)
Seat 4: P1xel7 (7762, 0.90€ bounty)
Seat 5: Lavanti (8499, 0.90€ bounty)
Seat 6: Mazel Bob (9285, 0.90€ bounty)
*** ANTE/BLINDS ***
P1xel7 posts ante 16
Lavanti posts ante 16
Astaeth posts ante 16
ortegato93 posts ante 16
jos920 posts ante 16
Mazel Bob posts ante 16
P1xel7 posts small blind 70
Lavanti posts big blind 140
Dealt to P1xel7 [5d 2h]
*** PRE-FLOP *** 
Mazel Bob raises 630 to 770
Astaeth folds
ortegato93 folds
jos920 folds
P1xel7 folds
Lavanti folds
Mazel Bob collected 1076 from pot
*** SUMMARY ***
Total pot 1076 | No rake
Seat 6: Mazel Bob won 1076


Winamax Poker - Tournament "W SERIES GIANT KO - DAY 1" buyIn: 1.80€ + 0.20€ level: 3 - HandId: #3106533163543822514-38-1705350068 - Holdem no limit (16/70/140) - 2024/01/15 20:21:08 UTC
Table: 'W SERIES GIANT KO - DAY 1(723296116)#0177' 6-max (real money) Seat #4 is the button
Seat 1: Astaeth (27999, 1.35€ bounty)
Seat 2: ortegato93 (10294, 0.90€ bounty)
Seat 3: jos920 (7101, 0.90€ bounty)
Seat 4: P1xel7 (7676, 0.90€ bounty)
Seat 5: Lavanti (8343, 0.90€ bounty)
Seat 6: Mazel Bob (9575, 0.90€ bounty)
*** ANTE/BLINDS ***
Lavanti posts ante 16
Mazel Bob posts ante 16
Astaeth posts ante 16
ortegato93 posts ante 16
jos920 posts ante 16
P1xel7 posts ante 16
Lavanti posts small blind 70
Mazel Bob posts big blind 140
Dealt to P1xel7 [2c 9d]
*** PRE-FLOP *** 
Astaeth raises 175 to 315
ortegato93 folds
jos920 folds
P1xel7 folds
Lavanti folds
Mazel Bob folds
Astaeth collected 621 from pot
*** SUMMARY ***
Total pot 621 | No rake
Seat 1: Astaeth won 621


Winamax Poker - Tournament "W SERIES GIANT KO - DAY 1" buyIn: 1.80€ + 0.20€ level: 3 - HandId: #3106533163543822514-39-1705350094 - Holdem no limit (16/70/140) - 2024/01/15 20:21:34 UTC
Table: 'W SERIES GIANT KO - DAY 1(723296116)#0177' 6-max (real money) Seat #5 is the button
Seat 1: Astaeth (28289, 1.35€ bounty)
Seat 2: ortegato93 (10278, 0.90€ bounty)
Seat 3: jos920 (7085, 0.90€ bounty)
Seat 4: P1xel7 (7660, 0.90€ bounty)
Seat 5: Lavanti (8257, 0.90€ bounty)
Seat 6: Mazel Bob (9419, 0.90€ bounty)
*** ANTE/BLINDS ***
Mazel Bob posts ante 16
Astaeth posts ante 16
ortegato93 posts ante 16
jos920 posts ante 16
P1xel7 posts ante 16
Lavanti posts ante 16
Mazel Bob posts small blind 70
Astaeth posts big blind 140
Dealt to P1xel7 [2c 7d]
*** PRE-FLOP *** 
ortegato93 folds
jos920 folds
P1xel7 folds
Lavanti folds
Mazel Bob folds
Astaeth collected 306 from pot
*** SUMMARY ***
Total pot 306 | No rake
Seat 1: Astaeth (big blind) won 306


Winamax Poker - Tournament "W SERIES GIANT KO - DAY 1" buyIn: 1.80€ + 0.20€ level: 3 - HandId: #3106533163543822514-40-1705350123 - Holdem no limit (16/70/140) - 2024/01/15 20:22:03 UTC
Table: 'W SERIES GIANT KO - DAY 1(723296116)#0177' 6-max (real money) Seat #6 is the button
Seat 1: Astaeth (28439, 1.35€ bounty)
Seat 2: ortegato93 (10262, 0.90€ bounty)
Seat 3: jos920 (7069, 0.90€ bounty)
Seat 4: P1xel7 (7644, 0.90€ bounty)
Seat 5: Lavanti (8241, 0.90€ bounty)
Seat 6: Mazel Bob (9333, 0.90€ bounty)
*** ANTE/BLINDS ***
Astaeth posts ante 16
ortegato93 posts ante 16
jos920 posts ante 16
P1xel7 posts ante 16
Lavanti posts ante 16
Mazel Bob posts ante 16
Astaeth posts small blind 70
ortegato93 posts big blind 140
Dealt to P1xel7 [9s 7s]
*** PRE-FLOP *** 
jos920 raises 175 to 315
P1xel7 folds
Lavanti calls 315
Mazel Bob folds
Astaeth folds
ortegato93 calls 175
*** FLOP *** [5s Ks Qh]
ortegato93 checks
jos920 checks
Lavanti bets 556
ortegato93 folds
jos920 folds
Lavanti collected 1667 from pot
*** SUMMARY ***
Total pot 1667 | No rake
Board: [5s Ks Qh]
Seat 5: Lavanti won 1667


Winamax Poker - Tournament "W SERIES GIANT KO - DAY 1" buyIn: 1.80€ + 0.20€ level: 3 - HandId: #3106533163543822514-41-1705350204 - Holdem no limit (16/70/140) - 2024/01/15 20:23:24 UTC
Table: 'W SERIES GIANT KO - DAY 1(723296116)#0177' 6-max (real money) Seat #1 is the button
Seat 1: Astaeth (28353, 1.35€ bounty)
Seat 2: ortegato93 (9931, 0.90€ bounty)
Seat 3: jos920 (6738, 0.90€ bounty)
Seat 4: P1xel7 (7628, 0.90€ bounty)
Seat 5: Lavanti (9021, 0.90€ bounty)
Seat 6: Mazel Bob (9317, 0.90€ bounty)
*** ANTE/BLINDS ***
ortegato93 posts ante 16
jos920 posts ante 16
Astaeth posts ante 16
P1xel7 posts ante 16
Lavanti posts ante 16
Mazel Bob posts ante 16
ortegato93 posts small blind 70
jos920 posts big blind 140
Dealt to P1xel7 [6s 2c]
*** PRE-FLOP *** 
P1xel7 folds
Lavanti folds
Mazel Bob calls 140
Astaeth folds
ortegato93 folds
jos920 checks
*** FLOP *** [6c 9d 2h]
jos920 checks
Mazel Bob checks
*** TURN *** [6c 9d 2h][Qd]
jos920 checks
Mazel Bob bets 290
jos920 folds
Mazel Bob collected 736 from pot
*** SUMMARY ***
Total pot 736 | No rake
Board: [6c 9d 2h Qd]
Seat 6: Mazel Bob won 736


Winamax Poker - Tournament "W SERIES GIANT KO - DAY 1" buyIn: 1.80€ + 0.20€ level: 3 - HandId: #3106533163543822514-42-1705350312 - Holdem no limit (16/70/140) - 2024/01/15 20:25:12 UTC
Table: 'W SERIES GIANT KO - DAY 1(723296116)#0177' 6-max (real money) Seat #2 is the button
Seat 1: Astaeth (28337, 1.35€ bounty)
Seat 2: ortegato93 (9845, 0.90€ bounty)
Seat 3: jos920 (6582, 0.90€ bounty)
Seat 4: P1xel7 (7612, 0.90€ bounty)
Seat 5: Lavanti (9005, 0.90€ bounty)
Seat 6: Mazel Bob (9607, 0.90€ bounty)
*** ANTE/BLINDS ***
jos920 posts ante 16
P1xel7 posts ante 16
Astaeth posts ante 16
ortegato93 posts ante 16
Lavanti posts ante 16
Mazel Bob posts ante 16
jos920 posts small blind 70
P1xel7 posts big blind 140
Dealt to P1xel7 [4d 7s]
*** PRE-FLOP *** 
Lavanti folds
Mazel Bob folds
Astaeth raises 175 to 315
ortegato93 folds
jos920 folds
P1xel7 folds
Astaeth collected 621 from pot
*** SUMMARY ***
Total pot 621 | No rake
Seat 1: Astaeth won 621


Winamax Poker - Tournament "W SERIES GIANT KO - DAY 1" buyIn: 1.80€ + 0.20€ level: 3 - HandId: #3106533163543822514-43-1705350326 - Holdem no limit (16/70/140) - 2024/01/15 20:25:26 UTC
Table: 'W SERIES GIANT KO - DAY 1(723296116)#0177' 6-max (real money) Seat #3 is the button
Seat 1: Astaeth (28627, 1.35€ bounty)
Seat 2: ortegato93 (9829, 0.90€ bounty)
Seat 3: jos920 (6496, 0.90€ bounty)
Seat 4: P1xel7 (7456, 0.90€ bounty)
Seat 5: Lavanti (8989, 0.90€ bounty)
Seat 6: Mazel Bob (9591, 0.90€ bounty)
*** ANTE/BLINDS ***
P1xel7 posts ante 16
Lavanti posts ante 16
Astaeth posts ante 16
ortegato93 posts ante 16
jos920 posts ante 16
Mazel Bob posts ante 16
P1xel7 posts small blind 70
Lavanti posts big blind 140
Dealt to P1xel7 [2d 4d]
*** PRE-FLOP *** 
Mazel Bob folds
Astaeth raises 175 to 315
ortegato93 folds
jos920 calls 315
P1xel7 folds
Lavanti calls 175
*** FLOP *** [Kh 3c Jc]
Lavanti bets 556
Astaeth calls 556
jos920 folds
*** TURN *** [Kh 3c Jc][7s]
Lavanti bets 1112
Astaeth calls 1112
*** RIVER *** [Kh 3c Jc 7s][Ks]
Lavanti bets 2224
Astaeth folds
Lavanti collected 6671 from pot
*** SUMMARY ***
Total pot 6671 | No rake
Board: [Kh 3c Jc 7s Ks]
Seat 5: Lavanti (big blind) won 6671


Winamax Poker - Tournament "W SERIES GIANT KO - DAY 1" buyIn: 1.80€ + 0.20€ level: 3 - HandId: #3106533163543822514-44-1705350370 - Holdem no limit (16/70/140) - 2024/01/15 20:26:10 UTC
Table: 'W SERIES GIANT KO - DAY 1(723296116)#0177' 6-max (real money) Seat #4 is the button
Seat 1: Astaeth (26628, 1.35€ bounty)
Seat 2: ortegato93 (9813, 0.90€ bounty)
Seat 3: jos920 (6165, 0.90€ bounty)
Seat 4: P1xel7 (7370, 0.90€ bounty)
Seat 5: Lavanti (11437, 0.90€ bounty)
Seat 6: Mazel Bob (9575, 0.90€ bounty)
*** ANTE/BLINDS ***
Lavanti posts ante 16
Mazel Bob posts ante 16
Astaeth posts ante 16
ortegato93 posts ante 16
jos920 posts ante 16
P1xel7 posts ante 16
Lavanti posts small blind 70
Mazel Bob posts big blind 140
Dealt to P1xel7 [7h 8c]
*** PRE-FLOP *** 
Astaeth raises 175 to 315
ortegato93 folds
jos920 folds
P1xel7 folds
Lavanti calls 245
Mazel Bob folds
*** FLOP *** [8h 5d 8d]
Lavanti checks
Astaeth checks
*** TURN *** [8h 5d 8d][Ks]
Lavanti bets 420
Astaeth calls 420
*** RIVER *** [8h 5d 8d Ks][2s]
Lavanti bets 1706
Astaeth calls 1706
*** SHOW DOWN ***
Astaeth shows [Tc Kc] (Two pairs : Kings and 8)
Lavanti shows [Ac 8s] (Trips of 8)
Lavanti collected 5118 from pot
*** SUMMARY ***
Total pot 5118 | No rake
Board: [8h 5d 8d Ks 2s]
Seat 1: Astaeth showed [Tc Kc] and lost with Two pairs : Kings and 8
Seat 5: Lavanti (small blind) showed [Ac 8s] and won 5118 with Trips of 8


Winamax Poker - Tournament "W SERIES GIANT KO - DAY 1" buyIn: 1.80€ + 0.20€ level: 3 - HandId: #3106533163543822514-45-1705350413 - Holdem no limit (16/70/140) - 2024/01/15 20:26:53 UTC
Table: 'W SERIES GIANT KO - DAY 1(723296116)#0177' 6-max (real money) Seat #5 is the button
Seat 1: Astaeth (24171, 1.35€ bounty)
Seat 2: ortegato93 (9797, 0.90€ bounty)
Seat 3: jos920 (6149, 0.90€ bounty)
Seat 4: P1xel7 (7354, 0.90€ bounty)
Seat 5: Lavanti (14098, 0.90€ bounty)
Seat 6: Mazel Bob (9419, 0.90€ bounty)
*** ANTE/BLINDS ***
Mazel Bob posts ante 16
Astaeth posts ante 16
ortegato93 posts ante 16
jos920 posts ante 16
P1xel7 posts ante 16
Lavanti posts ante 16
Mazel Bob posts small blind 70
Astaeth posts big blind 140
Dealt to P1xel7 [As 3c]
*** PRE-FLOP *** 
ortegato93 folds
jos920 folds
P1xel7 folds
Lavanti folds
Mazel Bob folds
Astaeth collected 306 from pot
*** SUMMARY ***
Total pot 306 | No rake
Seat 1: Astaeth (big blind) won 306


Winamax Poker - Tournament "W SERIES GIANT KO - DAY 1" buyIn: 1.80€ + 0.20€ level: 3 - HandId: #3106533163543822514-46-1705350430 - Holdem no limit (16/70/140) - 2024/01/15 20:27:10 UTC
Table: 'W SERIES GIANT KO - DAY 1(723296116)#0177' 6-max (real money) Seat #6 is the button
Seat 1: Astaeth (24321, 1.35€ bounty)
Seat 2: ortegato93 (9781, 0.90€ bounty)
Seat 3: jos920 (6133, 0.90€ bounty)
Seat 4: P1xel7 (7338, 0.90€ bounty)
Seat 5: Lavanti (14082, 0.90€ bounty)
Seat 6: Mazel Bob (9333, 0.90€ bounty)
*** ANTE/BLINDS ***
Astaeth posts ante 16
ortegato93 posts ante 16
jos920 posts ante 16
P1xel7 posts ante 16
Lavanti posts ante 16
Mazel Bob posts ante 16
Astaeth posts small blind 70
ortegato93 posts big blind 140
Dealt to P1xel7 [2h 2d]
*** PRE-FLOP *** 
jos920 raises 175 to 315
P1xel7 folds
Lavanti calls 315
Mazel Bob folds
Astaeth calls 245
ortegato93 calls 175
*** FLOP *** [7c Qc 9h]
Astaeth checks
ortegato93 checks
jos920 checks
Lavanti checks
*** TURN *** [7c Qc 9h][4c]
Astaeth checks
ortegato93 checks
jos920 checks
Lavanti checks
*** RIVER *** [7c Qc 9h 4c][8d]
Astaeth checks
ortegato93 bets 1695
jos920 folds
Lavanti folds
Astaeth folds
ortegato93 collected 3051 from pot
*** SUMMARY ***
Total pot 3051 | No rake
Board: [7c Qc 9h 4c 8d]
Seat 2: ortegato93 (big blind) won 3051


Winamax Poker - Tournament "W SERIES GIANT KO - DAY 1" buyIn: 1.80€ + 0.20€ level: 4 - HandId: #3106533163543822514-47-1705350552 - Holdem no limit (20/80/160) - 2024/01/15 20:29:12 UTC
Table: 'W SERIES GIANT KO - DAY 1(723296116)#0177' 6-max (real money) Seat #1 is the button
Seat 1: Astaeth (23990, 1.35€ bounty)
Seat 2: ortegato93 (10806, 0.90€ bounty)
Seat 3: jos920 (5802, 0.90€ bounty)
Seat 4: P1xel7 (7322, 0.90€ bounty)
Seat 5: Lavanti (13751, 0.90€ bounty)
Seat 6: Mazel Bob (9317, 0.90€ bounty)
*** ANTE/BLINDS ***
ortegato93 posts ante 20
jos920 posts ante 20
Astaeth posts ante 20
P1xel7 posts ante 20
Lavanti posts ante 20
Mazel Bob posts ante 20
ortegato93 posts small blind 80
jos920 posts big blind 160
Dealt to P1xel7 [3c 4d]
*** PRE-FLOP *** 
P1xel7 folds
Lavanti raises 160 to 320
Mazel Bob raises 1000 to 1320
Astaeth folds
ortegato93 folds
jos920 folds
Lavanti calls 1000
*** FLOP *** [2c 8h 2h]
Lavanti checks
Mazel Bob bets 7977 and is all-in
Lavanti folds
Mazel Bob collected 10977 from pot
*** SUMMARY ***
Total pot 10977 | No rake
Board: [2c 8h 2h]
Seat 6: Mazel Bob won 10977


Winamax Poker - Tournament "W SERIES GIANT KO - DAY 1" buyIn: 1.80€ + 0.20€ level: 4 - HandId: #3106533163543822514-48-1705350613 - Holdem no limit (20/80/160) - 2024/01/15 20:30:13 UTC
Table: 'W SERIES GIANT KO - DAY 1(723296116)#0177' 6-max (real money) Seat #2 is the button
Seat 1: Astaeth (23970, 1.35€ bounty)
Seat 2: ortegato93 (10706, 0.90€ bounty)
Seat 3: jos920 (5622, 0.90€ bounty)
Seat 4: P1xel7 (7302, 0.90€ bounty)
Seat 5: Lavanti (12411, 0.90€ bounty)
Seat 6: Mazel Bob (10977, 0.90€ bounty)
*** ANTE/BLINDS ***
jos920 posts ante 20
P1xel7 posts ante 20
Astaeth posts ante 20
ortegato93 posts ante 20
Lavanti posts ante 20
Mazel Bob posts ante 20
jos920 posts small blind 80
P1xel7 posts big blind 160
Dealt to P1xel7 [4h 3c]
*** PRE-FLOP *** 
Lavanti folds
Mazel Bob folds
Astaeth raises 200 to 360
ortegato93 calls 360
jos920 folds
P1xel7 folds
*** FLOP *** [2h 5h Ts]
Astaeth bets 378
ortegato93 calls 378
*** TURN *** [2h 5h Ts][Ad]
Astaeth checks
ortegato93 bets 1469
Astaeth folds
ortegato93 collected 3305 from pot
*** SUMMARY ***
Total pot 3305 | No rake
Board: [2h 5h Ts Ad]
Seat 2: ortegato93 (button) won 3305


Winamax Poker - Tournament "W SERIES GIANT KO - DAY 1" buyIn: 1.80€ + 0.20€ level: 4 - HandId: #3106533163543822514-49-1705350662 - Holdem no limit (20/80/160) - 2024/01/15 20:31:02 UTC
Table: 'W SERIES GIANT KO - DAY 1(723296116)#0177' 6-max (real money) Seat #3 is the button
Seat 1: Astaeth (23212, 1.35€ bounty)
Seat 2: ortegato93 (11784, 0.90€ bounty)
Seat 3: jos920 (5522, 0.90€ bounty)
Seat 4: P1xel7 (7122, 0.90€ bounty)
Seat 5: Lavanti (12391, 0.90€ bounty)
Seat 6: Mazel Bob (10957, 0.90€ bounty)
*** ANTE/BLINDS ***
P1xel7 posts ante 20
Lavanti posts ante 20
Astaeth posts ante 20
ortegato93 posts ante 20
jos920 posts ante 20
Mazel Bob posts ante 20
P1xel7 posts small blind 80
Lavanti posts big blind 160
Dealt to P1xel7 [5d 5s]
*** PRE-FLOP *** 
Mazel Bob folds
Astaeth folds
ortegato93 folds
jos920 raises 200 to 360
P1xel7 calls 280
Lavanti calls 200
*** FLOP *** [5h 9s Kc]
P1xel7 checks
Lavanti checks
jos920 bets 500
P1xel7 calls 500
Lavanti folds
*** TURN *** [5h 9s Kc][8c]
P1xel7 checks
jos920 checks
*** RIVER *** [5h 9s Kc 8c][Kh]
P1xel7 bets 1100
jos920 calls 1100
*** SHOW DOWN ***
jos920 shows [Js Jd] (Two pairs : Kings and Jacks)
P1xel7 shows [5d 5s] (Full of 5 and Kings)
P1xel7 collected 4400 from pot
*** SUMMARY ***
Total pot 4400 | No rake
Board: [5h 9s Kc 8c Kh]
Seat 3: jos920 (button) showed [Js Jd] and lost with Two pairs : Kings and Jacks
Seat 4: P1xel7 (small blind) showed [5d 5s] and won 4400 with Full of 5 and Kings


Winamax Poker - Tournament "W SERIES GIANT KO - DAY 1" buyIn: 1.80€ + 0.20€ level: 4 - HandId: #3106533163543822514-50-1705350769 - Holdem no limit (20/80/160) - 2024/01/15 20:32:49 UTC
Table: 'W SERIES GIANT KO - DAY 1(723296116)#0177' 6-max (real money) Seat #4 is the button
Seat 1: Astaeth (23192, 1.35€ bounty)
Seat 2: ortegato93 (11764, 0.90€ bounty)
Seat 3: jos920 (3542, 0.90€ bounty)
Seat 4: P1xel7 (9542, 0.90€ bounty)
Seat 5: Lavanti (12011, 0.90€ bounty)
Seat 6: Mazel Bob (10937, 0.90€ bounty)
*** ANTE/BLINDS ***
Lavanti posts ante 20
Mazel Bob posts ante 20
Astaeth posts ante 20
ortegato93 posts ante 20
jos920 posts ante 20
P1xel7 posts ante 20
Lavanti posts small blind 80
Mazel Bob posts big blind 160
Dealt to P1xel7 [5d Th]
*** PRE-FLOP *** 
Astaeth folds
ortegato93 folds
jos920 folds
P1xel7 folds
Lavanti raises 11831 to 11991 and is all-in
Mazel Bob folds
Lavanti collected 12271 from pot
*** SUMMARY ***
Total pot 12271 | No rake
Seat 5: Lavanti (small blind) won 12271


Winamax Poker - Tournament "W SERIES GIANT KO - DAY 1" buyIn: 1.80€ + 0.20€ level: 4 - HandId: #3106533163543822514-51-1705350796 - Holdem no limit (20/80/160) - 2024/01/15 20:33:16 UTC
Table: 'W SERIES GIANT KO - DAY 1(723296116)#0177' 6-max (real money) Seat #5 is the button
Seat 1: Astaeth (23172, 1.35€ bounty)
Seat 2: ortegato93 (11744, 0.90€ bounty)
Seat 3: jos920 (3522, 0.90€ bounty)
Seat 4: P1xel7 (9522, 0.90€ bounty)
Seat 5: Lavanti (12271, 0.90€ bounty)
Seat 6: Mazel Bob (10757, 0.90€ bounty)
*** ANTE/BLINDS ***
Mazel Bob posts ante 20
Astaeth posts ante 20
ortegato93 posts ante 20
jos920 posts ante 20
P1xel7 posts ante 20
Lavanti posts ante 20
Mazel Bob posts small blind 80
Astaeth posts big blind 160
Dealt to P1xel7 [7h 4c]
*** PRE-FLOP *** 
ortegato93 raises 160 to 320
jos920 folds
P1xel7 folds
Lavanti folds
Mazel Bob folds
Astaeth calls 160
*** FLOP *** [2h Td 8d]
Astaeth checks
ortegato93 bets 672
Astaeth folds
ortegato93 collected 1512 from pot
*** SUMMARY ***
Total pot 1512 | No rake
Board: [2h Td 8d]
Seat 2: ortegato93 won 1512


Winamax Poker - Tournament "W SERIES GIANT KO - DAY 1" buyIn: 1.80€ + 0.20€ level: 4 - HandId: #3106533163543822514-52-1705350866 - Holdem no limit (20/80/160) - 2024/01/15 20:34:26 UTC
Table: 'W SERIES GIANT KO - DAY 1(723296116)#0177' 6-max (real money) Seat #6 is the button
Seat 1: Astaeth (22832, 1.35€ bounty)
Seat 2: ortegato93 (12244, 0.90€ bounty)
Seat 3: jos920 (3502, 0.90€ bounty)
Seat 4: P1xel7 (9502, 0.90€ bounty)
Seat 5: Lavanti (12251, 0.90€ bounty)
Seat 6: Mazel Bob (10657, 0.90€ bounty)
*** ANTE/BLINDS ***
Astaeth posts ante 20
ortegato93 posts ante 20
jos920 posts ante 20
P1xel7 posts ante 20
Lavanti posts ante 20
Mazel Bob posts ante 20
Astaeth posts small blind 80
ortegato93 posts big blind 160
Dealt to P1xel7 [As 6s]
*** PRE-FLOP *** 
jos920 folds
P1xel7 folds
Lavanti raises 160 to 320
Mazel Bob folds
Astaeth calls 240
ortegato93 calls 160
*** FLOP *** [Qc 2d 6d]
Astaeth checks
ortegato93 checks
Lavanti bets 378
Astaeth folds
ortegato93 folds
Lavanti collected 1458 from pot
*** SUMMARY ***
Total pot 1458 | No rake
Board: [Qc 2d 6d]
Seat 5: Lavanti won 1458


Winamax Poker - Tournament "W SERIES GIANT KO - DAY 1" buyIn: 1.80€ + 0.20€ level: 4 - HandId: #3106533163543822514-53-1705350926 - Holdem no limit (20/80/160) - 2024/01/15 20:35:26 UTC
Table: 'W SERIES GIANT KO - DAY 1(723296116)#0177' 6-max (real money) Seat #1 is the button
Seat 1: Astaeth (22492, 1.35€ bounty)
Seat 2: ortegato93 (11904, 0.90€ bounty)
Seat 3: jos920 (3482, 0.90€ bounty)
Seat 4: P1xel7 (9482, 0.90€ bounty)
Seat 5: Lavanti (12991, 0.90€ bounty)
Seat 6: Mazel Bob (10637, 0.90€ bounty)
*** ANTE/BLINDS ***
ortegato93 posts ante 20
jos920 posts ante 20
Astaeth posts ante 20
P1xel7 posts ante 20
Lavanti posts ante 20
Mazel Bob posts ante 20
ortegato93 posts small blind 80
jos920 posts big blind 160
Dealt to P1xel7 [8s 8c]
*** PRE-FLOP *** 
P1xel7 raises 320 to 480
Lavanti folds
Mazel Bob folds
Astaeth folds
ortegato93 calls 400
jos920 folds
*** FLOP *** [Ks As 7s]
ortegato93 checks
P1xel7 bets 434
ortegato93 calls 434
*** TURN *** [Ks As 7s][4c]
ortegato93 checks
P1xel7 bets 738
ortegato93 calls 738
*** RIVER *** [Ks As 7s 4c][9d]
ortegato93 checks
P1xel7 checks
*** SHOW DOWN ***
P1xel7 shows [8s 8c] (One pair : 8)
ortegato93 shows [Qc Kh] (One pair : Kings)
ortegato93 collected 3584 from pot
*** SUMMARY ***
Total pot 3584 | No rake
Board: [Ks As 7s 4c 9d]
Seat 2: ortegato93 (small blind) showed [Qc Kh] and won 3584 with One pair : Kings
Seat 4: P1xel7 showed [8s 8c] and lost with One pair : 8


Winamax Poker - Tournament "W SERIES GIANT KO - DAY 1" buyIn: 1.80€ + 0.20€ level: 4 - HandId: #3106533163543822514-54-1705350990 - Holdem no limit (20/80/160) - 2024/01/15 20:36:30 UTC
Table: 'W SERIES GIANT KO - DAY 1(723296116)#0177' 6-max (real money) Seat #2 is the button
Seat 1: Astaeth (22472, 1.35€ bounty)
Seat 2: ortegato93 (13816, 0.90€ bounty)
Seat 3: jos920 (3302, 0.90€ bounty)
Seat 4: P1xel7 (7810, 0.90€ bounty)
Seat 5: Lavanti (12971, 0.90€ bounty)
Seat 6: Mazel Bob (10617, 0.90€ bounty)
*** ANTE/BLINDS ***
jos920 posts ante 20
P1xel7 posts ante 20
Astaeth posts ante 20
ortegato93 posts ante 20
Lavanti posts ante 20
Mazel Bob posts ante 20
jos920 posts small blind 80
P1xel7 posts big blind 160
Dealt to P1xel7 [2s Kh]
*** PRE-FLOP *** 
Lavanti raises 240 to 400
Mazel Bob calls 400
Astaeth folds
ortegato93 folds
jos920 folds
P1xel7 folds
*** FLOP *** [Th Qc 4c]
Lavanti bets 406
Mazel Bob calls 406
*** TURN *** [Th Qc 4c][Kd]
Lavanti bets 1282
Mazel Bob folds
Lavanti collected 3254 from pot
*** SUMMARY ***
Total pot 3254 | No rake
Board: [Th Qc 4c Kd]
Seat 5: Lavanti won 3254


Winamax Poker - Tournament "W SERIES GIANT KO - DAY 1" buyIn: 1.80€ + 0.20€ level: 4 - HandId: #3106533163543822514-55-1705351054 - Holdem no limit (20/80/160) - 2024/01/15 20:37:34 UTC
Table: 'W SERIES GIANT KO - DAY 1(723296116)#0177' 6-max (real money) Seat #3 is the button
Seat 1: Astaeth (22452, 1.35€ bounty)
Seat 2: ortegato93 (13796, 0.90€ bounty)
Seat 3: jos920 (3202, 0.90€ bounty)
Seat 4: P1xel7 (7630, 0.90€ bounty)
Seat 5: Lavanti (14117, 0.90€ bounty)
Seat 6: Mazel Bob (9791, 0.90€ bounty)
*** ANTE/BLINDS ***
P1xel7 posts ante 20
Lavanti posts ante 20
Astaeth posts ante 20
ortegato93 posts ante 20
jos920 posts ante 20
Mazel Bob posts ante 20
P1xel7 posts small blind 80
Lavanti posts big blind 160
Dealt to P1xel7 [2c 3h]
*** PRE-FLOP *** 
Mazel Bob folds
Astaeth folds
ortegato93 raises 160 to 320
jos920 folds
P1xel7 folds
Lavanti calls 160
*** FLOP *** [6h 8d 8s]
Lavanti checks
ortegato93 checks
*** TURN *** [6h 8d 8s][2s]
Lavanti checks
ortegato93 checks
*** RIVER *** [6h 8d 8s 2s][5s]
Lavanti checks
ortegato93 checks
*** SHOW DOWN ***
ortegato93 shows [Qd Jh] (One pair : 8)
Lavanti shows [5h 7h] (Two pairs : 8 and 5)
Lavanti collected 840 from pot
*** SUMMARY ***
Total pot 840 | No rake
Board: [6h 8d 8s 2s 5s]
Seat 2: ortegato93 showed [Qd Jh] and lost with One pair : 8
Seat 5: Lavanti (big blind) showed [5h 7h] and won 840 with Two pairs : 8 and 5


Winamax Poker - Tournament "W SERIES GIANT KO - DAY 1" buyIn: 1.80€ + 0.20€ level: 4 - HandId: #3106533163543822514-56-1705351088 - Holdem no limit (20/80/160) - 2024/01/15 20:38:08 UTC
Table: 'W SERIES GIANT KO - DAY 1(723296116)#0177' 6-max (real money) Seat #4 is the button
Seat 1: Astaeth (22432, 1.35€ bounty)
Seat 2: ortegato93 (13456, 0.90€ bounty)
Seat 3: jos920 (3182, 0.90€ bounty)
Seat 4: P1xel7 (7530, 0.90€ bounty)
Seat 5: Lavanti (14617, 0.90€ bounty)
Seat 6: Mazel Bob (9771, 0.90€ bounty)
*** ANTE/BLINDS ***
Lavanti posts ante 20
Mazel Bob posts ante 20
Astaeth posts ante 20
ortegato93 posts ante 20
jos920 posts ante 20
P1xel7 posts ante 20
Lavanti posts small blind 80
Mazel Bob posts big blind 160
Dealt to P1xel7 [5h 3s]
*** PRE-FLOP *** 
Astaeth raises 200 to 360
ortegato93 calls 360
jos920 folds
P1xel7 folds
Lavanti folds
Mazel Bob calls 200
*** FLOP *** [Ks 4h 3d]
Mazel Bob checks
Astaeth bets 448
ortegato93 folds
Mazel Bob folds
Astaeth collected 1728 from pot
*** SUMMARY ***
Total pot 1728 | No rake
Board: [Ks 4h 3d]
Seat 1: Astaeth won 1728


Winamax Poker - Tournament "W SERIES GIANT KO - DAY 1" buyIn: 1.80€ + 0.20€ level: 4 - HandId: #3106533163543822514-57-1705351115 - Holdem no limit (20/80/160) - 2024/01/15 20:38:35 UTC
Table: 'W SERIES GIANT KO - DAY 1(723296116)#0177' 6-max (real money) Seat #5 is the button
Seat 1: Astaeth (23332, 1.35€ bounty)
Seat 2: ortegato93 (13076, 0.90€ bounty)
Seat 3: jos920 (3162, 0.90€ bounty)
Seat 4: P1xel7 (7510, 0.90€ bounty)
Seat 5: Lavanti (14517, 0.90€ bounty)
Seat 6: Mazel Bob (9391, 0.90€ bounty)
*** ANTE/BLINDS ***
Mazel Bob posts ante 20
Astaeth posts ante 20
ortegato93 posts ante 20
jos920 posts ante 20
P1xel7 posts ante 20
Lavanti posts ante 20
Mazel Bob posts small blind 80
Astaeth posts big blind 160
Dealt to P1xel7 [3h Ks]
*** PRE-FLOP *** 
ortegato93 folds
jos920 folds
P1xel7 folds
Lavanti raises 240 to 400
Mazel Bob folds
Astaeth calls 240
*** FLOP *** [6d 5s 9h]
Astaeth checks
Lavanti bets 350
Astaeth folds
Lavanti collected 1350 from pot
*** SUMMARY ***
Total pot 1350 | No rake
Board: [6d 5s 9h]
Seat 5: Lavanti (button) won 1350


Winamax Poker - Tournament "W SERIES GIANT KO - DAY 1" buyIn: 1.80€ + 0.20€ level: 4 - HandId: #3106533163543822514-58-1705351145 - Holdem no limit (20/80/160) - 2024/01/15 20:39:05 UTC
Table: 'W SERIES GIANT KO - DAY 1(723296116)#0177' 6-max (real money) Seat #6 is the button
Seat 1: Astaeth (22912, 1.35€ bounty)
Seat 2: ortegato93 (13056, 0.90€ bounty)
Seat 3: jos920 (3142, 0.90€ bounty)
Seat 4: P1xel7 (7490, 0.90€ bounty)
Seat 5: Lavanti (15097, 0.90€ bounty)
Seat 6: Mazel Bob (9291, 0.90€ bounty)
*** ANTE/BLINDS ***
Astaeth posts ante 20
ortegato93 posts ante 20
jos920 posts ante 20
P1xel7 posts ante 20
Lavanti posts ante 20
Mazel Bob posts ante 20
Astaeth posts small blind 80
ortegato93 posts big blind 160
Dealt to P1xel7 [9h 6s]
*** PRE-FLOP *** 
jos920 folds
P1xel7 folds
Lavanti folds
Mazel Bob folds
Astaeth calls 80
ortegato93 checks
*** FLOP *** [9d Ad Ah]
Astaeth bets 160
ortegato93 folds
Astaeth collected 600 from pot
*** SUMMARY ***
Total pot 600 | No rake
Board: [9d Ad Ah]
Seat 1: Astaeth (small blind) won 600


Winamax Poker - Tournament "W SERIES GIANT KO - DAY 1" buyIn: 1.80€ + 0.20€ level: 5 - HandId: #3106533163543822514-59-1705351176 - Holdem no limit (25/100/200) - 2024/01/15 20:39:36 UTC
Table: 'W SERIES GIANT KO - DAY 1(723296116)#0177' 6-max (real money) Seat #1 is the button
Seat 1: Astaeth (23172, 1.35€ bounty)
Seat 2: ortegato93 (12876, 0.90€ bounty)
Seat 3: jos920 (3122, 0.90€ bounty)
Seat 4: P1xel7 (7470, 0.90€ bounty)
Seat 5: Lavanti (15077, 0.90€ bounty)
Seat 6: Mazel Bob (9271, 0.90€ bounty)
*** ANTE/BLINDS ***
ortegato93 posts ante 25
jos920 posts ante 25
Astaeth posts ante 25
P1xel7 posts ante 25
Lavanti posts ante 25
Mazel Bob posts ante 25
ortegato93 posts small blind 100
jos920 posts big blind 200
Dealt to P1xel7 [5s 6c]
*** PRE-FLOP *** 
P1xel7 folds
Lavanti raises 200 to 400
Mazel Bob raises 8846 to 9246 and is all-in
Astaeth folds
ortegato93 folds
jos920 folds
Lavanti calls 8846
*** FLOP *** [2d Th 7h]
*** TURN *** [2d Th 7h][2h]
*** RIVER *** [2d Th 7h 2h][2s]
*** SHOW DOWN ***
Lavanti shows [Ah 5h] (Flush Ace high)
Mazel Bob shows [Ks Kd] (Full of 2 and Kings)
Mazel Bob collected 18942 from pot
*** SUMMARY ***
Total pot 18942 | No rake
Board: [2d Th 7h 2h 2s]
Seat 5: Lavanti showed [Ah 5h] and lost with Flush Ace high
Seat 6: Mazel Bob showed [Ks Kd] and won 18942 with Full of 2 and Kings


Winamax Poker - Tournament "W SERIES GIANT KO - DAY 1" buyIn: 1.80€ + 0.20€ level: 5 - HandId: #3106533163543822514-60-1705351213 - Holdem no limit (25/100/200) - 2024/01/15 20:40:13 UTC
Table: 'W SERIES GIANT KO - DAY 1(723296116)#0177' 6-max (real money) Seat #2 is the button
Seat 1: Astaeth (23147, 1.35€ bounty)
Seat 2: ortegato93 (12751, 0.90€ bounty)
Seat 3: jos920 (2897, 0.90€ bounty)
Seat 4: P1xel7 (7445, 0.90€ bounty)
Seat 5: Lavanti (5806, 0.90€ bounty)
Seat 6: Mazel Bob (18942, 0.90€ bounty)
*** ANTE/BLINDS ***
jos920 posts ante 25
P1xel7 posts ante 25
Astaeth posts ante 25
ortegato93 posts ante 25
Lavanti posts ante 25
Mazel Bob posts ante 25
jos920 posts small blind 100
P1xel7 posts big blind 200
Dealt to P1xel7 [9s 6d]
*** PRE-FLOP *** 
Lavanti folds
Mazel Bob folds
Astaeth raises 250 to 450
ortegato93 calls 450
jos920 folds
P1xel7 folds
*** FLOP *** [Qh 8d 6c]
Astaeth bets 473
ortegato93 calls 473
*** TURN *** [Qh 8d 6c][5s]
Astaeth checks
ortegato93 bets 1300
Astaeth folds
ortegato93 collected 3596 from pot
*** SUMMARY ***
Total pot 3596 | No rake
Board: [Qh 8d 6c 5s]
Seat 2: ortegato93 (button) won 3596


Winamax Poker - Tournament "W SERIES GIANT KO - DAY 1" buyIn: 1.80€ + 0.20€ level: 5 - HandId: #3106533163543822514-61-1705351265 - Holdem no limit (25/100/200) - 2024/01/15 20:41:05 UTC
Table: 'W SERIES GIANT KO - DAY 1(723296116)#0177' 6-max (real money) Seat #3 is the button
Seat 1: Astaeth (22199, 1.35€ bounty)
Seat 2: ortegato93 (14099, 0.90€ bounty)
Seat 3: jos920 (2772, 0.90€ bounty)
Seat 4: P1xel7 (7220, 0.90€ bounty)
Seat 5: Lavanti (5781, 0.90€ bounty)
Seat 6: Mazel Bob (18917, 0.90€ bounty)
*** ANTE/BLINDS ***
P1xel7 posts ante 25
Lavanti posts ante 25
Astaeth posts ante 25
ortegato93 posts ante 25
jos920 posts ante 25
Mazel Bob posts ante 25
P1xel7 posts small blind 100
Lavanti posts big blind 200
Dealt to P1xel7 [5s 6c]
*** PRE-FLOP *** 
Mazel Bob raises 200 to 400
Astaeth folds
ortegato93 folds
jos920 folds
P1xel7 folds
Lavanti raises 5356 to 5756 and is all-in
Mazel Bob calls 5356
*** FLOP *** [Qc 8d 7d]
*** TURN *** [Qc 8d 7d][Ks]
*** RIVER *** [Qc 8d 7d Ks][3c]
*** SHOW DOWN ***
Lavanti shows [9d Ad] (High card : Ace)
Mazel Bob shows [Ac 8c] (One pair : 8)
Mazel Bob collected 11762 from pot
*** SUMMARY ***
Total pot 11762 | No rake
Board: [Qc 8d 7d Ks 3c]
Seat 5: Lavanti (big blind) showed [9d Ad] and lost with High card : Ace
Seat 6: Mazel Bob showed [Ac 8c] and won 11762 with One pair : 8


Winamax Poker - Tournament "W SERIES GIANT KO - DAY 1" buyIn: 1.80€ + 0.20€ level: 5 - HandId: #3106533163543822514-62-1705351314 - Holdem no limit (25/100/200) - 2024/01/15 20:41:54 UTC
Table: 'W SERIES GIANT KO - DAY 1(723296116)#0177' 6-max (real money) Seat #4 is the button
Seat 1: Astaeth (22174, 1.35€ bounty)
Seat 2: ortegato93 (14074, 0.90€ bounty)
Seat 3: jos920 (2747, 0.90€ bounty)
Seat 4: P1xel7 (7095, 0.90€ bounty)
Seat 6: Mazel Bob (24898, 1.35€ bounty)
*** ANTE/BLINDS ***
Mazel Bob posts ante 25
Astaeth posts ante 25
ortegato93 posts ante 25
jos920 posts ante 25
P1xel7 posts ante 25
Mazel Bob posts big blind 200
Dealt to P1xel7 [Jh 9h]
*** PRE-FLOP *** 
Astaeth folds
ortegato93 folds
jos920 raises 2522 to 2722 and is all-in
P1xel7 folds
Mazel Bob folds
jos920 collected 3047 from pot
*** SUMMARY ***
Total pot 3047 | No rake
Seat 3: jos920 won 3047


Winamax Poker - Tournament "W SERIES GIANT KO - DAY 1" buyIn: 1.80€ + 0.20€ level: 5 - HandId: #3106533163543822514-63-1705351342 - Holdem no limit (25/100/200) - 2024/01/15 20:42:22 UTC
Table: 'W SERIES GIANT KO - DAY 1(723296116)#0177' 6-max (real money) Seat #5 is the button
Seat 1: Astaeth (22149, 1.35€ bounty)
Seat 2: ortegato93 (14049, 0.90€ bounty)
Seat 3: jos920 (3047, 0.90€ bounty)
Seat 4: P1xel7 (7070, 0.90€ bounty)
Seat 5: __TOMBOLA__ (10000, 0.90€ bounty)
Seat 6: Mazel Bob (24673, 1.35€ bounty)
*** ANTE/BLINDS ***
Mazel Bob posts ante 25
Astaeth posts ante 25
ortegato93 posts ante 25
jos920 posts ante 25
P1xel7 posts ante 25
Mazel Bob posts small blind 100
Astaeth posts big blind 200
Dealt to P1xel7 [Td 7s]
*** PRE-FLOP *** 
ortegato93 raises 200 to 400
jos920 folds
P1xel7 folds
Mazel Bob folds
Astaeth calls 200
*** FLOP *** [Qc Js 4c]
Astaeth checks
ortegato93 checks
*** TURN *** [Qc Js 4c][Ah]
Astaeth checks
ortegato93 bets 390
Astaeth calls 390
*** RIVER *** [Qc Js 4c Ah][6s]
Astaeth bets 632
ortegato93 folds
Astaeth collected 2437 from pot
*** SUMMARY ***
Total pot 2437 | No rake
Board: [Qc Js 4c Ah 6s]
Seat 1: Astaeth (big blind) won 2437


Winamax Poker - Tournament "W SERIES GIANT KO - DAY 1" buyIn: 1.80€ + 0.20€ level: 5 - HandId: #3106533163543822514-64-1705351392 - Holdem no limit (25/100/200) - 2024/01/15 20:43:12 UTC
Table: 'W SERIES GIANT KO - DAY 1(723296116)#0177' 6-max (real money) Seat #6 is the button
Seat 1: Astaeth (23139, 1.35€ bounty)
Seat 2: ortegato93 (13234, 0.90€ bounty)
Seat 3: jos920 (3022, 0.90€ bounty)
Seat 4: P1xel7 (7045, 0.90€ bounty)
Seat 5: __TOMBOLA__ (10000, 0.90€ bounty)
Seat 6: Mazel Bob (24548, 1.35€ bounty)
*** ANTE/BLINDS ***
Astaeth posts ante 25
ortegato93 posts ante 25
jos920 posts ante 25
P1xel7 posts ante 25
__TOMBOLA__ posts ante 25
Mazel Bob posts ante 25
Astaeth posts small blind 100
ortegato93 posts big blind 200
Dealt to P1xel7 [9d 6h]
*** PRE-FLOP *** 
jos920 calls 200
P1xel7 folds
__TOMBOLA__ folds
Mazel Bob raises 300 to 500
Astaeth folds
ortegato93 folds
jos920 calls 300
*** FLOP *** [Jd 2c 2s]
jos920 bets 1043
Mazel Bob raises 22980 to 24023 and is all-in
jos920 calls 1454 and is all-in
*** TURN *** [Jd 2c 2s][9c]
*** RIVER *** [Jd 2c 2s 9c][As]
*** SHOW DOWN ***
jos920 shows [Jc Qh] (Two pairs : Jacks and 2)
Mazel Bob shows [Ac Js] (Two pairs : Aces and Jacks)
Mazel Bob collected 27970 from pot
*** SUMMARY ***
Total pot 27970 | No rake
Board: [Jd 2c 2s 9c As]
Seat 3: jos920 showed [Jc Qh] and lost with Two pairs : Jacks and 2
Seat 6: Mazel Bob (button) showed [Ac Js] and won 27970 with Two pairs : Aces and Jacks


Winamax Poker - Tournament "W SERIES GIANT KO - DAY 1" buyIn: 1.80€ + 0.20€ level: 5 - HandId: #3106533163543822514-65-1705351439 - Holdem no limit (25/100/200) - 2024/01/15 20:43:59 UTC
Table: 'W SERIES GIANT KO - DAY 1(723296116)#0177' 6-max (real money) Seat #1 is the button
Seat 1: Astaeth (23014, 1.35€ bounty)
Seat 2: ortegato93 (13009, 0.90€ bounty)
Seat 4: P1xel7 (7020, 0.90€ bounty)
Seat 5: __TOMBOLA__ (9975, 0.90€ bounty)
Seat 6: Mazel Bob (27970, 1.80€ bounty)
*** ANTE/BLINDS ***
ortegato93 posts ante 25
P1xel7 posts ante 25
Astaeth posts ante 25
__TOMBOLA__ posts ante 25
Mazel Bob posts ante 25
ortegato93 posts small blind 100
P1xel7 posts big blind 200
Dealt to P1xel7 [4d 6h]
*** PRE-FLOP *** 
__TOMBOLA__ folds
Mazel Bob folds
Astaeth raises 250 to 450
ortegato93 calls 350
P1xel7 calls 250
*** FLOP *** [Kd 7h 5h]
ortegato93 checks
P1xel7 checks
Astaeth bets 369
ortegato93 folds
P1xel7 calls 369
*** TURN *** [Kd 7h 5h][4c]
P1xel7 checks
Astaeth bets 1600
P1xel7 calls 1600
*** RIVER *** [Kd 7h 5h 4c][Kh]
P1xel7 checks
Astaeth checks
*** SHOW DOWN ***
P1xel7 shows [4d 6h] (Two pairs : Kings and 4)
Astaeth shows [Tc Kc] (Trips of Kings)
Astaeth collected 5413 from pot
*** SUMMARY ***
Total pot 5413 | No rake
Board: [Kd 7h 5h 4c Kh]
Seat 1: Astaeth (button) showed [Tc Kc] and won 5413 with Trips of Kings
Seat 4: P1xel7 (big blind) showed [4d 6h] and lost with Two pairs : Kings and 4


Winamax Poker - Tournament "W SERIES GIANT KO - DAY 1" buyIn: 1.80€ + 0.20€ level: 5 - HandId: #3106533163543822514-66-1705351503 - Holdem no limit (25/100/200) - 2024/01/15 20:45:03 UTC
Table: 'W SERIES GIANT KO - DAY 1(723296116)#0177' 6-max (real money) Seat #2 is the button
Seat 1: Astaeth (25983, 1.35€ bounty)
Seat 2: ortegato93 (12534, 0.90€ bounty)
Seat 3: DingooFitoo (10000, 0.90€ bounty)
Seat 4: P1xel7 (4576, 0.90€ bounty)
Seat 5: __TOMBOLA__ (9950, 0.90€ bounty)
Seat 6: Mazel Bob (27945, 1.80€ bounty)
*** ANTE/BLINDS ***
P1xel7 posts ante 25
__TOMBOLA__ posts ante 25
Astaeth posts ante 25
ortegato93 posts ante 25
Mazel Bob posts ante 25
P1xel7 posts small blind 100
__TOMBOLA__ posts big blind 200
Dealt to P1xel7 [4s 9s]
*** PRE-FLOP *** 
Mazel Bob raises 300 to 500
Astaeth raises 1000 to 1500
ortegato93 folds
P1xel7 folds
__TOMBOLA__ folds
Mazel Bob calls 1000
*** FLOP *** [8c Kh 3d]
Mazel Bob bets 2226
Astaeth calls 2226
*** TURN *** [8c Kh 3d][8d]
Mazel Bob bets 5120
Astaeth calls 5120
*** RIVER *** [8c Kh 3d 8d][4d]
Mazel Bob bets 19074 and is all-in
Astaeth calls 17112 and is all-in
*** SHOW DOWN ***
Astaeth shows [Ad Kc] (Two pairs : Kings and 8)
Mazel Bob shows [Ks Ts] (Two pairs : Kings and 8)
Mazel Bob collected 1962 from side pot 1
Astaeth collected 52341 from main pot
*** SUMMARY ***
Total pot 54303 | No rake
Board: [8c Kh 3d 8d 4d]
Seat 1: Astaeth showed [Ad Kc] and won 52341 with Two pairs : Kings and 8
Seat 6: Mazel Bob showed [Ks Ts] and won 1962 with Two pairs : Kings and 8


Winamax Poker - Tournament "W SERIES GIANT KO - DAY 1" buyIn: 1.80€ + 0.20€ level: 5 - HandId: #3106533163543822514-67-1705351612 - Holdem no limit (25/100/200) - 2024/01/15 20:46:52 UTC
Table: 'W SERIES GIANT KO - DAY 1(723296116)#0177' 6-max (real money) Seat #4 is the button
Seat 1: Astaeth (52341, 1.35€ bounty)
Seat 2: ortegato93 (12509, 0.90€ bounty)
Seat 3: DingooFitoo (10000, 0.90€ bounty)
Seat 4: P1xel7 (4451, 0.90€ bounty)
Seat 5: __TOMBOLA__ (9725, 0.90€ bounty)
Seat 6: Mazel Bob (1962, 1.80€ bounty)
*** ANTE/BLINDS ***
__TOMBOLA__ posts ante 25
Mazel Bob posts ante 25
Astaeth posts ante 25
ortegato93 posts ante 25
DingooFitoo posts ante 25
P1xel7 posts ante 25
__TOMBOLA__ posts small blind 100
Mazel Bob posts big blind 200
Dealt to P1xel7 [4c Jd]
*** PRE-FLOP *** 
Astaeth folds
ortegato93 folds
DingooFitoo folds
P1xel7 folds
__TOMBOLA__ raises 9500 to 9700 and is all-in
Mazel Bob folds
__TOMBOLA__ collected 10050 from pot
*** SUMMARY ***
Total pot 10050 | No rake
Seat 5: __TOMBOLA__ (small blind) won 10050


Winamax Poker - Tournament "W SERIES GIANT KO - DAY 1" buyIn: 1.80€ + 0.20€ level: 5 - HandId: #3106533163543822514-68-1705351635 - Holdem no limit (25/100/200) - 2024/01/15 20:47:15 UTC
Table: 'W SERIES GIANT KO - DAY 1(723296116)#0177' 6-max (real money) Seat #5 is the button
Seat 1: Astaeth (52316, 1.35€ bounty)
Seat 2: ortegato93 (12484, 0.90€ bounty)
Seat 3: DingooFitoo (9975, 0.90€ bounty)
Seat 4: P1xel7 (4426, 0.90€ bounty)
Seat 5: __TOMBOLA__ (10050, 0.90€ bounty)
Seat 6: Mazel Bob (1737, 1.80€ bounty)
*** ANTE/BLINDS ***
Mazel Bob posts ante 25
Astaeth posts ante 25
ortegato93 posts ante 25
DingooFitoo posts ante 25
P1xel7 posts ante 25
__TOMBOLA__ posts ante 25
Mazel Bob posts small blind 100
Astaeth posts big blind 200
Dealt to P1xel7 [9h 2d]
*** PRE-FLOP *** 
ortegato93 raises 200 to 400
DingooFitoo folds
P1xel7 folds
__TOMBOLA__ folds
Mazel Bob folds
Astaeth folds
ortegato93 collected 850 from pot
*** SUMMARY ***
Total pot 850 | No rake
Seat 2: ortegato93 won 850


Winamax Poker - Tournament "W SERIES GIANT KO - DAY 1" buyIn: 1.80€ + 0.20€ level: 5 - HandId: #3106533163543822514-69-1705351660 - Holdem no limit (25/100/200) - 2024/01/15 20:47:40 UTC
Table: 'W SERIES GIANT KO - DAY 1(723296116)#0177' 6-max (real money) Seat #6 is the button
Seat 1: Astaeth (52091, 1.35€ bounty)
Seat 2: ortegato93 (12909, 0.90€ bounty)
Seat 3: DingooFitoo (9950, 0.90€ bounty)
Seat 4: P1xel7 (4401, 0.90€ bounty)
Seat 5: __TOMBOLA__ (10025, 0.90€ bounty)
Seat 6: Mazel Bob (1612, 1.80€ bounty)
*** ANTE/BLINDS ***
Astaeth posts ante 25
ortegato93 posts ante 25
DingooFitoo posts ante 25
P1xel7 posts ante 25
__TOMBOLA__ posts ante 25
Mazel Bob posts ante 25
Astaeth posts small blind 100
ortegato93 posts big blind 200
Dealt to P1xel7 [As Td]
*** PRE-FLOP *** 
DingooFitoo folds
P1xel7 raises 240 to 440
__TOMBOLA__ calls 440
Mazel Bob folds
Astaeth calls 340
ortegato93 folds
*** FLOP *** [2c Qs 5h]
Astaeth checks
P1xel7 checks
__TOMBOLA__ checks
*** TURN *** [2c Qs 5h][Js]
Astaeth checks
P1xel7 checks
__TOMBOLA__ checks
*** RIVER *** [2c Qs 5h Js][8d]
Astaeth checks
P1xel7 checks
__TOMBOLA__ checks
*** SHOW DOWN ***
Astaeth shows [Th 7s] (High card : Queen)
P1xel7 shows [As Td] (High card : Ace)
__TOMBOLA__ shows [6d 6s] (One pair : 6)
__TOMBOLA__ collected 1670 from pot
*** SUMMARY ***
Total pot 1670 | No rake
Board: [2c Qs 5h Js 8d]
Seat 1: Astaeth (small blind) showed [Th 7s] and lost with High card : Queen
Seat 4: P1xel7 showed [As Td] and lost with High card : Ace
Seat 5: __TOMBOLA__ showed [6d 6s] and won 1670 with One pair : 6


Winamax Poker - Tournament "W SERIES GIANT KO - DAY 1" buyIn: 1.80€ + 0.20€ level: 5 - HandId: #3106533163543822514-70-1705351741 - Holdem no limit (25/100/200) - 2024/01/15 20:49:01 UTC
Table: 'W SERIES GIANT KO - DAY 1(723296116)#0177' 6-max (real money) Seat #1 is the button
Seat 1: Astaeth (51626, 1.35€ bounty)
Seat 2: ortegato93 (12684, 0.90€ bounty)
Seat 3: DingooFitoo (9925, 0.90€ bounty)
Seat 4: P1xel7 (3936, 0.90€ bounty)
Seat 5: __TOMBOLA__ (11230, 0.90€ bounty)
Seat 6: Mazel Bob (1587, 1.80€ bounty)
*** ANTE/BLINDS ***
ortegato93 posts ante 25
DingooFitoo posts ante 25
Astaeth posts ante 25
P1xel7 posts ante 25
__TOMBOLA__ posts ante 25
Mazel Bob posts ante 25
ortegato93 posts small blind 100
DingooFitoo posts big blind 200
Dealt to P1xel7 [Ac Tc]
*** PRE-FLOP *** 
P1xel7 raises 3711 to 3911 and is all-in
__TOMBOLA__ folds
Mazel Bob calls 1562 and is all-in
Astaeth calls 3911
ortegato93 folds
DingooFitoo folds
*** FLOP *** [3h 8c Jd]
*** TURN *** [3h 8c Jd][4h]
*** RIVER *** [3h 8c Jd 4h][9h]
*** SHOW DOWN ***
Astaeth shows [Ad 5h] (High card : Ace)
P1xel7 shows [Ac Tc] (High card : Ace)
Mazel Bob shows [Th Qc] (Straight Queen high)
Mazel Bob collected 5136 from main pot
P1xel7 collected 4698 from side pot 1
*** SUMMARY ***
Total pot 9834 | No rake
Board: [3h 8c Jd 4h 9h]
Seat 1: Astaeth (button) showed [Ad 5h] and lost with High card : Ace
Seat 4: P1xel7 showed [Ac Tc] and won 4698 with High card : Ace
Seat 6: Mazel Bob showed [Th Qc] and won 5136 with Straight Queen high


Winamax Poker - Tournament "W SERIES GIANT KO - DAY 1" buyIn: 1.80€ + 0.20€ level: 5 - HandId: #3106533163543822514-71-1705351783 - Holdem no limit (25/100/200) - 2024/01/15 20:49:43 UTC
Table: 'W SERIES GIANT KO - DAY 1(723296116)#0177' 6-max (real money) Seat #2 is the button
Seat 1: Astaeth (47690, 1.35€ bounty)
Seat 2: ortegato93 (12559, 0.90€ bounty)
Seat 3: DingooFitoo (9700, 0.90€ bounty)
Seat 4: P1xel7 (4698, 0.90€ bounty)
Seat 5: __TOMBOLA__ (11205, 0.90€ bounty)
Seat 6: Mazel Bob (5136, 1.80€ bounty)
*** ANTE/BLINDS ***
DingooFitoo posts ante 25
P1xel7 posts ante 25
Astaeth posts ante 25
ortegato93 posts ante 25
__TOMBOLA__ posts ante 25
Mazel Bob posts ante 25
DingooFitoo posts small blind 100
P1xel7 posts big blind 200
Dealt to P1xel7 [4h 3d]
*** PRE-FLOP *** 
__TOMBOLA__ folds
Mazel Bob folds
Astaeth raises 250 to 450
ortegato93 calls 450
DingooFitoo folds
P1xel7 folds
*** FLOP *** [Js Qh 3h]
Astaeth checks
ortegato93 bets 675
Astaeth folds
ortegato93 collected 2025 from pot
*** SUMMARY ***
Total pot 2025 | No rake
Board: [Js Qh 3h]
Seat 2: ortegato93 (button) won 2025


Winamax Poker - Tournament "W SERIES GIANT KO - DAY 1" buyIn: 1.80€ + 0.20€ level: 6 - HandId: #3106533163543822514-72-1705351827 - Holdem no limit (30/125/250) - 2024/01/15 20:50:27 UTC
Table: 'W SERIES GIANT KO - DAY 1(723296116)#0177' 6-max (real money) Seat #3 is the button
Seat 1: Astaeth (47215, 1.35€ bounty)
Seat 2: ortegato93 (13434, 0.90€ bounty)
Seat 3: DingooFitoo (9575, 0.90€ bounty)
Seat 4: P1xel7 (4473, 0.90€ bounty)
Seat 5: __TOMBOLA__ (11180, 0.90€ bounty)
Seat 6: Mazel Bob (5111, 1.80€ bounty)
*** ANTE/BLINDS ***
P1xel7 posts ante 30
__TOMBOLA__ posts ante 30
Astaeth posts ante 30
ortegato93 posts ante 30
DingooFitoo posts ante 30
Mazel Bob posts ante 30
P1xel7 posts small blind 125
__TOMBOLA__ posts big blind 250
Dealt to P1xel7 [Ac 9c]
*** PRE-FLOP *** 
Mazel Bob folds
Astaeth folds
ortegato93 folds
DingooFitoo raises 375 to 625
P1xel7 raises 3818 to 4443 and is all-in
__TOMBOLA__ folds
DingooFitoo calls 3818
*** FLOP *** [7d Ah 4c]
*** TURN *** [7d Ah 4c][Js]
*** RIVER *** [7d Ah 4c Js][8s]
*** SHOW DOWN ***
DingooFitoo shows [8c Tc] (One pair : 8)
P1xel7 shows [Ac 9c] (One pair : Aces)
P1xel7 collected 9316 from pot
*** SUMMARY ***
Total pot 9316 | No rake
Board: [7d Ah 4c Js 8s]
Seat 3: DingooFitoo (button) showed [8c Tc] and lost with One pair : 8
Seat 4: P1xel7 (small blind) showed [Ac 9c] and won 9316 with One pair : Aces


Winamax Poker - Tournament "W SERIES GIANT KO - DAY 1" buyIn: 1.80€ + 0.20€ level: 6 - HandId: #3106533163543822514-73-1705351867 - Holdem no limit (30/125/250) - 2024/01/15 20:51:07 UTC
Table: 'W SERIES GIANT KO - DAY 1(723296116)#0177' 6-max (real money) Seat #4 is the button
Seat 1: Astaeth (47185, 1.35€ bounty)
Seat 2: ortegato93 (13404, 0.90€ bounty)
Seat 3: DingooFitoo (5102, 0.90€ bounty)
Seat 4: P1xel7 (9316, 0.90€ bounty)
Seat 5: __TOMBOLA__ (10900, 0.90€ bounty)
Seat 6: Mazel Bob (5081, 1.80€ bounty)
*** ANTE/BLINDS ***
__TOMBOLA__ posts ante 30
Mazel Bob posts ante 30
Astaeth posts ante 30
ortegato93 posts ante 30
DingooFitoo posts ante 30
P1xel7 posts ante 30
__TOMBOLA__ posts small blind 125
Mazel Bob posts big blind 250
Dealt to P1xel7 [8d Qd]
*** PRE-FLOP *** 
Astaeth folds
ortegato93 folds
DingooFitoo folds
P1xel7 raises 375 to 625
__TOMBOLA__ folds
Mazel Bob folds
P1xel7 collected 1180 from pot
*** SUMMARY ***
Total pot 1180 | No rake
Seat 4: P1xel7 (button) won 1180


Winamax Poker - Tournament "W SERIES GIANT KO - DAY 1" buyIn: 1.80€ + 0.20€ level: 6 - HandId: #3106533163543822514-74-1705351901 - Holdem no limit (30/125/250) - 2024/01/15 20:51:41 UTC
Table: 'W SERIES GIANT KO - DAY 1(723296116)#0177' 6-max (real money) Seat #5 is the button
Seat 1: Astaeth (47155, 1.35€ bounty)
Seat 2: ortegato93 (13374, 0.90€ bounty)
Seat 3: DingooFitoo (5072, 0.90€ bounty)
Seat 4: P1xel7 (9841, 0.90€ bounty)
Seat 5: __TOMBOLA__ (10745, 0.90€ bounty)
Seat 6: Mazel Bob (4801, 1.80€ bounty)
*** ANTE/BLINDS ***
Mazel Bob posts ante 30
Astaeth posts ante 30
ortegato93 posts ante 30
DingooFitoo posts ante 30
P1xel7 posts ante 30
__TOMBOLA__ posts ante 30
Mazel Bob posts small blind 125
Astaeth posts big blind 250
Dealt to P1xel7 [Qh Ac]
*** PRE-FLOP *** 
ortegato93 folds
DingooFitoo raises 375 to 625
P1xel7 raises 1250 to 1875
__TOMBOLA__ folds
Mazel Bob folds
Astaeth folds
DingooFitoo raises 3167 to 5042 and is all-in
P1xel7 calls 3167
*** FLOP *** [7c 4d 4c]
*** TURN *** [7c 4d 4c][Qc]
*** RIVER *** [7c 4d 4c Qc][Jh]
*** SHOW DOWN ***
DingooFitoo shows [Ah 8h] (One pair : 4)
P1xel7 shows [Qh Ac] (Two pairs : Queens and 4)
P1xel7 collected 10639 from pot
*** SUMMARY ***
Total pot 10639 | No rake
Board: [7c 4d 4c Qc Jh]
Seat 3: DingooFitoo showed [Ah 8h] and lost with One pair : 4
Seat 4: P1xel7 showed [Qh Ac] and won 10639 with Two pairs : Queens and 4


Winamax Poker - Tournament "W SERIES GIANT KO - DAY 1" buyIn: 1.80€ + 0.20€ level: 6 - HandId: #3106533163543822514-75-1705351947 - Holdem no limit (30/125/250) - 2024/01/15 20:52:27 UTC
Table: 'W SERIES GIANT KO - DAY 1(723296116)#0177' 6-max (real money) Seat #6 is the button
Seat 1: Astaeth (46875, 1.35€ bounty)
Seat 2: ortegato93 (13344, 0.90€ bounty)
Seat 4: P1xel7 (15408, 1.35€ bounty)
Seat 5: __TOMBOLA__ (10715, 0.90€ bounty)
Seat 6: Mazel Bob (4646, 1.80€ bounty)
*** ANTE/BLINDS ***
Astaeth posts ante 30
ortegato93 posts ante 30
P1xel7 posts ante 30
__TOMBOLA__ posts ante 30
Mazel Bob posts ante 30
Astaeth posts small blind 125
ortegato93 posts big blind 250
Dealt to P1xel7 [2c 6h]
*** PRE-FLOP *** 
P1xel7 folds
__TOMBOLA__ folds
Mazel Bob folds
Astaeth raises 500 to 750
ortegato93 calls 500
*** FLOP *** [As Kc 2d]
Astaeth bets 578
ortegato93 folds
Astaeth collected 2228 from pot
*** SUMMARY ***
Total pot 2228 | No rake
Board: [As Kc 2d]
Seat 1: Astaeth (small blind) won 2228


Winamax Poker - Tournament "W SERIES GIANT KO - DAY 1" buyIn: 1.80€ + 0.20€ level: 6 - HandId: #3106533163543822514-76-1705351983 - Holdem no limit (30/125/250) - 2024/01/15 20:53:03 UTC
Table: 'W SERIES GIANT KO - DAY 1(723296116)#0177' 6-max (real money) Seat #1 is the button
Seat 1: Astaeth (47745, 1.35€ bounty)
Seat 2: ortegato93 (12564, 0.90€ bounty)
Seat 3: ovatsugkk (10000, 0.90€ bounty)
Seat 4: P1xel7 (15378, 1.35€ bounty)
Seat 5: __TOMBOLA__ (10685, 0.90€ bounty)
Seat 6: Mazel Bob (4616, 1.80€ bounty)
*** ANTE/BLINDS ***
ortegato93 posts ante 30
ovatsugkk posts ante 30
Astaeth posts ante 30
P1xel7 posts ante 30
__TOMBOLA__ posts ante 30
Mazel Bob posts ante 30
ortegato93 posts small blind 125
ovatsugkk posts big blind 250
Dealt to P1xel7 [2s Ts]
*** PRE-FLOP *** 
P1xel7 folds
__TOMBOLA__ folds
Mazel Bob folds
Astaeth raises 313 to 563
ortegato93 calls 438
ovatsugkk folds
*** FLOP *** [8h 9h Ad]
ortegato93 checks
Astaeth checks
*** TURN *** [8h 9h Ad][2c]
ortegato93 checks
Astaeth bets 545
ortegato93 folds
Astaeth collected 2101 from pot
*** SUMMARY ***
Total pot 2101 | No rake
Board: [8h 9h Ad 2c]
Seat 1: Astaeth (button) won 2101


Winamax Poker - Tournament "W SERIES GIANT KO - DAY 1" buyIn: 1.80€ + 0.20€ level: 6 - HandId: #3106533163543822514-77-1705352032 - Holdem no limit (30/125/250) - 2024/01/15 20:53:52 UTC
Table: 'W SERIES GIANT KO - DAY 1(723296116)#0177' 6-max (real money) Seat #2 is the button
Seat 1: Astaeth (48708, 1.35€ bounty)
Seat 2: ortegato93 (11971, 0.90€ bounty)
Seat 3: ovatsugkk (9720, 0.90€ bounty)
Seat 4: P1xel7 (15348, 1.35€ bounty)
Seat 5: __TOMBOLA__ (10655, 0.90€ bounty)
Seat 6: Mazel Bob (4586, 1.80€ bounty)
*** ANTE/BLINDS ***
ovatsugkk posts ante 30
P1xel7 posts ante 30
Astaeth posts ante 30
ortegato93 posts ante 30
__TOMBOLA__ posts ante 30
Mazel Bob posts ante 30
ovatsugkk posts small blind 125
P1xel7 posts big blind 250
Dealt to P1xel7 [Td 4s]
*** PRE-FLOP *** 
__TOMBOLA__ folds
Mazel Bob raises 4306 to 4556 and is all-in
Astaeth folds
ortegato93 folds
ovatsugkk folds
P1xel7 folds
Mazel Bob collected 5111 from pot
*** SUMMARY ***
Total pot 5111 | No rake
Seat 6: Mazel Bob won 5111


Winamax Poker - Tournament "W SERIES GIANT KO - DAY 1" buyIn: 1.80€ + 0.20€ level: 6 - HandId: #3106533163543822514-78-1705352051 - Holdem no limit (30/125/250) - 2024/01/15 20:54:11 UTC
Table: 'W SERIES GIANT KO - DAY 1(723296116)#0177' 6-max (real money) Seat #3 is the button
Seat 1: Astaeth (48678, 1.35€ bounty)
Seat 2: ortegato93 (11941, 0.90€ bounty)
Seat 3: ovatsugkk (9565, 0.90€ bounty)
Seat 4: P1xel7 (15068, 1.35€ bounty)
Seat 5: __TOMBOLA__ (10625, 0.90€ bounty)
Seat 6: Mazel Bob (5111, 1.80€ bounty)
*** ANTE/BLINDS ***
P1xel7 posts ante 30
__TOMBOLA__ posts ante 30
Astaeth posts ante 30
ortegato93 posts ante 30
ovatsugkk posts ante 30
Mazel Bob posts ante 30
P1xel7 posts small blind 125
__TOMBOLA__ posts big blind 250
Dealt to P1xel7 [Qc 3c]
*** PRE-FLOP *** 
Mazel Bob folds
Astaeth raises 313 to 563
ortegato93 raises 1681 to 2244
ovatsugkk folds
P1xel7 folds
__TOMBOLA__ folds
Astaeth raises 46404 to 48648 and is all-in
ortegato93 calls 9667 and is all-in
*** FLOP *** [Ac Kd 6s]
*** TURN *** [Ac Kd 6s][6h]
*** RIVER *** [Ac Kd 6s 6h][Jh]
*** SHOW DOWN ***
ortegato93 shows [8h 8s] (Two pairs : 8 and 6)
Astaeth shows [Ks Ah] (Two pairs : Aces and Kings)
Astaeth collected 61114 from pot
*** SUMMARY ***
Total pot 61114 | No rake
Board: [Ac Kd 6s 6h Jh]
Seat 1: Astaeth showed [Ks Ah] and won 61114 with Two pairs : Aces and Kings
Seat 2: ortegato93 showed [8h 8s] and lost with Two pairs : 8 and 6


Winamax Poker - Tournament "W SERIES GIANT KO - DAY 1" buyIn: 1.80€ + 0.20€ level: 6 - HandId: #3106533163543822514-79-1705352092 - Holdem no limit (30/125/250) - 2024/01/15 20:54:52 UTC
Table: 'W SERIES GIANT KO - DAY 1(723296116)#0177' 6-max (real money) Seat #4 is the button
Seat 1: Astaeth (61114, 1.80€ bounty)
Seat 3: ovatsugkk (9535, 0.90€ bounty)
Seat 4: P1xel7 (14913, 1.35€ bounty)
Seat 5: __TOMBOLA__ (10345, 0.90€ bounty)
Seat 6: Mazel Bob (5081, 1.80€ bounty)
*** ANTE/BLINDS ***
__TOMBOLA__ posts ante 30
Mazel Bob posts ante 30
Astaeth posts ante 30
ovatsugkk posts ante 30
P1xel7 posts ante 30
__TOMBOLA__ posts small blind 125
Mazel Bob posts big blind 250
Dealt to P1xel7 [Ts Ah]
*** PRE-FLOP *** 
Astaeth folds
ovatsugkk raises 250 to 500
P1xel7 raises 1375 to 1875
__TOMBOLA__ folds
Mazel Bob folds
ovatsugkk folds
P1xel7 collected 2900 from pot
*** SUMMARY ***
Total pot 2900 | No rake
Seat 4: P1xel7 (button) won 2900


Winamax Poker - Tournament "W SERIES GIANT KO - DAY 1" buyIn: 1.80€ + 0.20€ level: 6 - HandId: #3106533163543822514-80-1705352464 - Holdem no limit (30/125/250) - 2024/01/15 21:01:04 UTC
Table: 'W SERIES GIANT KO - DAY 1(723296116)#0177' 6-max (real money) Seat #5 is the button
Seat 1: Astaeth (61084, 1.80€ bounty)
Seat 2: CHURROS MAYO (10000, 0.90€ bounty)
Seat 3: ovatsugkk (9005, 0.90€ bounty)
Seat 4: P1xel7 (15908, 1.35€ bounty)
Seat 5: __TOMBOLA__ (10190, 0.90€ bounty)
Seat 6: Mazel Bob (4801, 1.80€ bounty)
*** ANTE/BLINDS ***
Mazel Bob posts ante 30
Astaeth posts ante 30
CHURROS MAYO posts ante 30
ovatsugkk posts ante 30
P1xel7 posts ante 30
__TOMBOLA__ posts ante 30
Mazel Bob posts small blind 125
Astaeth posts big blind 250
Dealt to P1xel7 [6s Td]
*** PRE-FLOP *** 
CHURROS MAYO raises 375 to 625
ovatsugkk folds
P1xel7 folds
__TOMBOLA__ raises 1125 to 1750
Mazel Bob folds
Astaeth folds
CHURROS MAYO calls 1125
*** FLOP *** [9c Qc Tc]
CHURROS MAYO bets 1875
__TOMBOLA__ raises 6535 to 8410 and is all-in
CHURROS MAYO calls 6345 and is all-in
*** TURN *** [9c Qc Tc][9s]
*** RIVER *** [9c Qc Tc 9s][2h]
*** SHOW DOWN ***
CHURROS MAYO shows [Ac 7h] (One pair : 9)
__TOMBOLA__ shows [Th Ts] (Full of Tens and 9)
__TOMBOLA__ collected 20685 from pot
*** SUMMARY ***
Total pot 20685 | No rake
Board: [9c Qc Tc 9s 2h]
Seat 2: CHURROS MAYO showed [Ac 7h] and lost with One pair : 9
Seat 5: __TOMBOLA__ (button) showed [Th Ts] and won 20685 with Full of Tens and 9


Winamax Poker - Tournament "W SERIES GIANT KO - DAY 1" buyIn: 1.80€ + 0.20€ level: 6 - HandId: #3106533163543822514-81-1705352590 - Holdem no limit (30/125/250) - 2024/01/15 21:03:10 UTC
Table: 'W SERIES GIANT KO - DAY 1(723296116)#0177' 6-max (real money) Seat #6 is the button
Seat 1: Astaeth (60804, 1.80€ bounty)
Seat 3: ovatsugkk (8975, 0.90€ bounty)
Seat 4: P1xel7 (15878, 1.35€ bounty)
Seat 5: __TOMBOLA__ (20685, 1.35€ bounty)
Seat 6: Mazel Bob (4646, 1.80€ bounty)
*** ANTE/BLINDS ***
Astaeth posts ante 30
ovatsugkk posts ante 30
P1xel7 posts ante 30
__TOMBOLA__ posts ante 30
Mazel Bob posts ante 30
Astaeth posts small blind 125
ovatsugkk posts big blind 250
Dealt to P1xel7 [7c Ac]
*** PRE-FLOP *** 
P1xel7 folds
__TOMBOLA__ folds
Mazel Bob calls 250
Astaeth folds
ovatsugkk checks
*** FLOP *** [9h 4s 2h]
ovatsugkk checks
Mazel Bob checks
*** TURN *** [9h 4s 2h][6d]
ovatsugkk checks
Mazel Bob bets 775
ovatsugkk folds
Mazel Bob collected 1550 from pot
*** SUMMARY ***
Total pot 1550 | No rake
Board: [9h 4s 2h 6d]
Seat 6: Mazel Bob (button) won 1550


Winamax Poker - Tournament "W SERIES GIANT KO - DAY 1" buyIn: 1.80€ + 0.20€ level: 6 - HandId: #3106533163543822514-82-1705352677 - Holdem no limit (30/125/250) - 2024/01/15 21:04:37 UTC
Table: 'W SERIES GIANT KO - DAY 1(723296116)#0177' 6-max (real money) Seat #1 is the button
Seat 1: Astaeth (60649, 1.80€ bounty)
Seat 3: ovatsugkk (8695, 0.90€ bounty)
Seat 4: P1xel7 (15848, 1.35€ bounty)
Seat 5: __TOMBOLA__ (20655, 1.35€ bounty)
Seat 6: Mazel Bob (5141, 1.80€ bounty)
*** ANTE/BLINDS ***
ovatsugkk posts ante 30
P1xel7 posts ante 30
Astaeth posts ante 30
__TOMBOLA__ posts ante 30
Mazel Bob posts ante 30
ovatsugkk posts small blind 125
P1xel7 posts big blind 250
Dealt to P1xel7 [7h Qh]
*** PRE-FLOP *** 
__TOMBOLA__ folds
Mazel Bob folds
Astaeth raises 313 to 563
ovatsugkk calls 438
P1xel7 calls 313
*** FLOP *** [9h 2d 5d]
ovatsugkk checks
P1xel7 checks
Astaeth bets 1195
ovatsugkk calls 1195
P1xel7 folds
*** TURN *** [9h 2d 5d][2h]
ovatsugkk checks
Astaeth bets 2115
ovatsugkk folds
Astaeth collected 6344 from pot
*** SUMMARY ***
Total pot 6344 | No rake
Board: [9h 2d 5d 2h]
Seat 1: Astaeth (button) won 6344


Winamax Poker - Tournament "W SERIES GIANT KO - DAY 1" buyIn: 1.80€ + 0.20€ level: 6 - HandId: #3106533163543822514-83-1705352760 - Holdem no limit (30/125/250) - 2024/01/15 21:06:00 UTC
Table: 'W SERIES GIANT KO - DAY 1(723296116)#0177' 6-max (real money) Seat #3 is the button
Seat 1: Astaeth (63090, 1.80€ bounty)
Seat 2: Zzzdoerrr (10000, 0.90€ bounty)
Seat 3: ovatsugkk (6907, 0.90€ bounty)
Seat 4: P1xel7 (15255, 1.35€ bounty)
Seat 5: __TOMBOLA__ (20625, 1.35€ bounty)
Seat 6: Mazel Bob (5111, 1.80€ bounty)
*** ANTE/BLINDS ***
P1xel7 posts ante 30
__TOMBOLA__ posts ante 30
Astaeth posts ante 30
Zzzdoerrr posts ante 30
ovatsugkk posts ante 30
Mazel Bob posts ante 30
P1xel7 posts small blind 125
__TOMBOLA__ posts big blind 250
Dealt to P1xel7 [As 2d]
*** PRE-FLOP *** 
Mazel Bob folds
Astaeth folds
Zzzdoerrr folds
ovatsugkk folds
P1xel7 raises 300 to 550
__TOMBOLA__ calls 300
*** FLOP *** [9h 4h 6s]
P1xel7 checks
__TOMBOLA__ checks
*** TURN *** [9h 4h 6s][2h]
P1xel7 bets 320
__TOMBOLA__ folds
P1xel7 collected 1600 from pot
*** SUMMARY ***
Total pot 1600 | No rake
Board: [9h 4h 6s 2h]
Seat 4: P1xel7 (small blind) won 1600


Winamax Poker - Tournament "W SERIES GIANT KO - DAY 1" buyIn: 1.80€ + 0.20€ level: 6 - HandId: #3106533163543822514-84-1705352827 - Holdem no limit (30/125/250) - 2024/01/15 21:07:07 UTC
Table: 'W SERIES GIANT KO - DAY 1(723296116)#0177' 6-max (real money) Seat #4 is the button
Seat 1: Astaeth (63060, 1.80€ bounty)
Seat 2: Zzzdoerrr (9970, 0.90€ bounty)
Seat 3: ovatsugkk (6877, 0.90€ bounty)
Seat 4: P1xel7 (15955, 1.35€ bounty)
Seat 5: __TOMBOLA__ (20045, 1.35€ bounty)
Seat 6: Mazel Bob (5081, 1.80€ bounty)
*** ANTE/BLINDS ***
__TOMBOLA__ posts ante 30
Mazel Bob posts ante 30
Astaeth posts ante 30
Zzzdoerrr posts ante 30
ovatsugkk posts ante 30
P1xel7 posts ante 30
__TOMBOLA__ posts small blind 125
Mazel Bob posts big blind 250
Dealt to P1xel7 [3s 6c]
*** PRE-FLOP *** 
Astaeth folds
Zzzdoerrr raises 250 to 500
ovatsugkk folds
P1xel7 folds
__TOMBOLA__ folds
Mazel Bob folds
Zzzdoerrr collected 1055 from pot
*** SUMMARY ***
Total pot 1055 | No rake
Seat 2: Zzzdoerrr won 1055


Winamax Poker - Tournament "W SERIES GIANT KO - DAY 1" buyIn: 1.80€ + 0.20€ level: 7 - HandId: #3106533163543822514-85-1705352854 - Holdem no limit (35/150/300) - 2024/01/15 21:07:34 UTC
Table: 'W SERIES GIANT KO - DAY 1(723296116)#0177' 6-max (real money) Seat #5 is the button
Seat 1: Astaeth (63030, 1.80€ bounty)
Seat 2: Zzzdoerrr (10495, 0.90€ bounty)
Seat 3: ovatsugkk (6847, 0.90€ bounty)
Seat 4: P1xel7 (15925, 1.35€ bounty)
Seat 5: __TOMBOLA__ (19890, 1.35€ bounty)
Seat 6: Mazel Bob (4801, 1.80€ bounty)
*** ANTE/BLINDS ***
Mazel Bob posts ante 35
Astaeth posts ante 35
Zzzdoerrr posts ante 35
ovatsugkk posts ante 35
P1xel7 posts ante 35
__TOMBOLA__ posts ante 35
Mazel Bob posts small blind 150
Astaeth posts big blind 300
Dealt to P1xel7 [8c Qd]
*** PRE-FLOP *** 
Zzzdoerrr folds
ovatsugkk folds
P1xel7 folds
__TOMBOLA__ raises 300 to 600
Mazel Bob folds
Astaeth calls 300
*** FLOP *** [7h 6s 8s]
Astaeth checks
__TOMBOLA__ bets 468
Astaeth calls 468
*** TURN *** [7h 6s 8s][Th]
Astaeth checks
__TOMBOLA__ checks
*** RIVER *** [7h 6s 8s Th][9h]
Astaeth checks
__TOMBOLA__ checks
*** SHOW DOWN ***
Astaeth shows [9d Ts] (Straight Ten high)
__TOMBOLA__ shows [Qs 7s] (Straight Ten high)
__TOMBOLA__ collected 1248 from pot
Astaeth collected 1248 from pot
*** SUMMARY ***
Total pot 2496 | No rake
Board: [7h 6s 8s Th 9h]
Seat 1: Astaeth (big blind) showed [9d Ts] and won 1248 with Straight Ten high
Seat 5: __TOMBOLA__ (button) showed [Qs 7s] and won 1248 with Straight Ten high


Winamax Poker - Tournament "W SERIES GIANT KO - DAY 1" buyIn: 1.80€ + 0.20€ level: 7 - HandId: #3106533163543822514-86-1705352925 - Holdem no limit (35/150/300) - 2024/01/15 21:08:45 UTC
Table: 'W SERIES GIANT KO - DAY 1(723296116)#0177' 6-max (real money) Seat #6 is the button
Seat 1: Astaeth (63175, 1.80€ bounty)
Seat 2: Zzzdoerrr (10460, 0.90€ bounty)
Seat 3: ovatsugkk (6812, 0.90€ bounty)
Seat 4: P1xel7 (15890, 1.35€ bounty)
Seat 5: __TOMBOLA__ (20035, 1.35€ bounty)
Seat 6: Mazel Bob (4616, 1.80€ bounty)
*** ANTE/BLINDS ***
Astaeth posts ante 35
Zzzdoerrr posts ante 35
ovatsugkk posts ante 35
P1xel7 posts ante 35
__TOMBOLA__ posts ante 35
Mazel Bob posts ante 35
Astaeth posts small blind 150
Zzzdoerrr posts big blind 300
Dealt to P1xel7 [7c 7d]
*** PRE-FLOP *** 
ovatsugkk folds
P1xel7 raises 450 to 750
__TOMBOLA__ calls 750
Mazel Bob folds
Astaeth folds
Zzzdoerrr calls 450
*** FLOP *** [Ac 4c 2d]
Zzzdoerrr checks
P1xel7 bets 1305
__TOMBOLA__ calls 1305
Zzzdoerrr folds
*** TURN *** [Ac 4c 2d][3c]
P1xel7 bets 1827
__TOMBOLA__ folds
P1xel7 collected 7047 from pot
*** SUMMARY ***
Total pot 7047 | No rake
Board: [Ac 4c 2d 3c]
Seat 4: P1xel7 won 7047


Winamax Poker - Tournament "W SERIES GIANT KO - DAY 1" buyIn: 1.80€ + 0.20€ level: 7 - HandId: #3106533163543822514-87-1705353000 - Holdem no limit (35/150/300) - 2024/01/15 21:10:00 UTC
Table: 'W SERIES GIANT KO - DAY 1(723296116)#0177' 6-max (real money) Seat #1 is the button
Seat 1: Astaeth (62990, 1.80€ bounty)
Seat 2: Zzzdoerrr (9675, 0.90€ bounty)
Seat 3: ovatsugkk (6777, 0.90€ bounty)
Seat 4: P1xel7 (19020, 1.35€ bounty)
Seat 5: __TOMBOLA__ (17945, 1.35€ bounty)
Seat 6: Mazel Bob (4581, 1.80€ bounty)
*** ANTE/BLINDS ***
Zzzdoerrr posts ante 35
ovatsugkk posts ante 35
Astaeth posts ante 35
P1xel7 posts ante 35
__TOMBOLA__ posts ante 35
Mazel Bob posts ante 35
Zzzdoerrr posts small blind 150
ovatsugkk posts big blind 300
Dealt to P1xel7 [5d Kd]
*** PRE-FLOP *** 
P1xel7 folds
__TOMBOLA__ folds
Mazel Bob folds
Astaeth folds
Zzzdoerrr raises 300 to 600
ovatsugkk folds
Zzzdoerrr collected 1110 from pot
*** SUMMARY ***
Total pot 1110 | No rake
Seat 2: Zzzdoerrr (small blind) won 1110


Winamax Poker - Tournament "W SERIES GIANT KO - DAY 1" buyIn: 1.80€ + 0.20€ level: 7 - HandId: #3106533163543822514-88-1705353027 - Holdem no limit (35/150/300) - 2024/01/15 21:10:27 UTC
Table: 'W SERIES GIANT KO - DAY 1(723296116)#0177' 6-max (real money) Seat #2 is the button
Seat 1: Astaeth (62955, 1.80€ bounty)
Seat 2: Zzzdoerrr (10150, 0.90€ bounty)
Seat 3: ovatsugkk (6442, 0.90€ bounty)
Seat 4: P1xel7 (18985, 1.35€ bounty)
Seat 5: __TOMBOLA__ (17910, 1.35€ bounty)
Seat 6: Mazel Bob (4546, 1.80€ bounty)
*** ANTE/BLINDS ***
ovatsugkk posts ante 35
P1xel7 posts ante 35
Astaeth posts ante 35
Zzzdoerrr posts ante 35
__TOMBOLA__ posts ante 35
Mazel Bob posts ante 35
ovatsugkk posts small blind 150
P1xel7 posts big blind 300
Dealt to P1xel7 [Th 6c]
*** PRE-FLOP *** 
__TOMBOLA__ folds
Mazel Bob raises 4211 to 4511 and is all-in
Astaeth folds
Zzzdoerrr folds
ovatsugkk folds
P1xel7 folds
Mazel Bob collected 5171 from pot
*** SUMMARY ***
Total pot 5171 | No rake
Seat 6: Mazel Bob won 5171


Winamax Poker - Tournament "W SERIES GIANT KO - DAY 1" buyIn: 1.80€ + 0.20€ level: 7 - HandId: #3106533163543822514-89-1705353056 - Holdem no limit (35/150/300) - 2024/01/15 21:10:56 UTC
Table: 'W SERIES GIANT KO - DAY 1(723296116)#0177' 6-max (real money) Seat #3 is the button
Seat 1: Astaeth (62920, 1.80€ bounty)
Seat 2: Zzzdoerrr (10115, 0.90€ bounty)
Seat 3: ovatsugkk (6257, 0.90€ bounty)
Seat 4: P1xel7 (18650, 1.35€ bounty)
Seat 5: __TOMBOLA__ (17875, 1.35€ bounty)
Seat 6: Mazel Bob (5171, 1.80€ bounty)
*** ANTE/BLINDS ***
P1xel7 posts ante 35
__TOMBOLA__ posts ante 35
Astaeth posts ante 35
Zzzdoerrr posts ante 35
ovatsugkk posts ante 35
Mazel Bob posts ante 35
P1xel7 posts small blind 150
__TOMBOLA__ posts big blind 300
Dealt to P1xel7 [5s Qd]
*** PRE-FLOP *** 
Mazel Bob folds
Astaeth raises 375 to 675
Zzzdoerrr folds
ovatsugkk folds
P1xel7 folds
__TOMBOLA__ calls 375
*** FLOP *** [Jh 9d 4h]
__TOMBOLA__ checks
Astaeth bets 428
__TOMBOLA__ calls 428
*** TURN *** [Jh 9d 4h][Ts]
__TOMBOLA__ checks
Astaeth bets 1668
__TOMBOLA__ calls 1668
*** RIVER *** [Jh 9d 4h Ts][7d]
__TOMBOLA__ bets 15069 and is all-in
Astaeth calls 15069
*** SHOW DOWN ***
__TOMBOLA__ shows [Qs Td] (One pair : Tens)
Astaeth shows [8c Kc] (Straight Jack high)
Astaeth collected 36040 from pot
*** SUMMARY ***
Total pot 36040 | No rake
Board: [Jh 9d 4h Ts 7d]
Seat 1: Astaeth showed [8c Kc] and won 36040 with Straight Jack high
Seat 5: __TOMBOLA__ (big blind) showed [Qs Td] and lost with One pair : Tens


Winamax Poker - Tournament "W SERIES GIANT KO - DAY 1" buyIn: 1.80€ + 0.20€ level: 7 - HandId: #3106533163543822514-90-1705353170 - Holdem no limit (35/150/300) - 2024/01/15 21:12:50 UTC
Table: 'W SERIES GIANT KO - DAY 1(723296116)#0177' 6-max (real money) Seat #4 is the button
Seat 1: Astaeth (81085, 2.47€ bounty)
Seat 2: Zzzdoerrr (10080, 0.90€ bounty)
Seat 3: ovatsugkk (6222, 0.90€ bounty)
Seat 4: P1xel7 (18465, 1.35€ bounty)
Seat 6: Mazel Bob (5136, 1.80€ bounty)
*** ANTE/BLINDS ***
Mazel Bob posts ante 35
Astaeth posts ante 35
Zzzdoerrr posts ante 35
ovatsugkk posts ante 35
P1xel7 posts ante 35
Mazel Bob posts big blind 300
Dealt to P1xel7 [Th Kd]
*** PRE-FLOP *** 
Astaeth raises 375 to 675
Zzzdoerrr folds
ovatsugkk folds
P1xel7 calls 675
Mazel Bob folds
*** FLOP *** [Ks 7s Qc]
Astaeth checks
P1xel7 checks
*** TURN *** [Ks 7s Qc][Tc]
Astaeth checks
P1xel7 bets 639
Astaeth folds
P1xel7 collected 2464 from pot
*** SUMMARY ***
Total pot 2464 | No rake
Board: [Ks 7s Qc Tc]
Seat 4: P1xel7 (button) won 2464


Winamax Poker - Tournament "W SERIES GIANT KO - DAY 1" buyIn: 1.80€ + 0.20€ level: 7 - HandId: #3106533163543822514-91-1705353221 - Holdem no limit (35/150/300) - 2024/01/15 21:13:41 UTC
Table: 'W SERIES GIANT KO - DAY 1(723296116)#0177' 6-max (real money) Seat #5 is the button
Seat 1: Astaeth (80375, 2.47€ bounty)
Seat 2: Zzzdoerrr (10045, 0.90€ bounty)
Seat 3: ovatsugkk (6187, 0.90€ bounty)
Seat 4: P1xel7 (19580, 1.35€ bounty)
Seat 6: Mazel Bob (4801, 1.80€ bounty)
*** ANTE/BLINDS ***
Mazel Bob posts ante 35
Astaeth posts ante 35
Zzzdoerrr posts ante 35
ovatsugkk posts ante 35
P1xel7 posts ante 35
Mazel Bob posts small blind 150
Astaeth posts big blind 300
Dealt to P1xel7 [9h 7h]
*** PRE-FLOP *** 
Zzzdoerrr folds
ovatsugkk folds
P1xel7 folds
Mazel Bob raises 4466 to 4766 and is all-in
Astaeth calls 4466
*** FLOP *** [5s 2d 7c]
*** TURN *** [5s 2d 7c][Td]
*** RIVER *** [5s 2d 7c Td][Kh]
*** SHOW DOWN ***
Mazel Bob shows [Qh Tc] (One pair : Tens)
Astaeth shows [Ah Th] (One pair : Tens)
Astaeth collected 9707 from pot
*** SUMMARY ***
Total pot 9707 | No rake
Board: [5s 2d 7c Td Kh]
Seat 1: Astaeth (big blind) showed [Ah Th] and won 9707 with One pair : Tens
Seat 6: Mazel Bob (small blind) showed [Qh Tc] and lost with One pair : Tens


Winamax Poker - Tournament "W SERIES GIANT KO - DAY 1" buyIn: 1.80€ + 0.20€ level: 7 - HandId: #3106533163543822514-92-1705353247 - Holdem no limit (35/150/300) - 2024/01/15 21:14:07 UTC
Table: 'W SERIES GIANT KO - DAY 1(723296116)#0177' 6-max (real money) Seat #6 is the button
Seat 1: Astaeth (85281, 3.37€ bounty)
Seat 2: Zzzdoerrr (10010, 0.90€ bounty)
Seat 3: ovatsugkk (6152, 0.90€ bounty)
Seat 4: P1xel7 (19545, 1.35€ bounty)
*** ANTE/BLINDS ***
Astaeth posts ante 35
Zzzdoerrr posts ante 35
ovatsugkk posts ante 35
P1xel7 posts ante 35
Astaeth posts small blind 150
Zzzdoerrr posts big blind 300
Dealt to P1xel7 [6c 8h]
*** PRE-FLOP *** 
ovatsugkk folds
P1xel7 folds
Astaeth folds
Zzzdoerrr collected 590 from pot
*** SUMMARY ***
Total pot 590 | No rake
Seat 2: Zzzdoerrr (big blind) won 590


Winamax Poker - Tournament "W SERIES GIANT KO - DAY 1" buyIn: 1.80€ + 0.20€ level: 7 - HandId: #3106533163543822514-93-1705353275 - Holdem no limit (35/150/300) - 2024/01/15 21:14:35 UTC
Table: 'W SERIES GIANT KO - DAY 1(723296116)#0177' 6-max (real money) Seat #1 is the button
Seat 1: Astaeth (85096, 3.37€ bounty)
Seat 2: Zzzdoerrr (10265, 0.90€ bounty)
Seat 3: ovatsugkk (6117, 0.90€ bounty)
Seat 4: P1xel7 (19510, 1.35€ bounty)
Seat 6: nobbla57 (7638, 0.90€ bounty)
*** ANTE/BLINDS ***
Zzzdoerrr posts ante 35
ovatsugkk posts ante 35
Astaeth posts ante 35
P1xel7 posts ante 35
nobbla57 posts ante 35
Zzzdoerrr posts small blind 150
ovatsugkk posts big blind 300
Dealt to P1xel7 [Ks Th]
*** PRE-FLOP *** 
P1xel7 raises 360 to 660
nobbla57 folds
Astaeth raises 1440 to 2100
Zzzdoerrr raises 8130 to 10230 and is all-in
ovatsugkk folds
P1xel7 folds
Astaeth calls 8130
*** FLOP *** [Kh 4d 4h]
*** TURN *** [Kh 4d 4h][Tc]
*** RIVER *** [Kh 4d 4h Tc][2h]
*** SHOW DOWN ***
Astaeth shows [As Qs] (One pair : 4)
Zzzdoerrr shows [7s 7c] (Two pairs : 7 and 4)
Zzzdoerrr collected 21595 from pot
*** SUMMARY ***
Total pot 21595 | No rake
Board: [Kh 4d 4h Tc 2h]
Seat 1: Astaeth (button) showed [As Qs] and lost with One pair : 4
Seat 2: Zzzdoerrr (small blind) showed [7s 7c] and won 21595 with Two pairs : 7 and 4


Winamax Poker - Tournament "W SERIES GIANT KO - DAY 1" buyIn: 1.80€ + 0.20€ level: 7 - HandId: #3106533163543822514-94-1705353312 - Holdem no limit (35/150/300) - 2024/01/15 21:15:12 UTC
Table: 'W SERIES GIANT KO - DAY 1(723296116)#0177' 6-max (real money) Seat #2 is the button
Seat 1: Astaeth (74831, 3.37€ bounty)
Seat 2: Zzzdoerrr (21595, 0.90€ bounty)
Seat 3: ovatsugkk (5782, 0.90€ bounty)
Seat 4: P1xel7 (18815, 1.35€ bounty)
Seat 6: nobbla57 (7603, 0.90€ bounty)
*** ANTE/BLINDS ***
ovatsugkk posts ante 35
P1xel7 posts ante 35
Astaeth posts ante 35
Zzzdoerrr posts ante 35
nobbla57 posts ante 35
ovatsugkk posts small blind 150
P1xel7 posts big blind 300
Dealt to P1xel7 [Jc 3h]
*** PRE-FLOP *** 
nobbla57 raises 300 to 600
Astaeth raises 1200 to 1800
Zzzdoerrr folds
ovatsugkk folds
P1xel7 folds
nobbla57 raises 5768 to 7568 and is all-in
Astaeth calls 5768
*** FLOP *** [5c Th As]
*** TURN *** [5c Th As][6d]
*** RIVER *** [5c Th As 6d][6c]
*** SHOW DOWN ***
Astaeth shows [Kd Qc] (One pair : 6)
nobbla57 shows [4h 4d] (Two pairs : 6 and 4)
nobbla57 collected 15761 from pot
*** SUMMARY ***
Total pot 15761 | No rake
Board: [5c Th As 6d 6c]
Seat 1: Astaeth showed [Kd Qc] and lost with One pair : 6
Seat 6: nobbla57 showed [4h 4d] and won 15761 with Two pairs : 6 and 4


Winamax Poker - Tournament "W SERIES GIANT KO - DAY 1" buyIn: 1.80€ + 0.20€ level: 7 - HandId: #3106533163543822514-95-1705353354 - Holdem no limit (35/150/300) - 2024/01/15 21:15:54 UTC
Table: 'W SERIES GIANT KO - DAY 1(723296116)#0177' 6-max (real money) Seat #3 is the button
Seat 1: Astaeth (67228, 3.37€ bounty)
Seat 2: Zzzdoerrr (21560, 0.90€ bounty)
Seat 3: ovatsugkk (5597, 0.90€ bounty)
Seat 4: P1xel7 (18480, 1.35€ bounty)
Seat 5: Arte & Marte (10000, 0.90€ bounty)
Seat 6: nobbla57 (15761, 0.90€ bounty)
*** ANTE/BLINDS ***
P1xel7 posts ante 35
Arte & Marte posts ante 35
Astaeth posts ante 35
Zzzdoerrr posts ante 35
ovatsugkk posts ante 35
nobbla57 posts ante 35
P1xel7 posts small blind 150
Arte & Marte posts big blind 300
Dealt to P1xel7 [6s 2h]
*** PRE-FLOP *** 
nobbla57 folds
Astaeth raises 375 to 675
Zzzdoerrr folds
ovatsugkk folds
P1xel7 folds
Arte & Marte folds
Astaeth collected 1335 from pot
*** SUMMARY ***
Total pot 1335 | No rake
Seat 1: Astaeth won 1335


Winamax Poker - Tournament "W SERIES GIANT KO - DAY 1" buyIn: 1.80€ + 0.20€ level: 7 - HandId: #3106533163543822514-96-1705353364 - Holdem no limit (35/150/300) - 2024/01/15 21:16:04 UTC
Table: 'W SERIES GIANT KO - DAY 1(723296116)#0177' 6-max (real money) Seat #4 is the button
Seat 1: Astaeth (67853, 3.37€ bounty)
Seat 2: Zzzdoerrr (21525, 0.90€ bounty)
Seat 3: ovatsugkk (5562, 0.90€ bounty)
Seat 4: P1xel7 (18295, 1.35€ bounty)
Seat 5: Arte & Marte (9665, 0.90€ bounty)
Seat 6: nobbla57 (15726, 0.90€ bounty)
*** ANTE/BLINDS ***
Arte & Marte posts ante 35
nobbla57 posts ante 35
Astaeth posts ante 35
Zzzdoerrr posts ante 35
ovatsugkk posts ante 35
P1xel7 posts ante 35
Arte & Marte posts small blind 150
nobbla57 posts big blind 300
Dealt to P1xel7 [Tc 4h]
*** PRE-FLOP *** 
Astaeth folds
Zzzdoerrr folds
ovatsugkk raises 300 to 600
P1xel7 folds
Arte & Marte folds
nobbla57 folds
ovatsugkk collected 1260 from pot
*** SUMMARY ***
Total pot 1260 | No rake
Seat 3: ovatsugkk won 1260


Winamax Poker - Tournament "W SERIES GIANT KO - DAY 1" buyIn: 1.80€ + 0.20€ level: 7 - HandId: #3106533163543822514-97-1705353381 - Holdem no limit (35/150/300) - 2024/01/15 21:16:21 UTC
Table: 'W SERIES GIANT KO - DAY 1(723296116)#0177' 6-max (real money) Seat #5 is the button
Seat 1: Astaeth (67818, 3.37€ bounty)
Seat 2: Zzzdoerrr (21490, 0.90€ bounty)
Seat 3: ovatsugkk (6187, 0.90€ bounty)
Seat 4: P1xel7 (18260, 1.35€ bounty)
Seat 5: Arte & Marte (9480, 0.90€ bounty)
Seat 6: nobbla57 (15391, 0.90€ bounty)
*** ANTE/BLINDS ***
nobbla57 posts ante 35
Astaeth posts ante 35
Zzzdoerrr posts ante 35
ovatsugkk posts ante 35
P1xel7 posts ante 35
Arte & Marte posts ante 35
nobbla57 posts small blind 150
Astaeth posts big blind 300
Dealt to P1xel7 [8c Ad]
*** PRE-FLOP *** 
Zzzdoerrr folds
ovatsugkk folds
P1xel7 raises 360 to 660
Arte & Marte calls 660
nobbla57 calls 510
Astaeth calls 360
*** FLOP *** [5d 2d Kc]
nobbla57 checks
Astaeth checks
P1xel7 checks
Arte & Marte checks
*** TURN *** [5d 2d Kc][3h]
nobbla57 checks
Astaeth checks
P1xel7 checks
Arte & Marte bets 1853
nobbla57 folds
Astaeth folds
P1xel7 calls 1853
*** RIVER *** [5d 2d Kc 3h][Qd]
P1xel7 checks
Arte & Marte checks
*** SHOW DOWN ***
P1xel7 shows [8c Ad] (High card : Ace)
Arte & Marte shows [7h 5h] (One pair : 5)
Arte & Marte collected 6556 from pot
*** SUMMARY ***
Total pot 6556 | No rake
Board: [5d 2d Kc 3h Qd]
Seat 4: P1xel7 showed [8c Ad] and lost with High card : Ace
Seat 5: Arte & Marte (button) showed [7h 5h] and won 6556 with One pair : 5


Winamax Poker - Tournament "W SERIES GIANT KO - DAY 1" buyIn: 1.80€ + 0.20€ level: 7 - HandId: #3106533163543822514-98-1705353456 - Holdem no limit (35/150/300) - 2024/01/15 21:17:36 UTC
Table: 'W SERIES GIANT KO - DAY 1(723296116)#0177' 6-max (real money) Seat #6 is the button
Seat 1: Astaeth (67123, 3.37€ bounty)
Seat 2: Zzzdoerrr (21455, 0.90€ bounty)
Seat 3: ovatsugkk (6152, 0.90€ bounty)
Seat 4: P1xel7 (15712, 1.35€ bounty)
Seat 5: Arte & Marte (13488, 0.90€ bounty)
Seat 6: nobbla57 (14696, 0.90€ bounty)
*** ANTE/BLINDS ***
Astaeth posts ante 35
Zzzdoerrr posts ante 35
ovatsugkk posts ante 35
P1xel7 posts ante 35
Arte & Marte posts ante 35
nobbla57 posts ante 35
Astaeth posts small blind 150
Zzzdoerrr posts big blind 300
Dealt to P1xel7 [2d 6h]
*** PRE-FLOP *** 
ovatsugkk folds
P1xel7 folds
Arte & Marte folds
nobbla57 folds
Astaeth folds
Zzzdoerrr collected 660 from pot
*** SUMMARY ***
Total pot 660 | No rake
Seat 2: Zzzdoerrr (big blind) won 660


Winamax Poker - Tournament "W SERIES GIANT KO - DAY 1" buyIn: 1.80€ + 0.20€ level: 7 - HandId: #3106533163543822514-99-1705353481 - Holdem no limit (35/150/300) - 2024/01/15 21:18:01 UTC
Table: 'W SERIES GIANT KO - DAY 1(723296116)#0177' 6-max (real money) Seat #1 is the button
Seat 1: Astaeth (66938, 3.37€ bounty)
Seat 2: Zzzdoerrr (21780, 0.90€ bounty)
Seat 3: ovatsugkk (6117, 0.90€ bounty)
Seat 4: P1xel7 (15677, 1.35€ bounty)
Seat 5: Arte & Marte (13453, 0.90€ bounty)
Seat 6: nobbla57 (14661, 0.90€ bounty)
*** ANTE/BLINDS ***
Zzzdoerrr posts ante 35
ovatsugkk posts ante 35
Astaeth posts ante 35
P1xel7 posts ante 35
Arte & Marte posts ante 35
nobbla57 posts ante 35
Zzzdoerrr posts small blind 150
ovatsugkk posts big blind 300
Dealt to P1xel7 [Js 5h]
*** PRE-FLOP *** 
P1xel7 folds
Arte & Marte folds
nobbla57 folds
Astaeth folds
Zzzdoerrr raises 21445 to 21745 and is all-in
ovatsugkk folds
Zzzdoerrr collected 22255 from pot
*** SUMMARY ***
Total pot 22255 | No rake
Seat 2: Zzzdoerrr (small blind) won 22255


Winamax Poker - Tournament "W SERIES GIANT KO - DAY 1" buyIn: 1.80€ + 0.20€ level: 8 - HandId: #3106533163543822514-100-1705353511 - Holdem no limit (40/175/350) - 2024/01/15 21:18:31 UTC
Table: 'W SERIES GIANT KO - DAY 1(723296116)#0177' 6-max (real money) Seat #2 is the button
Seat 1: Astaeth (66903, 3.37€ bounty)
Seat 2: Zzzdoerrr (22255, 0.90€ bounty)
Seat 3: ovatsugkk (5782, 0.90€ bounty)
Seat 4: P1xel7 (15642, 1.35€ bounty)
Seat 5: Arte & Marte (13418, 0.90€ bounty)
Seat 6: nobbla57 (14626, 0.90€ bounty)
*** ANTE/BLINDS ***
ovatsugkk posts ante 40
P1xel7 posts ante 40
Astaeth posts ante 40
Zzzdoerrr posts ante 40
Arte & Marte posts ante 40
nobbla57 posts ante 40
ovatsugkk posts small blind 175
P1xel7 posts big blind 350
Dealt to P1xel7 [9h 4s]
*** PRE-FLOP *** 
Arte & Marte folds
nobbla57 raises 350 to 700
Astaeth folds
Zzzdoerrr folds
ovatsugkk folds
P1xel7 folds
nobbla57 collected 1465 from pot
*** SUMMARY ***
Total pot 1465 | No rake
Seat 6: nobbla57 won 1465


Winamax Poker - Tournament "W SERIES GIANT KO - DAY 1" buyIn: 1.80€ + 0.20€ level: 8 - HandId: #3106533163543822514-101-1705353560 - Holdem no limit (40/175/350) - 2024/01/15 21:19:20 UTC
Table: 'W SERIES GIANT KO - DAY 1(723296116)#0177' 6-max (real money) Seat #3 is the button
Seat 1: Astaeth (66863, 3.37€ bounty)
Seat 2: Zzzdoerrr (22215, 0.90€ bounty)
Seat 3: ovatsugkk (5567, 0.90€ bounty)
Seat 4: P1xel7 (15252, 1.35€ bounty)
Seat 5: Arte & Marte (13378, 0.90€ bounty)
Seat 6: nobbla57 (15351, 0.90€ bounty)
*** ANTE/BLINDS ***
P1xel7 posts ante 40
Arte & Marte posts ante 40
Astaeth posts ante 40
Zzzdoerrr posts ante 40
ovatsugkk posts ante 40
nobbla57 posts ante 40
P1xel7 posts small blind 175
Arte & Marte posts big blind 350
Dealt to P1xel7 [6s 4d]
*** PRE-FLOP *** 
nobbla57 raises 350 to 700
Astaeth folds
Zzzdoerrr raises 700 to 1400
ovatsugkk folds
P1xel7 folds
Arte & Marte folds
nobbla57 calls 700
*** FLOP *** [4c 7s Ts]
nobbla57 checks
Zzzdoerrr bets 1598
nobbla57 folds
Zzzdoerrr collected 5163 from pot
*** SUMMARY ***
Total pot 5163 | No rake
Board: [4c 7s Ts]
Seat 2: Zzzdoerrr won 5163


Winamax Poker - Tournament "W SERIES GIANT KO - DAY 1" buyIn: 1.80€ + 0.20€ level: 8 - HandId: #3106533163543822514-102-1705353614 - Holdem no limit (40/175/350) - 2024/01/15 21:20:14 UTC
Table: 'W SERIES GIANT KO - DAY 1(723296116)#0177' 6-max (real money) Seat #4 is the button
Seat 1: Astaeth (66823, 3.37€ bounty)
Seat 2: Zzzdoerrr (24340, 0.90€ bounty)
Seat 3: ovatsugkk (5527, 0.90€ bounty)
Seat 4: P1xel7 (15037, 1.35€ bounty)
Seat 5: Arte & Marte (12988, 0.90€ bounty)
Seat 6: nobbla57 (13911, 0.90€ bounty)
*** ANTE/BLINDS ***
Arte & Marte posts ante 40
nobbla57 posts ante 40
Astaeth posts ante 40
Zzzdoerrr posts ante 40
ovatsugkk posts ante 40
P1xel7 posts ante 40
Arte & Marte posts small blind 175
nobbla57 posts big blind 350
Dealt to P1xel7 [3h 6c]
*** PRE-FLOP *** 
Astaeth folds
Zzzdoerrr folds
ovatsugkk folds
P1xel7 folds
Arte & Marte raises 940 to 1290
nobbla57 folds
Arte & Marte collected 1880 from pot
*** SUMMARY ***
Total pot 1880 | No rake
Seat 5: Arte & Marte (small blind) won 1880


Winamax Poker - Tournament "W SERIES GIANT KO - DAY 1" buyIn: 1.80€ + 0.20€ level: 8 - HandId: #3106533163543822514-103-1705353633 - Holdem no limit (40/175/350) - 2024/01/15 21:20:33 UTC
Table: 'W SERIES GIANT KO - DAY 1(723296116)#0177' 6-max (real money) Seat #5 is the button
Seat 1: Astaeth (66783, 3.37€ bounty)
Seat 2: Zzzdoerrr (24300, 0.90€ bounty)
Seat 3: ovatsugkk (5487, 0.90€ bounty)
Seat 4: P1xel7 (14997, 1.35€ bounty)
Seat 5: Arte & Marte (13538, 0.90€ bounty)
Seat 6: nobbla57 (13521, 0.90€ bounty)
*** ANTE/BLINDS ***
nobbla57 posts ante 40
Astaeth posts ante 40
Zzzdoerrr posts ante 40
ovatsugkk posts ante 40
P1xel7 posts ante 40
Arte & Marte posts ante 40
nobbla57 posts small blind 175
Astaeth posts big blind 350
Dealt to P1xel7 [Kd Th]
*** PRE-FLOP *** 
Zzzdoerrr raises 350 to 700
ovatsugkk folds
P1xel7 calls 700
Arte & Marte folds
nobbla57 folds
Astaeth folds
*** FLOP *** [2h 2c 7s]
Zzzdoerrr bets 541
P1xel7 calls 541
*** TURN *** [2h 2c 7s][5h]
Zzzdoerrr bets 1624
P1xel7 raises 2926 to 4550
Zzzdoerrr folds
P1xel7 collected 9421 from pot
*** SUMMARY ***
Total pot 9421 | No rake
Board: [2h 2c 7s 5h]
Seat 4: P1xel7 won 9421


Winamax Poker - Tournament "W SERIES GIANT KO - DAY 1" buyIn: 1.80€ + 0.20€ level: 8 - HandId: #3106533163543822514-104-1705353688 - Holdem no limit (40/175/350) - 2024/01/15 21:21:28 UTC
Table: 'W SERIES GIANT KO - DAY 1(723296116)#0177' 6-max (real money) Seat #6 is the button
Seat 1: Astaeth (66393, 3.37€ bounty)
Seat 2: Zzzdoerrr (21395, 0.90€ bounty)
Seat 3: ovatsugkk (5447, 0.90€ bounty)
Seat 4: P1xel7 (18587, 1.35€ bounty)
Seat 5: Arte & Marte (13498, 0.90€ bounty)
Seat 6: nobbla57 (13306, 0.90€ bounty)
*** ANTE/BLINDS ***
Astaeth posts ante 40
Zzzdoerrr posts ante 40
ovatsugkk posts ante 40
P1xel7 posts ante 40
Arte & Marte posts ante 40
nobbla57 posts ante 40
Astaeth posts small blind 175
Zzzdoerrr posts big blind 350
Dealt to P1xel7 [7d Kh]
*** PRE-FLOP *** 
ovatsugkk folds
P1xel7 folds
Arte & Marte folds
nobbla57 raises 350 to 700
Astaeth folds
Zzzdoerrr calls 350
*** FLOP *** [7h 5c Qh]
Zzzdoerrr checks
nobbla57 bets 599
Zzzdoerrr calls 599
*** TURN *** [7h 5c Qh][8s]
Zzzdoerrr checks
nobbla57 bets 1989
Zzzdoerrr calls 1989
*** RIVER *** [7h 5c Qh 8s][Ac]
Zzzdoerrr checks
nobbla57 checks
*** SHOW DOWN ***
nobbla57 shows [Qc Td] (One pair : Queens)
Zzzdoerrr shows [Qs 8h] (Two pairs : Queens and 8)
Zzzdoerrr collected 6991 from pot
*** SUMMARY ***
Total pot 6991 | No rake
Board: [7h 5c Qh 8s Ac]
Seat 2: Zzzdoerrr (big blind) showed [Qs 8h] and won 6991 with Two pairs : Queens and 8
Seat 6: nobbla57 (button) showed [Qc Td] and lost with One pair : Queens


Winamax Poker - Tournament "W SERIES GIANT KO - DAY 1" buyIn: 1.80€ + 0.20€ level: 8 - HandId: #3106533163543822514-105-1705353733 - Holdem no limit (40/175/350) - 2024/01/15 21:22:13 UTC
Table: 'W SERIES GIANT KO - DAY 1(723296116)#0177' 6-max (real money) Seat #1 is the button
Seat 1: Astaeth (66178, 3.37€ bounty)
Seat 2: Zzzdoerrr (25058, 0.90€ bounty)
Seat 3: ovatsugkk (5407, 0.90€ bounty)
Seat 4: P1xel7 (18547, 1.35€ bounty)
Seat 5: Arte & Marte (13458, 0.90€ bounty)
Seat 6: nobbla57 (9978, 0.90€ bounty)
*** ANTE/BLINDS ***
Zzzdoerrr posts ante 40
ovatsugkk posts ante 40
Astaeth posts ante 40
P1xel7 posts ante 40
Arte & Marte posts ante 40
nobbla57 posts ante 40
Zzzdoerrr posts small blind 175
ovatsugkk posts big blind 350
Dealt to P1xel7 [3c 4d]
*** PRE-FLOP *** 
P1xel7 folds
Arte & Marte folds
nobbla57 folds
Astaeth folds
Zzzdoerrr raises 24668 to 25018 and is all-in
ovatsugkk folds
Zzzdoerrr collected 25608 from pot
*** SUMMARY ***
Total pot 25608 | No rake
Seat 2: Zzzdoerrr (small blind) won 25608


Winamax Poker - Tournament "W SERIES GIANT KO - DAY 1" buyIn: 1.80€ + 0.20€ level: 8 - HandId: #3106533163543822514-106-1705353767 - Holdem no limit (40/175/350) - 2024/01/15 21:22:47 UTC
Table: 'W SERIES GIANT KO - DAY 1(723296116)#0177' 6-max (real money) Seat #2 is the button
Seat 1: Astaeth (66138, 3.37€ bounty)
Seat 2: Zzzdoerrr (25608, 0.90€ bounty)
Seat 3: ovatsugkk (5017, 0.90€ bounty)
Seat 4: P1xel7 (18507, 1.35€ bounty)
Seat 5: Arte & Marte (13418, 0.90€ bounty)
Seat 6: nobbla57 (9938, 0.90€ bounty)
*** ANTE/BLINDS ***
ovatsugkk posts ante 40
P1xel7 posts ante 40
Astaeth posts ante 40
Zzzdoerrr posts ante 40
Arte & Marte posts ante 40
nobbla57 posts ante 40
ovatsugkk posts small blind 175
P1xel7 posts big blind 350
Dealt to P1xel7 [Ks 4h]
*** PRE-FLOP *** 
Arte & Marte folds
nobbla57 folds
Astaeth raises 438 to 788
Zzzdoerrr calls 788
ovatsugkk folds
P1xel7 calls 438
*** FLOP *** [4s 2h Ad]
P1xel7 checks
Astaeth bets 973
Zzzdoerrr calls 973
P1xel7 folds
*** TURN *** [4s 2h Ad][Tc]
Astaeth bets 1654
Zzzdoerrr folds
Astaeth collected 6379 from pot
*** SUMMARY ***
Total pot 6379 | No rake
Board: [4s 2h Ad Tc]
Seat 1: Astaeth won 6379


Winamax Poker - Tournament "W SERIES GIANT KO - DAY 1" buyIn: 1.80€ + 0.20€ level: 8 - HandId: #3106533163543822514-107-1705353808 - Holdem no limit (40/175/350) - 2024/01/15 21:23:28 UTC
Table: 'W SERIES GIANT KO - DAY 1(723296116)#0177' 6-max (real money) Seat #3 is the button
Seat 1: Astaeth (69062, 3.37€ bounty)
Seat 2: Zzzdoerrr (23807, 0.90€ bounty)
Seat 3: ovatsugkk (4802, 0.90€ bounty)
Seat 4: P1xel7 (17679, 1.35€ bounty)
Seat 5: Arte & Marte (13378, 0.90€ bounty)
Seat 6: nobbla57 (9898, 0.90€ bounty)
*** ANTE/BLINDS ***
P1xel7 posts ante 40
Arte & Marte posts ante 40
Astaeth posts ante 40
Zzzdoerrr posts ante 40
ovatsugkk posts ante 40
nobbla57 posts ante 40
P1xel7 posts small blind 175
Arte & Marte posts big blind 350
Dealt to P1xel7 [Ks Qh]
*** PRE-FLOP *** 
nobbla57 folds
Astaeth folds
Zzzdoerrr folds
ovatsugkk folds
P1xel7 raises 525 to 875
Arte & Marte folds
P1xel7 collected 1465 from pot
*** SUMMARY ***
Total pot 1465 | No rake
Seat 4: P1xel7 (small blind) won 1465


Winamax Poker - Tournament "W SERIES GIANT KO - DAY 1" buyIn: 1.80€ + 0.20€ level: 8 - HandId: #3106533163543822514-108-1705353828 - Holdem no limit (40/175/350) - 2024/01/15 21:23:48 UTC
Table: 'W SERIES GIANT KO - DAY 1(723296116)#0177' 6-max (real money) Seat #4 is the button
Seat 1: Astaeth (69022, 3.37€ bounty)
Seat 2: Zzzdoerrr (23767, 0.90€ bounty)
Seat 3: ovatsugkk (4762, 0.90€ bounty)
Seat 4: P1xel7 (18229, 1.35€ bounty)
Seat 5: Arte & Marte (12988, 0.90€ bounty)
Seat 6: nobbla57 (9858, 0.90€ bounty)
*** ANTE/BLINDS ***
Arte & Marte posts ante 40
nobbla57 posts ante 40
Astaeth posts ante 40
Zzzdoerrr posts ante 40
ovatsugkk posts ante 40
P1xel7 posts ante 40
Arte & Marte posts small blind 175
nobbla57 posts big blind 350
Dealt to P1xel7 [3s 5s]
*** PRE-FLOP *** 
Astaeth folds
Zzzdoerrr folds
ovatsugkk folds
P1xel7 raises 700 to 1050
Arte & Marte folds
nobbla57 calls 700
*** FLOP *** [7s Qs Ks]
nobbla57 checks
P1xel7 bets 880
nobbla57 folds
P1xel7 collected 3395 from pot
*** SUMMARY ***
Total pot 3395 | No rake
Board: [7s Qs Ks]
Seat 4: P1xel7 (button) won 3395


Winamax Poker - Tournament "W SERIES GIANT KO - DAY 1" buyIn: 1.80€ + 0.20€ level: 8 - HandId: #3106533163543822514-109-1705353883 - Holdem no limit (40/175/350) - 2024/01/15 21:24:43 UTC
Table: 'W SERIES GIANT KO - DAY 1(723296116)#0177' 6-max (real money) Seat #5 is the button
Seat 1: Astaeth (68982, 3.37€ bounty)
Seat 2: Zzzdoerrr (23727, 0.90€ bounty)
Seat 3: ovatsugkk (4722, 0.90€ bounty)
Seat 4: P1xel7 (19654, 1.35€ bounty)
Seat 5: Arte & Marte (12773, 0.90€ bounty)
Seat 6: nobbla57 (8768, 0.90€ bounty)
*** ANTE/BLINDS ***
nobbla57 posts ante 40
Astaeth posts ante 40
Zzzdoerrr posts ante 40
ovatsugkk posts ante 40
P1xel7 posts ante 40
Arte & Marte posts ante 40
nobbla57 posts small blind 175
Astaeth posts big blind 350
Dealt to P1xel7 [4c Qs]
*** PRE-FLOP *** 
Zzzdoerrr raises 350 to 700
ovatsugkk folds
P1xel7 folds
Arte & Marte folds
nobbla57 folds
Astaeth folds
Zzzdoerrr collected 1465 from pot
*** SUMMARY ***
Total pot 1465 | No rake
Seat 2: Zzzdoerrr won 1465


Winamax Poker - Tournament "W SERIES GIANT KO - DAY 1" buyIn: 1.80€ + 0.20€ level: 8 - HandId: #3106533163543822514-110-1705353906 - Holdem no limit (40/175/350) - 2024/01/15 21:25:06 UTC
Table: 'W SERIES GIANT KO - DAY 1(723296116)#0177' 6-max (real money) Seat #6 is the button
Seat 1: Astaeth (68592, 3.37€ bounty)
Seat 2: Zzzdoerrr (24452, 0.90€ bounty)
Seat 3: ovatsugkk (4682, 0.90€ bounty)
Seat 4: P1xel7 (19614, 1.35€ bounty)
Seat 5: Arte & Marte (12733, 0.90€ bounty)
Seat 6: nobbla57 (8553, 0.90€ bounty)
*** ANTE/BLINDS ***
Astaeth posts ante 40
Zzzdoerrr posts ante 40
ovatsugkk posts ante 40
P1xel7 posts ante 40
Arte & Marte posts ante 40
nobbla57 posts ante 40
Astaeth posts small blind 175
Zzzdoerrr posts big blind 350
Dealt to P1xel7 [5s 5c]
*** PRE-FLOP *** 
ovatsugkk raises 4292 to 4642 and is all-in
P1xel7 raises 14932 to 19574 and is all-in
Arte & Marte folds
nobbla57 calls 8513 and is all-in
Astaeth folds
Zzzdoerrr folds
*** FLOP *** [Ah Kh 9h]
*** TURN *** [Ah Kh 9h][7h]
*** RIVER *** [Ah Kh 9h 7h][9d]
*** SHOW DOWN ***
ovatsugkk shows [Kd Ac] (Two pairs : Aces and Kings)
P1xel7 shows [5s 5c] (Two pairs : 9 and 5)
nobbla57 shows [Jh As] (Flush Ace high)
nobbla57 collected 22433 from main pot
P1xel7 collected 11061 from side pot 1
*** SUMMARY ***
Total pot 33494 | No rake
Board: [Ah Kh 9h 7h 9d]
Seat 3: ovatsugkk showed [Kd Ac] and lost with Two pairs : Aces and Kings
Seat 4: P1xel7 showed [5s 5c] and won 11061 with Two pairs : 9 and 5
Seat 6: nobbla57 (button) showed [Jh As] and won 22433 with Flush Ace high


Winamax Poker - Tournament "W SERIES GIANT KO - DAY 1" buyIn: 1.80€ + 0.20€ level: 8 - HandId: #3106533163543822514-111-1705353953 - Holdem no limit (40/175/350) - 2024/01/15 21:25:53 UTC
Table: 'W SERIES GIANT KO - DAY 1(723296116)#0177' 6-max (real money) Seat #1 is the button
Seat 1: Astaeth (68377, 3.37€ bounty)
Seat 2: Zzzdoerrr (24062, 0.90€ bounty)
Seat 4: P1xel7 (11061, 1.35€ bounty)
Seat 5: Arte & Marte (12693, 0.90€ bounty)
Seat 6: nobbla57 (22433, 1.35€ bounty)
*** ANTE/BLINDS ***
Zzzdoerrr posts ante 40
P1xel7 posts ante 40
Astaeth posts ante 40
Arte & Marte posts ante 40
nobbla57 posts ante 40
Zzzdoerrr posts small blind 175
P1xel7 posts big blind 350
Dealt to P1xel7 [2d Ac]
*** PRE-FLOP *** 
Arte & Marte folds
nobbla57 folds
Astaeth raises 438 to 788
Zzzdoerrr folds
P1xel7 calls 438
*** FLOP *** [6c Qh 9h]
P1xel7 checks
Astaeth bets 683
P1xel7 calls 683
*** TURN *** [6c Qh 9h][7d]
P1xel7 checks
Astaeth bets 1659
P1xel7 folds
Astaeth collected 4976 from pot
*** SUMMARY ***
Total pot 4976 | No rake
Board: [6c Qh 9h 7d]
Seat 1: Astaeth (button) won 4976


Winamax Poker - Tournament "W SERIES GIANT KO - DAY 1" buyIn: 1.80€ + 0.20€ level: 8 - HandId: #3106533163543822514-112-1705354007 - Holdem no limit (40/175/350) - 2024/01/15 21:26:47 UTC
Table: 'W SERIES GIANT KO - DAY 1(723296116)#0177' 6-max (real money) Seat #2 is the button
Seat 1: Astaeth (70183, 3.37€ bounty)
Seat 2: Zzzdoerrr (23847, 0.90€ bounty)
Seat 3: Uriage38130 (16225, 0.90€ bounty)
Seat 4: P1xel7 (9550, 1.35€ bounty)
Seat 5: Arte & Marte (12653, 0.90€ bounty)
Seat 6: nobbla57 (22393, 1.35€ bounty)
*** ANTE/BLINDS ***
P1xel7 posts ante 40
Arte & Marte posts ante 40
Astaeth posts ante 40
Zzzdoerrr posts ante 40
nobbla57 posts ante 40
P1xel7 posts small blind 175
Arte & Marte posts big blind 350
Dealt to P1xel7 [6d 8s]
*** PRE-FLOP *** 
nobbla57 folds
Astaeth raises 438 to 788
Zzzdoerrr folds
P1xel7 folds
Arte & Marte raises 1951 to 2739
Astaeth calls 1951
*** FLOP *** [8h Td Qs]
Arte & Marte bets 9874 and is all-in
Astaeth folds
Arte & Marte collected 15727 from pot
*** SUMMARY ***
Total pot 15727 | No rake
Board: [8h Td Qs]
Seat 5: Arte & Marte (big blind) won 15727


Winamax Poker - Tournament "W SERIES GIANT KO - DAY 1" buyIn: 1.80€ + 0.20€ level: 8 - HandId: #3106533163543822514-113-1705354040 - Holdem no limit (40/175/350) - 2024/01/15 21:27:20 UTC
Table: 'W SERIES GIANT KO - DAY 1(723296116)#0177' 6-max (real money) Seat #4 is the button
Seat 1: Astaeth (67404, 3.37€ bounty)
Seat 2: Zzzdoerrr (23807, 0.90€ bounty)
Seat 3: Uriage38130 (16225, 0.90€ bounty)
Seat 4: P1xel7 (9335, 1.35€ bounty)
Seat 5: Arte & Marte (15727, 0.90€ bounty)
*** ANTE/BLINDS ***
Arte & Marte posts ante 40
Astaeth posts ante 40
Zzzdoerrr posts ante 40
Uriage38130 posts ante 40
P1xel7 posts ante 40
Arte & Marte posts small blind 175
Astaeth posts big blind 350
Dealt to P1xel7 [7d 9d]
*** PRE-FLOP *** 
Zzzdoerrr raises 350 to 700
Uriage38130 folds
P1xel7 raises 350 to 1050
Arte & Marte folds
Astaeth folds
Zzzdoerrr calls 350
*** FLOP *** [4h 3c 8d]
Zzzdoerrr checks
P1xel7 checks
*** TURN *** [4h 3c 8d][Tc]
Zzzdoerrr checks
P1xel7 checks
*** RIVER *** [4h 3c 8d Tc][3d]
Zzzdoerrr checks
P1xel7 bets 1836
Zzzdoerrr folds
P1xel7 collected 4661 from pot
*** SUMMARY ***
Total pot 4661 | No rake
Board: [4h 3c 8d Tc 3d]
Seat 4: P1xel7 (button) won 4661


Winamax Poker - Tournament "W SERIES GIANT KO - DAY 1" buyIn: 1.80€ + 0.20€ level: 8 - HandId: #3106533163543822514-114-1705354101 - Holdem no limit (40/175/350) - 2024/01/15 21:28:21 UTC
Table: 'W SERIES GIANT KO - DAY 1(723296116)#0177' 6-max (real money) Seat #5 is the button
Seat 1: Astaeth (67014, 3.37€ bounty)
Seat 2: Zzzdoerrr (22717, 0.90€ bounty)
Seat 3: Uriage38130 (16185, 0.90€ bounty)
Seat 4: P1xel7 (11070, 1.35€ bounty)
Seat 5: Arte & Marte (15512, 0.90€ bounty)
*** ANTE/BLINDS ***
Astaeth posts ante 40
Zzzdoerrr posts ante 40
Uriage38130 posts ante 40
P1xel7 posts ante 40
Arte & Marte posts ante 40
Astaeth posts small blind 175
Zzzdoerrr posts big blind 350
Dealt to P1xel7 [Qh 4c]
*** PRE-FLOP *** 
Uriage38130 folds
P1xel7 folds
Arte & Marte folds
Astaeth raises 1050 to 1400
Zzzdoerrr calls 1050
*** FLOP *** [3d 4s 6h]
Astaeth bets 1050
Zzzdoerrr calls 1050
*** TURN *** [3d 4s 6h][9h]
Astaeth bets 1785
Zzzdoerrr calls 1785
*** RIVER *** [3d 4s 6h 9h][Th]
Astaeth checks
Zzzdoerrr checks
*** SHOW DOWN ***
Astaeth shows [Jh Ad] (High card : Ace)
Zzzdoerrr shows [As 3s] (One pair : 3)
Zzzdoerrr collected 8670 from pot
*** SUMMARY ***
Total pot 8670 | No rake
Board: [3d 4s 6h 9h Th]
Seat 1: Astaeth (small blind) showed [Jh Ad] and lost with High card : Ace
Seat 2: Zzzdoerrr (big blind) showed [As 3s] and won 8670 with One pair : 3


Winamax Poker - Tournament "W SERIES GIANT KO - DAY 1" buyIn: 1.80€ + 0.20€ level: 8 - HandId: #3106533163543822514-115-1705354160 - Holdem no limit (40/175/350) - 2024/01/15 21:29:20 UTC
Table: 'W SERIES GIANT KO - DAY 1(723296116)#0177' 6-max (real money) Seat #1 is the button
Seat 1: Astaeth (62739, 3.37€ bounty)
Seat 2: Zzzdoerrr (27112, 0.90€ bounty)
Seat 3: Uriage38130 (16145, 0.90€ bounty)
Seat 4: P1xel7 (11030, 1.35€ bounty)
Seat 5: Arte & Marte (15472, 0.90€ bounty)
*** ANTE/BLINDS ***
Zzzdoerrr posts ante 40
Uriage38130 posts ante 40
Astaeth posts ante 40
P1xel7 posts ante 40
Arte & Marte posts ante 40
Zzzdoerrr posts small blind 175
Uriage38130 posts big blind 350
Dealt to P1xel7 [9s 2c]
*** PRE-FLOP *** 
P1xel7 folds
Arte & Marte folds
Astaeth raises 438 to 788
Zzzdoerrr calls 613
Uriage38130 calls 438
*** FLOP *** [2h Kc Ks]
Zzzdoerrr checks
Uriage38130 checks
Astaeth checks
*** TURN *** [2h Kc Ks][6h]
Zzzdoerrr bets 1282
Uriage38130 folds
Astaeth folds
Zzzdoerrr collected 3846 from pot
*** SUMMARY ***
Total pot 3846 | No rake
Board: [2h Kc Ks 6h]
Seat 2: Zzzdoerrr (small blind) won 3846


Winamax Poker - Tournament "W SERIES GIANT KO - DAY 1" buyIn: 1.80€ + 0.20€ level: 9 - HandId: #3106533163543822514-116-1705354209 - Holdem no limit (50/200/400) - 2024/01/15 21:30:09 UTC
Table: 'W SERIES GIANT KO - DAY 1(723296116)#0177' 6-max (real money) Seat #2 is the button
Seat 1: Astaeth (61911, 3.37€ bounty)
Seat 2: Zzzdoerrr (28848, 0.90€ bounty)
Seat 3: Uriage38130 (15317, 0.90€ bounty)
Seat 4: P1xel7 (10990, 1.35€ bounty)
Seat 5: Arte & Marte (15432, 0.90€ bounty)
*** ANTE/BLINDS ***
Uriage38130 posts ante 50
P1xel7 posts ante 50
Astaeth posts ante 50
Zzzdoerrr posts ante 50
Arte & Marte posts ante 50
Uriage38130 posts small blind 200
P1xel7 posts big blind 400
Dealt to P1xel7 [6h 3d]
*** PRE-FLOP *** 
Arte & Marte raises 800 to 1200
Astaeth calls 1200
Zzzdoerrr calls 1200
Uriage38130 folds
P1xel7 folds
*** FLOP *** [5s 8c 5d]
Arte & Marte bets 2893
Astaeth folds
Zzzdoerrr folds
Arte & Marte collected 7343 from pot
*** SUMMARY ***
Total pot 7343 | No rake
Board: [5s 8c 5d]
Seat 5: Arte & Marte won 7343


Winamax Poker - Tournament "W SERIES GIANT KO - DAY 1" buyIn: 1.80€ + 0.20€ level: 9 - HandId: #3106533163543822514-117-1705354235 - Holdem no limit (50/200/400) - 2024/01/15 21:30:35 UTC
Table: 'W SERIES GIANT KO - DAY 1(723296116)#0177' 6-max (real money) Seat #3 is the button
Seat 1: Astaeth (60661, 3.37€ bounty)
Seat 2: Zzzdoerrr (27598, 0.90€ bounty)
Seat 3: Uriage38130 (15067, 0.90€ bounty)
Seat 4: P1xel7 (10540, 1.35€ bounty)
Seat 5: Arte & Marte (18632, 0.90€ bounty)
*** ANTE/BLINDS ***
P1xel7 posts ante 50
Arte & Marte posts ante 50
Astaeth posts ante 50
Zzzdoerrr posts ante 50
Uriage38130 posts ante 50
P1xel7 posts small blind 200
Arte & Marte posts big blind 400
Dealt to P1xel7 [2s 2c]
*** PRE-FLOP *** 
Astaeth folds
Zzzdoerrr folds
Uriage38130 folds
P1xel7 raises 400 to 800
Arte & Marte calls 400
*** FLOP *** [6s 6c 8d]
P1xel7 bets 463
Arte & Marte calls 463
*** TURN *** [6s 6c 8d][7c]
P1xel7 bets 1388
Arte & Marte folds
P1xel7 collected 4164 from pot
*** SUMMARY ***
Total pot 4164 | No rake
Board: [6s 6c 8d 7c]
Seat 4: P1xel7 (small blind) won 4164


Winamax Poker - Tournament "W SERIES GIANT KO - DAY 1" buyIn: 1.80€ + 0.20€ level: 9 - HandId: #3106533163543822514-118-1705354262 - Holdem no limit (50/200/400) - 2024/01/15 21:31:02 UTC
Table: 'W SERIES GIANT KO - DAY 1(723296116)#0177' 6-max (real money) Seat #4 is the button
Seat 1: Astaeth (60611, 3.37€ bounty)
Seat 2: Zzzdoerrr (27548, 0.90€ bounty)
Seat 3: Uriage38130 (15017, 0.90€ bounty)
Seat 4: P1xel7 (12003, 1.35€ bounty)
Seat 5: Arte & Marte (17319, 0.90€ bounty)
*** ANTE/BLINDS ***
Arte & Marte posts ante 50
Astaeth posts ante 50
Zzzdoerrr posts ante 50
Uriage38130 posts ante 50
P1xel7 posts ante 50
Arte & Marte posts small blind 200
Astaeth posts big blind 400
Dealt to P1xel7 [6s Ts]
*** PRE-FLOP *** 
Zzzdoerrr folds
Uriage38130 folds
P1xel7 folds
Arte & Marte folds
Astaeth collected 850 from pot
*** SUMMARY ***
Total pot 850 | No rake
Seat 1: Astaeth (big blind) won 850


Winamax Poker - Tournament "W SERIES GIANT KO - DAY 1" buyIn: 1.80€ + 0.20€ level: 9 - HandId: #3106533163543822514-119-1705354270 - Holdem no limit (50/200/400) - 2024/01/15 21:31:10 UTC
Table: 'W SERIES GIANT KO - DAY 1(723296116)#0177' 6-max (real money) Seat #5 is the button
Seat 1: Astaeth (61011, 3.37€ bounty)
Seat 2: Zzzdoerrr (27498, 0.90€ bounty)
Seat 3: Uriage38130 (14967, 0.90€ bounty)
Seat 4: P1xel7 (11953, 1.35€ bounty)
Seat 5: Arte & Marte (17069, 0.90€ bounty)
*** ANTE/BLINDS ***
Astaeth posts ante 50
Zzzdoerrr posts ante 50
Uriage38130 posts ante 50
P1xel7 posts ante 50
Arte & Marte posts ante 50
Astaeth posts small blind 200
Zzzdoerrr posts big blind 400
Dealt to P1xel7 [7d 7h]
*** PRE-FLOP *** 
Uriage38130 folds
P1xel7 raises 480 to 880
Arte & Marte folds
Astaeth folds
Zzzdoerrr calls 480
*** FLOP *** [Kd 5s Td]
Zzzdoerrr checks
P1xel7 bets 774
Zzzdoerrr raises 774 to 1548
P1xel7 calls 774
*** TURN *** [Kd 5s Td][4d]
Zzzdoerrr checks
P1xel7 bets 2653
Zzzdoerrr calls 2653
*** RIVER *** [Kd 5s Td 4d][2h]
Zzzdoerrr checks
P1xel7 checks
*** SHOW DOWN ***
P1xel7 shows [7d 7h] (One pair : 7)
Zzzdoerrr shows [Kh 6h] (One pair : Kings)
Zzzdoerrr collected 10612 from pot
*** SUMMARY ***
Total pot 10612 | No rake
Board: [Kd 5s Td 4d 2h]
Seat 2: Zzzdoerrr (big blind) showed [Kh 6h] and won 10612 with One pair : Kings
Seat 4: P1xel7 showed [7d 7h] and lost with One pair : 7


Winamax Poker - Tournament "W SERIES GIANT KO - DAY 1" buyIn: 1.80€ + 0.20€ level: 9 - HandId: #3106533163543822514-120-1705354340 - Holdem no limit (50/200/400) - 2024/01/15 21:32:20 UTC
Table: 'W SERIES GIANT KO - DAY 1(723296116)#0177' 6-max (real money) Seat #1 is the button
Seat 1: Astaeth (60761, 3.37€ bounty)
Seat 2: Zzzdoerrr (32979, 0.90€ bounty)
Seat 3: Uriage38130 (14917, 0.90€ bounty)
Seat 4: P1xel7 (6822, 1.35€ bounty)
Seat 5: Arte & Marte (17019, 0.90€ bounty)
Seat 6: Bibi fuck (29489, 0.90€ bounty)
*** ANTE/BLINDS ***
Zzzdoerrr posts ante 50
Uriage38130 posts ante 50
Astaeth posts ante 50
P1xel7 posts ante 50
Arte & Marte posts ante 50
Bibi fuck posts ante 50
Zzzdoerrr posts small blind 200
Uriage38130 posts big blind 400
Dealt to P1xel7 [Js 2c]
*** PRE-FLOP *** 
P1xel7 folds
Arte & Marte folds
Bibi fuck folds
Astaeth folds
Zzzdoerrr raises 400 to 800
Uriage38130 folds
Zzzdoerrr collected 1500 from pot
*** SUMMARY ***
Total pot 1500 | No rake
Seat 2: Zzzdoerrr (small blind) won 1500


Winamax Poker - Tournament "W SERIES GIANT KO - DAY 1" buyIn: 1.80€ + 0.20€ level: 9 - HandId: #3106533163543822514-121-1705354363 - Holdem no limit (50/200/400) - 2024/01/15 21:32:43 UTC
Table: 'W SERIES GIANT KO - DAY 1(723296116)#0177' 6-max (real money) Seat #2 is the button
Seat 1: Astaeth (60711, 3.37€ bounty)
Seat 2: Zzzdoerrr (33629, 0.90€ bounty)
Seat 3: Uriage38130 (14467, 0.90€ bounty)
Seat 4: P1xel7 (6772, 1.35€ bounty)
Seat 5: Arte & Marte (16969, 0.90€ bounty)
Seat 6: Bibi fuck (29439, 0.90€ bounty)
*** ANTE/BLINDS ***
Uriage38130 posts ante 50
P1xel7 posts ante 50
Astaeth posts ante 50
Zzzdoerrr posts ante 50
Arte & Marte posts ante 50
Bibi fuck posts ante 50
Uriage38130 posts small blind 200
P1xel7 posts big blind 400
Dealt to P1xel7 [8c 2h]
*** PRE-FLOP *** 
Arte & Marte folds
Bibi fuck raises 488 to 888
Astaeth folds
Zzzdoerrr folds
Uriage38130 calls 688
P1xel7 folds
*** FLOP *** [Qs Jd 4d]
Uriage38130 checks
Bibi fuck bets 619
Uriage38130 calls 619
*** TURN *** [Qs Jd 4d][Ts]
Uriage38130 checks
Bibi fuck checks
*** RIVER *** [Qs Jd 4d Ts][Kc]
Uriage38130 checks
Bibi fuck bets 27882 and is all-in
Uriage38130 folds
Bibi fuck collected 31596 from pot
*** SUMMARY ***
Total pot 31596 | No rake
Board: [Qs Jd 4d Ts Kc]
Seat 6: Bibi fuck won 31596


Winamax Poker - Tournament "W SERIES GIANT KO - DAY 1" buyIn: 1.80€ + 0.20€ level: 9 - HandId: #3106533163543822514-122-1705354424 - Holdem no limit (50/200/400) - 2024/01/15 21:33:44 UTC
Table: 'W SERIES GIANT KO - DAY 1(723296116)#0177' 6-max (real money) Seat #3 is the button
Seat 1: Astaeth (60661, 3.37€ bounty)
Seat 2: Zzzdoerrr (33579, 0.90€ bounty)
Seat 3: Uriage38130 (12910, 0.90€ bounty)
Seat 4: P1xel7 (6322, 1.35€ bounty)
Seat 5: Arte & Marte (16919, 0.90€ bounty)
Seat 6: Bibi fuck (31596, 0.90€ bounty)
*** ANTE/BLINDS ***
P1xel7 posts ante 50
Arte & Marte posts ante 50
Astaeth posts ante 50
Zzzdoerrr posts ante 50
Uriage38130 posts ante 50
Bibi fuck posts ante 50
P1xel7 posts small blind 200
Arte & Marte posts big blind 400
Dealt to P1xel7 [6h 6c]
*** PRE-FLOP *** 
Bibi fuck folds
Astaeth folds
Zzzdoerrr folds
Uriage38130 folds
P1xel7 raises 5872 to 6272 and is all-in
Arte & Marte folds
P1xel7 collected 6972 from pot
*** SUMMARY ***
Total pot 6972 | No rake
Seat 4: P1xel7 (small blind) won 6972


Winamax Poker - Tournament "W SERIES GIANT KO - DAY 1" buyIn: 1.80€ + 0.20€ level: 9 - HandId: #3106533163543822514-123-1705354443 - Holdem no limit (50/200/400) - 2024/01/15 21:34:03 UTC
Table: 'W SERIES GIANT KO - DAY 1(723296116)#0177' 6-max (real money) Seat #4 is the button
Seat 1: Astaeth (60611, 3.37€ bounty)
Seat 2: Zzzdoerrr (33529, 0.90€ bounty)
Seat 3: Uriage38130 (12860, 0.90€ bounty)
Seat 4: P1xel7 (6972, 1.35€ bounty)
Seat 5: Arte & Marte (16469, 0.90€ bounty)
Seat 6: Bibi fuck (31546, 0.90€ bounty)
*** ANTE/BLINDS ***
Arte & Marte posts ante 50
Bibi fuck posts ante 50
Astaeth posts ante 50
Zzzdoerrr posts ante 50
Uriage38130 posts ante 50
P1xel7 posts ante 50
Arte & Marte posts small blind 200
Bibi fuck posts big blind 400
Dealt to P1xel7 [4c 5d]
*** PRE-FLOP *** 
Astaeth folds
Zzzdoerrr folds
Uriage38130 folds
P1xel7 folds
Arte & Marte raises 1100 to 1500
Bibi fuck calls 1100
*** FLOP *** [Kd 4s Ad]
Arte & Marte bets 3300
Bibi fuck folds
Arte & Marte collected 6600 from pot
*** SUMMARY ***
Total pot 6600 | No rake
Board: [Kd 4s Ad]
Seat 5: Arte & Marte (small blind) won 6600


Winamax Poker - Tournament "W SERIES GIANT KO - DAY 1" buyIn: 1.80€ + 0.20€ level: 9 - HandId: #3106533163543822514-124-1705354475 - Holdem no limit (50/200/400) - 2024/01/15 21:34:35 UTC
Table: 'W SERIES GIANT KO - DAY 1(723296116)#0177' 6-max (real money) Seat #5 is the button
Seat 1: Astaeth (60561, 3.37€ bounty)
Seat 2: Zzzdoerrr (33479, 0.90€ bounty)
Seat 3: Uriage38130 (12810, 0.90€ bounty)
Seat 4: P1xel7 (6922, 1.35€ bounty)
Seat 5: Arte & Marte (18219, 0.90€ bounty)
Seat 6: Bibi fuck (29996, 0.90€ bounty)
*** ANTE/BLINDS ***
Bibi fuck posts ante 50
Astaeth posts ante 50
Zzzdoerrr posts ante 50
Uriage38130 posts ante 50
P1xel7 posts ante 50
Arte & Marte posts ante 50
Bibi fuck posts small blind 200
Astaeth posts big blind 400
Dealt to P1xel7 [Jh 7h]
*** PRE-FLOP *** 
Zzzdoerrr folds
Uriage38130 folds
P1xel7 folds
Arte & Marte raises 1300 to 1700
Bibi fuck folds
Astaeth folds
Arte & Marte collected 2600 from pot
*** SUMMARY ***
Total pot 2600 | No rake
Seat 5: Arte & Marte (button) won 2600


Winamax Poker - Tournament "W SERIES GIANT KO - DAY 1" buyIn: 1.80€ + 0.20€ level: 9 - HandId: #3106533163543822514-125-1705354495 - Holdem no limit (50/200/400) - 2024/01/15 21:34:55 UTC
Table: 'W SERIES GIANT KO - DAY 1(723296116)#0177' 6-max (real money) Seat #6 is the button
Seat 1: Astaeth (60111, 3.37€ bounty)
Seat 2: Zzzdoerrr (33429, 0.90€ bounty)
Seat 3: Uriage38130 (12760, 0.90€ bounty)
Seat 4: P1xel7 (6872, 1.35€ bounty)
Seat 5: Arte & Marte (19069, 0.90€ bounty)
Seat 6: Bibi fuck (29746, 0.90€ bounty)
*** ANTE/BLINDS ***
Astaeth posts ante 50
Zzzdoerrr posts ante 50
Uriage38130 posts ante 50
P1xel7 posts ante 50
Arte & Marte posts ante 50
Bibi fuck posts ante 50
Astaeth posts small blind 200
Zzzdoerrr posts big blind 400
Dealt to P1xel7 [Ks 2c]
*** PRE-FLOP *** 
Uriage38130 raises 400 to 800
P1xel7 folds
Arte & Marte calls 800
Bibi fuck folds
Astaeth folds
Zzzdoerrr folds
*** FLOP *** [Td 2h 7c]
Uriage38130 checks
Arte & Marte bets 1625
Uriage38130 calls 1625
*** TURN *** [Td 2h 7c][2d]
Uriage38130 checks
Arte & Marte checks
*** RIVER *** [Td 2h 7c 2d][Ah]
Uriage38130 checks
Arte & Marte bets 5750
Uriage38130 folds
Arte & Marte collected 11500 from pot
*** SUMMARY ***
Total pot 11500 | No rake
Board: [Td 2h 7c 2d Ah]
Seat 5: Arte & Marte won 11500


Winamax Poker - Tournament "W SERIES GIANT KO - DAY 1" buyIn: 1.80€ + 0.20€ level: 9 - HandId: #3106533163543822514-126-1705354561 - Holdem no limit (50/200/400) - 2024/01/15 21:36:01 UTC
Table: 'W SERIES GIANT KO - DAY 1(723296116)#0177' 6-max (real money) Seat #1 is the button
Seat 1: Astaeth (59861, 3.37€ bounty)
Seat 2: Zzzdoerrr (32979, 0.90€ bounty)
Seat 3: Uriage38130 (10285, 0.90€ bounty)
Seat 4: P1xel7 (6822, 1.35€ bounty)
Seat 5: Arte & Marte (22344, 0.90€ bounty)
Seat 6: Bibi fuck (29696, 0.90€ bounty)
*** ANTE/BLINDS ***
Zzzdoerrr posts ante 50
Uriage38130 posts ante 50
Astaeth posts ante 50
P1xel7 posts ante 50
Arte & Marte posts ante 50
Bibi fuck posts ante 50
Zzzdoerrr posts small blind 200
Uriage38130 posts big blind 400
Dealt to P1xel7 [Jc 3c]
*** PRE-FLOP *** 
P1xel7 folds
Arte & Marte folds
Bibi fuck raises 488 to 888
Astaeth calls 888
Zzzdoerrr calls 688
Uriage38130 folds
*** FLOP *** [5c Ac 2s]
Zzzdoerrr checks
Bibi fuck checks
Astaeth checks
*** TURN *** [5c Ac 2s][7s]
Zzzdoerrr bets 1177
Bibi fuck calls 1177
Astaeth folds
*** RIVER *** [5c Ac 2s 7s][4s]
Zzzdoerrr checks
Bibi fuck bets 5718
Zzzdoerrr folds
Bibi fuck collected 11436 from pot
*** SUMMARY ***
Total pot 11436 | No rake
Board: [5c Ac 2s 7s 4s]
Seat 6: Bibi fuck won 11436


Winamax Poker - Tournament "W SERIES GIANT KO - DAY 1" buyIn: 1.80€ + 0.20€ level: 9 - HandId: #3106533163543822514-127-1705354645 - Holdem no limit (50/200/400) - 2024/01/15 21:37:25 UTC
Table: 'W SERIES GIANT KO - DAY 1(723296116)#0177' 6-max (real money) Seat #2 is the button
Seat 1: Astaeth (58923, 3.37€ bounty)
Seat 2: Zzzdoerrr (30864, 0.90€ bounty)
Seat 3: Uriage38130 (9835, 0.90€ bounty)
Seat 4: P1xel7 (6772, 1.35€ bounty)
Seat 5: Arte & Marte (22294, 0.90€ bounty)
Seat 6: Bibi fuck (33299, 0.90€ bounty)
*** ANTE/BLINDS ***
Uriage38130 posts ante 50
P1xel7 posts ante 50
Astaeth posts ante 50
Zzzdoerrr posts ante 50
Arte & Marte posts ante 50
Bibi fuck posts ante 50
Uriage38130 posts small blind 200
P1xel7 posts big blind 400
Dealt to P1xel7 [9h As]
*** PRE-FLOP *** 
Arte & Marte folds
Bibi fuck folds
Astaeth folds
Zzzdoerrr folds
Uriage38130 folds
P1xel7 collected 900 from pot
*** SUMMARY ***
Total pot 900 | No rake
Seat 4: P1xel7 (big blind) won 900


Winamax Poker - Tournament "W SERIES GIANT KO - DAY 1" buyIn: 1.80€ + 0.20€ level: 9 - HandId: #3106533163543822514-128-1705354658 - Holdem no limit (50/200/400) - 2024/01/15 21:37:38 UTC
Table: 'W SERIES GIANT KO - DAY 1(723296116)#0177' 6-max (real money) Seat #3 is the button
Seat 1: Astaeth (58873, 3.37€ bounty)
Seat 2: Zzzdoerrr (30814, 0.90€ bounty)
Seat 3: Uriage38130 (9585, 0.90€ bounty)
Seat 4: P1xel7 (7222, 1.35€ bounty)
Seat 5: Arte & Marte (22244, 0.90€ bounty)
Seat 6: Bibi fuck (33249, 0.90€ bounty)
*** ANTE/BLINDS ***
P1xel7 posts ante 50
Arte & Marte posts ante 50
Astaeth posts ante 50
Zzzdoerrr posts ante 50
Uriage38130 posts ante 50
Bibi fuck posts ante 50
P1xel7 posts small blind 200
Arte & Marte posts big blind 400
Dealt to P1xel7 [7h Th]
*** PRE-FLOP *** 
Bibi fuck folds
Astaeth folds
Zzzdoerrr raises 400 to 800
Uriage38130 calls 800
P1xel7 folds
Arte & Marte folds
*** FLOP *** [Tc 9c 7s]
Zzzdoerrr bets 875
Uriage38130 raises 7860 to 8735 and is all-in
Zzzdoerrr folds
Uriage38130 collected 12110 from pot
*** SUMMARY ***
Total pot 12110 | No rake
Board: [Tc 9c 7s]
Seat 3: Uriage38130 (button) won 12110


Winamax Poker - Tournament "W SERIES GIANT KO - DAY 1" buyIn: 1.80€ + 0.20€ level: 9 - HandId: #3106533163543822514-129-1705354696 - Holdem no limit (50/200/400) - 2024/01/15 21:38:16 UTC
Table: 'W SERIES GIANT KO - DAY 1(723296116)#0177' 6-max (real money) Seat #4 is the button
Seat 1: Astaeth (58823, 3.37€ bounty)
Seat 2: Zzzdoerrr (29089, 0.90€ bounty)
Seat 3: Uriage38130 (12110, 0.90€ bounty)
Seat 4: P1xel7 (6972, 1.35€ bounty)
Seat 5: Arte & Marte (21794, 0.90€ bounty)
Seat 6: Bibi fuck (33199, 0.90€ bounty)
*** ANTE/BLINDS ***
Arte & Marte posts ante 50
Bibi fuck posts ante 50
Astaeth posts ante 50
Zzzdoerrr posts ante 50
Uriage38130 posts ante 50
P1xel7 posts ante 50
Arte & Marte posts small blind 200
Bibi fuck posts big blind 400
Dealt to P1xel7 [6d 8h]
*** PRE-FLOP *** 
Astaeth raises 500 to 900
Zzzdoerrr folds
Uriage38130 folds
P1xel7 folds
Arte & Marte folds
Bibi fuck calls 500
*** FLOP *** [3d 6c 2s]
Bibi fuck checks
Astaeth checks
*** TURN *** [3d 6c 2s][4d]
Bibi fuck checks
Astaeth checks
*** RIVER *** [3d 6c 2s 4d][4c]
Bibi fuck bets 5200
Astaeth folds
Bibi fuck collected 7500 from pot
*** SUMMARY ***
Total pot 7500 | No rake
Board: [3d 6c 2s 4d 4c]
Seat 6: Bibi fuck (big blind) won 7500


Winamax Poker - Tournament "W SERIES GIANT KO - DAY 1" buyIn: 1.80€ + 0.20€ level: 9 - HandId: #3106533163543822514-130-1705354753 - Holdem no limit (50/200/400) - 2024/01/15 21:39:13 UTC
Table: 'W SERIES GIANT KO - DAY 1(723296116)#0177' 6-max (real money) Seat #5 is the button
Seat 1: Astaeth (57873, 3.37€ bounty)
Seat 2: Zzzdoerrr (29039, 0.90€ bounty)
Seat 3: Uriage38130 (12060, 0.90€ bounty)
Seat 4: P1xel7 (6922, 1.35€ bounty)
Seat 5: Arte & Marte (21544, 0.90€ bounty)
Seat 6: Bibi fuck (34549, 0.90€ bounty)
*** ANTE/BLINDS ***
Bibi fuck posts ante 50
Astaeth posts ante 50
Zzzdoerrr posts ante 50
Uriage38130 posts ante 50
P1xel7 posts ante 50
Arte & Marte posts ante 50
Bibi fuck posts small blind 200
Astaeth posts big blind 400
Dealt to P1xel7 [8s Ac]
*** PRE-FLOP *** 
Zzzdoerrr folds
Uriage38130 folds
P1xel7 raises 6472 to 6872 and is all-in
Arte & Marte folds
Bibi fuck folds
Astaeth folds
P1xel7 collected 7772 from pot
*** SUMMARY ***
Total pot 7772 | No rake
Seat 4: P1xel7 won 7772


Winamax Poker - Tournament "W SERIES GIANT KO - DAY 1" buyIn: 1.80€ + 0.20€ level: 9 - HandId: #3106533163543822514-131-1705354773 - Holdem no limit (50/200/400) - 2024/01/15 21:39:33 UTC
Table: 'W SERIES GIANT KO - DAY 1(723296116)#0177' 6-max (real money) Seat #6 is the button
Seat 1: Astaeth (57423, 3.37€ bounty)
Seat 2: Zzzdoerrr (28989, 0.90€ bounty)
Seat 3: Uriage38130 (12010, 0.90€ bounty)
Seat 4: P1xel7 (7772, 1.35€ bounty)
Seat 5: Arte & Marte (21494, 0.90€ bounty)
Seat 6: Bibi fuck (34299, 0.90€ bounty)
*** ANTE/BLINDS ***
Astaeth posts ante 50
Zzzdoerrr posts ante 50
Uriage38130 posts ante 50
P1xel7 posts ante 50
Arte & Marte posts ante 50
Bibi fuck posts ante 50
Astaeth posts small blind 200
Zzzdoerrr posts big blind 400
Dealt to P1xel7 [2d 5s]
*** PRE-FLOP *** 
Uriage38130 folds
P1xel7 folds
Arte & Marte raises 600 to 1000
Bibi fuck folds
Astaeth raises 2000 to 3000
Zzzdoerrr folds
Arte & Marte calls 2000
*** FLOP *** [4c 6d Kc]
Astaeth bets 3350
Arte & Marte folds
Astaeth collected 10050 from pot
*** SUMMARY ***
Total pot 10050 | No rake
Board: [4c 6d Kc]
Seat 1: Astaeth (small blind) won 10050


