Winamax Poker - Tournament "X-MAS FEVER 5 € - DAY 1" buyIn: 4.50€ + 0.50€ level: 1 - HandId: #3150633295033663601-20-1703360186 - Holdem no limit (25/100/200) - 2023/12/23 19:36:26 UTC
Table: 'X-MAS FEVER 5 € - DAY 1(733563978)#0112' 6-max (real money) Seat #6 is the button
Seat 1: fuIImoon (39767)
Seat 2: P1xel7 (20000)
Seat 3: letoons26 (6342)
Seat 4: Whynot v (19423)
Seat 5: DUICEETDELOR (39070)
Seat 6: KAZAAR (20225)
*** ANTE/BLINDS ***
fuIImoon posts ante 25
P1xel7 posts ante 25
letoons26 posts ante 25
Whynot v posts ante 25
DUICEETDELOR posts ante 25
KAZAAR posts ante 25
fuIImoon posts small blind 100
P1xel7 posts big blind 200
Dealt to P1xel7 [Ah Th]
*** PRE-FLOP *** 
letoons26 calls 200
Whynot v folds
DUICEETDELOR folds
KAZAAR folds
fuIImoon folds
P1xel7 raises 800 to 1000
letoons26 calls 800
*** FLOP *** [4s Js 9h]
P1xel7 bets 788
letoons26 raises 4529 to 5317 and is all-in
P1xel7 folds
letoons26 collected 8355 from pot
*** SUMMARY ***
Total pot 8355 | No rake
Board: [4s Js 9h]
Seat 3: letoons26 won 8355


Winamax Poker - Tournament "X-MAS FEVER 5 € - DAY 1" buyIn: 4.50€ + 0.50€ level: 1 - HandId: #3150633295033663601-21-1703360224 - Holdem no limit (25/100/200) - 2023/12/23 19:37:04 UTC
Table: 'X-MAS FEVER 5 € - DAY 1(733563978)#0112' 6-max (real money) Seat #1 is the button
Seat 1: fuIImoon (39642)
Seat 2: P1xel7 (18187)
Seat 3: letoons26 (8355)
Seat 4: Whynot v (19398)
Seat 5: DUICEETDELOR (39045)
Seat 6: KAZAAR (20200)
*** ANTE/BLINDS ***
P1xel7 posts ante 25
letoons26 posts ante 25
fuIImoon posts ante 25
Whynot v posts ante 25
DUICEETDELOR posts ante 25
KAZAAR posts ante 25
P1xel7 posts small blind 100
letoons26 posts big blind 200
Dealt to P1xel7 [5d 5c]
*** PRE-FLOP *** 
Whynot v calls 200
DUICEETDELOR folds
KAZAAR raises 300 to 500
fuIImoon folds
P1xel7 calls 400
letoons26 calls 300
Whynot v calls 300
*** FLOP *** [Ac 2s 3h]
P1xel7 checks
letoons26 checks
Whynot v bets 2150
KAZAAR folds
P1xel7 folds
letoons26 folds
Whynot v collected 4300 from pot
*** SUMMARY ***
Total pot 4300 | No rake
Board: [Ac 2s 3h]
Seat 4: Whynot v won 4300


Winamax Poker - Tournament "X-MAS FEVER 5 € - DAY 1" buyIn: 4.50€ + 0.50€ level: 1 - HandId: #3150633295033663601-23-1703360318 - Holdem no limit (25/100/200) - 2023/12/23 19:38:38 UTC
Table: 'X-MAS FEVER 5 € - DAY 1(733563978)#0112' 6-max (real money) Seat #3 is the button
Seat 1: fuIImoon (39592)
Seat 2: P1xel7 (17637)
Seat 3: letoons26 (7705)
Seat 4: Whynot v (21248)
Seat 5: DUICEETDELOR (38995)
Seat 6: KAZAAR (19650)
*** ANTE/BLINDS ***
Whynot v posts ante 25
DUICEETDELOR posts ante 25
fuIImoon posts ante 25
P1xel7 posts ante 25
letoons26 posts ante 25
KAZAAR posts ante 25
Whynot v posts small blind 100
DUICEETDELOR posts big blind 200
Dealt to P1xel7 [Ah 8c]
*** PRE-FLOP *** 
KAZAAR raises 300 to 500
fuIImoon folds
P1xel7 folds
letoons26 calls 500
Whynot v folds
DUICEETDELOR calls 300
*** FLOP *** [6d 5s Qh]
DUICEETDELOR checks
KAZAAR bets 765
letoons26 calls 765
DUICEETDELOR calls 765
*** TURN *** [6d 5s Qh][Ks]
DUICEETDELOR checks
KAZAAR checks
letoons26 bets 2023
DUICEETDELOR folds
KAZAAR folds
letoons26 collected 6068 from pot
*** SUMMARY ***
Total pot 6068 | No rake
Board: [6d 5s Qh Ks]
Seat 3: letoons26 (button) won 6068


Winamax Poker - Tournament "X-MAS FEVER 5 € - DAY 1" buyIn: 4.50€ + 0.50€ level: 1 - HandId: #3150633295033663601-24-1703360429 - Holdem no limit (25/100/200) - 2023/12/23 19:40:29 UTC
Table: 'X-MAS FEVER 5 € - DAY 1(733563978)#0112' 6-max (real money) Seat #4 is the button
Seat 1: fuIImoon (39567)
Seat 2: P1xel7 (17612)
Seat 3: letoons26 (10460)
Seat 4: Whynot v (21123)
Seat 5: DUICEETDELOR (37705)
Seat 6: KAZAAR (18360)
*** ANTE/BLINDS ***
DUICEETDELOR posts ante 25
KAZAAR posts ante 25
fuIImoon posts ante 25
P1xel7 posts ante 25
letoons26 posts ante 25
Whynot v posts ante 25
DUICEETDELOR posts small blind 100
KAZAAR posts big blind 200
Dealt to P1xel7 [Kh 6d]
*** PRE-FLOP *** 
fuIImoon folds
P1xel7 folds
letoons26 raises 300 to 500
Whynot v calls 500
DUICEETDELOR folds
KAZAAR calls 300
*** FLOP *** [As 6h 2d]
KAZAAR checks
letoons26 bets 875
Whynot v calls 875
KAZAAR folds
*** TURN *** [As 6h 2d][9d]
letoons26 bets 2800
Whynot v raises 9100 to 11900
letoons26 calls 6260 and is all-in
*** RIVER *** [As 6h 2d 9d][4s]
*** SHOW DOWN ***
letoons26 shows [Qd Ac] (One pair : Aces)
Whynot v shows [2h 2c] (Trips of 2)
Whynot v collected 24460 from pot
*** SUMMARY ***
Total pot 24460 | No rake
Board: [As 6h 2d 9d 4s]
Seat 3: letoons26 showed [Qd Ac] and lost with One pair : Aces
Seat 4: Whynot v (button) showed [2h 2c] and won 24460 with Trips of 2


Winamax Poker - Tournament "X-MAS FEVER 5 € - DAY 1" buyIn: 4.50€ + 0.50€ level: 1 - HandId: #3150633295033663601-25-1703360481 - Holdem no limit (25/100/200) - 2023/12/23 19:41:21 UTC
Table: 'X-MAS FEVER 5 € - DAY 1(733563978)#0112' 6-max (real money) Seat #5 is the button
Seat 1: fuIImoon (39542)
Seat 2: P1xel7 (17587)
Seat 4: Whynot v (32283)
Seat 5: DUICEETDELOR (37580)
Seat 6: KAZAAR (17835)
*** ANTE/BLINDS ***
KAZAAR posts ante 25
fuIImoon posts ante 25
P1xel7 posts ante 25
Whynot v posts ante 25
DUICEETDELOR posts ante 25
KAZAAR posts small blind 100
fuIImoon posts big blind 200
Dealt to P1xel7 [Tc Kh]
*** PRE-FLOP *** 
P1xel7 raises 300 to 500
Whynot v calls 500
DUICEETDELOR raises 1300 to 1800
KAZAAR folds
fuIImoon folds
P1xel7 folds
Whynot v calls 1300
*** FLOP *** [7h 4c As]
Whynot v checks
DUICEETDELOR bets 1300
Whynot v calls 1300
*** TURN *** [7h 4c As][4d]
Whynot v checks
DUICEETDELOR checks
*** RIVER *** [7h 4c As 4d][Td]
Whynot v checks
DUICEETDELOR checks
*** SHOW DOWN ***
Whynot v shows [7s Jd] (Two pairs : 7 and 4)
DUICEETDELOR shows [Js Jh] (Two pairs : Jacks and 4)
DUICEETDELOR collected 7125 from pot
*** SUMMARY ***
Total pot 7125 | No rake
Board: [7h 4c As 4d Td]
Seat 4: Whynot v showed [7s Jd] and lost with Two pairs : 7 and 4
Seat 5: DUICEETDELOR (button) showed [Js Jh] and won 7125 with Two pairs : Jacks and 4


Winamax Poker - Tournament "X-MAS FEVER 5 € - DAY 1" buyIn: 4.50€ + 0.50€ level: 1 - HandId: #3150633295033663601-26-1703360529 - Holdem no limit (25/100/200) - 2023/12/23 19:42:09 UTC
Table: 'X-MAS FEVER 5 € - DAY 1(733563978)#0112' 6-max (real money) Seat #6 is the button
Seat 1: fuIImoon (39317)
Seat 2: P1xel7 (17062)
Seat 3: Wago7 (20000)
Seat 4: Whynot v (29158)
Seat 5: DUICEETDELOR (41580)
Seat 6: KAZAAR (17710)
*** ANTE/BLINDS ***
fuIImoon posts ante 25
P1xel7 posts ante 25
Wago7 posts ante 25
Whynot v posts ante 25
DUICEETDELOR posts ante 25
KAZAAR posts ante 25
fuIImoon posts small blind 100
P1xel7 posts big blind 200
Dealt to P1xel7 [Js 6s]
*** PRE-FLOP *** 
Wago7 folds
Whynot v raises 650 to 850
DUICEETDELOR folds
KAZAAR calls 850
fuIImoon folds
P1xel7 folds
*** FLOP *** [5h Kh 3h]
Whynot v checks
KAZAAR checks
*** TURN *** [5h Kh 3h][8h]
Whynot v bets 2150
KAZAAR folds
Whynot v collected 4300 from pot
*** SUMMARY ***
Total pot 4300 | No rake
Board: [5h Kh 3h 8h]
Seat 4: Whynot v won 4300


Winamax Poker - Tournament "X-MAS FEVER 5 € - DAY 1" buyIn: 4.50€ + 0.50€ level: 1 - HandId: #3150633295033663601-27-1703360567 - Holdem no limit (25/100/200) - 2023/12/23 19:42:47 UTC
Table: 'X-MAS FEVER 5 € - DAY 1(733563978)#0112' 6-max (real money) Seat #1 is the button
Seat 1: fuIImoon (39192)
Seat 2: P1xel7 (16837)
Seat 3: Wago7 (19975)
Seat 4: Whynot v (30433)
Seat 5: DUICEETDELOR (41555)
Seat 6: KAZAAR (16835)
*** ANTE/BLINDS ***
P1xel7 posts ante 25
Wago7 posts ante 25
fuIImoon posts ante 25
Whynot v posts ante 25
DUICEETDELOR posts ante 25
KAZAAR posts ante 25
P1xel7 posts small blind 100
Wago7 posts big blind 200
Dealt to P1xel7 [6h Qs]
*** PRE-FLOP *** 
Whynot v raises 650 to 850
DUICEETDELOR folds
KAZAAR folds
fuIImoon folds
P1xel7 folds
Wago7 folds
Whynot v collected 1300 from pot
*** SUMMARY ***
Total pot 1300 | No rake
Seat 4: Whynot v won 1300


Winamax Poker - Tournament "X-MAS FEVER 5 € - DAY 1" buyIn: 4.50€ + 0.50€ level: 1 - HandId: #3150633295033663601-28-1703360581 - Holdem no limit (25/100/200) - 2023/12/23 19:43:01 UTC
Table: 'X-MAS FEVER 5 € - DAY 1(733563978)#0112' 6-max (real money) Seat #2 is the button
Seat 1: fuIImoon (39167)
Seat 2: P1xel7 (16712)
Seat 3: Wago7 (19750)
Seat 4: Whynot v (30858)
Seat 5: DUICEETDELOR (41530)
Seat 6: KAZAAR (16810)
*** ANTE/BLINDS ***
Wago7 posts ante 25
Whynot v posts ante 25
fuIImoon posts ante 25
P1xel7 posts ante 25
DUICEETDELOR posts ante 25
KAZAAR posts ante 25
Wago7 posts small blind 100
Whynot v posts big blind 200
Dealt to P1xel7 [Qh 7c]
*** PRE-FLOP *** 
DUICEETDELOR folds
KAZAAR folds
fuIImoon raises 300 to 500
P1xel7 folds
Wago7 folds
Whynot v calls 300
*** FLOP *** [7d 7h 2h]
Whynot v checks
fuIImoon bets 438
Whynot v calls 438
*** TURN *** [7d 7h 2h][4h]
Whynot v checks
fuIImoon checks
*** RIVER *** [7d 7h 2h 4h][5s]
Whynot v checks
fuIImoon bets 3126
Whynot v calls 3126
*** SHOW DOWN ***
Whynot v shows [4d 2c] (Two pairs : 7 and 4)
fuIImoon shows [7s 9d] (Trips of 7)
fuIImoon collected 8378 from pot
*** SUMMARY ***
Total pot 8378 | No rake
Board: [7d 7h 2h 4h 5s]
Seat 1: fuIImoon showed [7s 9d] and won 8378 with Trips of 7
Seat 4: Whynot v (big blind) showed [4d 2c] and lost with Two pairs : 7 and 4


Winamax Poker - Tournament "X-MAS FEVER 5 € - DAY 1" buyIn: 4.50€ + 0.50€ level: 1 - HandId: #3150633295033663601-29-1703360642 - Holdem no limit (25/100/200) - 2023/12/23 19:44:02 UTC
Table: 'X-MAS FEVER 5 € - DAY 1(733563978)#0112' 6-max (real money) Seat #3 is the button
Seat 1: fuIImoon (43456)
Seat 2: P1xel7 (16687)
Seat 3: Wago7 (19625)
Seat 4: Whynot v (26769)
Seat 5: DUICEETDELOR (41505)
Seat 6: KAZAAR (16785)
*** ANTE/BLINDS ***
Whynot v posts ante 25
DUICEETDELOR posts ante 25
fuIImoon posts ante 25
P1xel7 posts ante 25
Wago7 posts ante 25
KAZAAR posts ante 25
Whynot v posts small blind 100
DUICEETDELOR posts big blind 200
Dealt to P1xel7 [2h Ah]
*** PRE-FLOP *** 
KAZAAR folds
fuIImoon folds
P1xel7 folds
Wago7 folds
Whynot v raises 550 to 750
DUICEETDELOR calls 550
*** FLOP *** [4h 3s As]
Whynot v checks
DUICEETDELOR checks
*** TURN *** [4h 3s As][3d]
Whynot v bets 1073
DUICEETDELOR folds
Whynot v collected 2723 from pot
*** SUMMARY ***
Total pot 2723 | No rake
Board: [4h 3s As 3d]
Seat 4: Whynot v (small blind) won 2723


Winamax Poker - Tournament "X-MAS FEVER 5 € - DAY 1" buyIn: 4.50€ + 0.50€ level: 1 - HandId: #3150633295033663601-30-1703360687 - Holdem no limit (25/100/200) - 2023/12/23 19:44:47 UTC
Table: 'X-MAS FEVER 5 € - DAY 1(733563978)#0112' 6-max (real money) Seat #4 is the button
Seat 1: fuIImoon (43431)
Seat 2: P1xel7 (16662)
Seat 3: Wago7 (19600)
Seat 4: Whynot v (27644)
Seat 5: DUICEETDELOR (40730)
Seat 6: KAZAAR (16760)
*** ANTE/BLINDS ***
DUICEETDELOR posts ante 25
KAZAAR posts ante 25
fuIImoon posts ante 25
P1xel7 posts ante 25
Wago7 posts ante 25
Whynot v posts ante 25
DUICEETDELOR posts small blind 100
KAZAAR posts big blind 200
Dealt to P1xel7 [9s 3c]
*** PRE-FLOP *** 
fuIImoon folds
P1xel7 folds
Wago7 folds
Whynot v raises 650 to 850
DUICEETDELOR folds
KAZAAR folds
Whynot v collected 1300 from pot
*** SUMMARY ***
Total pot 1300 | No rake
Seat 4: Whynot v (button) won 1300


Winamax Poker - Tournament "X-MAS FEVER 5 € - DAY 1" buyIn: 4.50€ + 0.50€ level: 1 - HandId: #3150633295033663601-31-1703360700 - Holdem no limit (25/100/200) - 2023/12/23 19:45:00 UTC
Table: 'X-MAS FEVER 5 € - DAY 1(733563978)#0112' 6-max (real money) Seat #5 is the button
Seat 1: fuIImoon (43406)
Seat 2: P1xel7 (16637)
Seat 3: Wago7 (19575)
Seat 4: Whynot v (28069)
Seat 5: DUICEETDELOR (40605)
Seat 6: KAZAAR (16535)
*** ANTE/BLINDS ***
KAZAAR posts ante 25
fuIImoon posts ante 25
P1xel7 posts ante 25
Wago7 posts ante 25
Whynot v posts ante 25
DUICEETDELOR posts ante 25
KAZAAR posts small blind 100
fuIImoon posts big blind 200
Dealt to P1xel7 [Js Jh]
*** PRE-FLOP *** 
P1xel7 raises 400 to 600
Wago7 folds
Whynot v calls 600
DUICEETDELOR folds
KAZAAR folds
fuIImoon folds
*** FLOP *** [Ks 2c 9s]
P1xel7 bets 825
Whynot v calls 825
*** TURN *** [Ks 2c 9s][3d]
P1xel7 bets 1650
Whynot v calls 1650
*** RIVER *** [Ks 2c 9s 3d][Qh]
P1xel7 bets 1650
Whynot v calls 1650
*** SHOW DOWN ***
P1xel7 shows [Js Jh] (One pair : Jacks)
Whynot v shows [6c Kd] (One pair : Kings)
Whynot v collected 9900 from pot
*** SUMMARY ***
Total pot 9900 | No rake
Board: [Ks 2c 9s 3d Qh]
Seat 2: P1xel7 showed [Js Jh] and lost with One pair : Jacks
Seat 4: Whynot v showed [6c Kd] and won 9900 with One pair : Kings


Winamax Poker - Tournament "X-MAS FEVER 5 € - DAY 1" buyIn: 4.50€ + 0.50€ level: 1 - HandId: #3150633295033663601-32-1703360738 - Holdem no limit (25/100/200) - 2023/12/23 19:45:38 UTC
Table: 'X-MAS FEVER 5 € - DAY 1(733563978)#0112' 6-max (real money) Seat #6 is the button
Seat 1: fuIImoon (43181)
Seat 2: P1xel7 (11887)
Seat 3: Wago7 (19550)
Seat 4: Whynot v (33219)
Seat 5: DUICEETDELOR (40580)
Seat 6: KAZAAR (16410)
*** ANTE/BLINDS ***
fuIImoon posts ante 25
P1xel7 posts ante 25
Wago7 posts ante 25
Whynot v posts ante 25
DUICEETDELOR posts ante 25
KAZAAR posts ante 25
fuIImoon posts small blind 100
P1xel7 posts big blind 200
Dealt to P1xel7 [9d 5c]
*** PRE-FLOP *** 
Wago7 raises 300 to 500
Whynot v calls 500
DUICEETDELOR folds
KAZAAR folds
fuIImoon folds
P1xel7 folds
*** FLOP *** [Ks 9c Tc]
Wago7 bets 943
Whynot v calls 943
*** TURN *** [Ks 9c Tc][Kd]
Wago7 bets 2669
Whynot v folds
Wago7 collected 6005 from pot
*** SUMMARY ***
Total pot 6005 | No rake
Board: [Ks 9c Tc Kd]
Seat 3: Wago7 won 6005


Winamax Poker - Tournament "X-MAS FEVER 5 € - DAY 1" buyIn: 4.50€ + 0.50€ level: 1 - HandId: #3150633295033663601-33-1703360774 - Holdem no limit (25/100/200) - 2023/12/23 19:46:14 UTC
Table: 'X-MAS FEVER 5 € - DAY 1(733563978)#0112' 6-max (real money) Seat #1 is the button
Seat 1: fuIImoon (43056)
Seat 2: P1xel7 (11662)
Seat 3: Wago7 (21418)
Seat 4: Whynot v (31751)
Seat 5: DUICEETDELOR (40555)
Seat 6: KAZAAR (16385)
*** ANTE/BLINDS ***
P1xel7 posts ante 25
Wago7 posts ante 25
fuIImoon posts ante 25
Whynot v posts ante 25
DUICEETDELOR posts ante 25
KAZAAR posts ante 25
P1xel7 posts small blind 100
Wago7 posts big blind 200
Dealt to P1xel7 [Jd As]
*** PRE-FLOP *** 
Whynot v calls 200
DUICEETDELOR folds
KAZAAR folds
fuIImoon folds
P1xel7 raises 400 to 600
Wago7 folds
Whynot v calls 400
*** FLOP *** [6h 2d Ad]
P1xel7 checks
Whynot v checks
*** TURN *** [6h 2d Ad][Th]
P1xel7 bets 543
Whynot v calls 543
*** RIVER *** [6h 2d Ad Th][3d]
P1xel7 bets 1713
Whynot v folds
P1xel7 collected 4349 from pot
*** SUMMARY ***
Total pot 4349 | No rake
Board: [6h 2d Ad Th 3d]
Seat 2: P1xel7 (small blind) won 4349


Winamax Poker - Tournament "X-MAS FEVER 5 € - DAY 1" buyIn: 4.50€ + 0.50€ level: 1 - HandId: #3150633295033663601-34-1703360817 - Holdem no limit (25/100/200) - 2023/12/23 19:46:57 UTC
Table: 'X-MAS FEVER 5 € - DAY 1(733563978)#0112' 6-max (real money) Seat #2 is the button
Seat 1: fuIImoon (43031)
Seat 2: P1xel7 (13130)
Seat 3: Wago7 (21193)
Seat 4: Whynot v (30583)
Seat 5: DUICEETDELOR (40530)
Seat 6: KAZAAR (16360)
*** ANTE/BLINDS ***
Wago7 posts ante 25
Whynot v posts ante 25
fuIImoon posts ante 25
P1xel7 posts ante 25
DUICEETDELOR posts ante 25
KAZAAR posts ante 25
Wago7 posts small blind 100
Whynot v posts big blind 200
Dealt to P1xel7 [9s Td]
*** PRE-FLOP *** 
DUICEETDELOR folds
KAZAAR folds
fuIImoon raises 300 to 500
P1xel7 folds
Wago7 folds
Whynot v calls 300
*** FLOP *** [5d 7c 8h]
Whynot v checks
fuIImoon bets 313
Whynot v calls 313
*** TURN *** [5d 7c 8h][3s]
Whynot v bets 1876
fuIImoon folds
Whynot v collected 3752 from pot
*** SUMMARY ***
Total pot 3752 | No rake
Board: [5d 7c 8h 3s]
Seat 4: Whynot v (big blind) won 3752


Winamax Poker - Tournament "X-MAS FEVER 5 € - DAY 1" buyIn: 4.50€ + 0.50€ level: 1 - HandId: #3150633295033663601-35-1703360871 - Holdem no limit (25/100/200) - 2023/12/23 19:47:51 UTC
Table: 'X-MAS FEVER 5 € - DAY 1(733563978)#0112' 6-max (real money) Seat #3 is the button
Seat 1: fuIImoon (42193)
Seat 2: P1xel7 (13105)
Seat 3: Wago7 (21068)
Seat 4: Whynot v (31621)
Seat 5: DUICEETDELOR (40505)
Seat 6: KAZAAR (16335)
*** ANTE/BLINDS ***
Whynot v posts ante 25
DUICEETDELOR posts ante 25
fuIImoon posts ante 25
P1xel7 posts ante 25
Wago7 posts ante 25
KAZAAR posts ante 25
Whynot v posts small blind 100
DUICEETDELOR posts big blind 200
Dealt to P1xel7 [Ac Ks]
*** PRE-FLOP *** 
KAZAAR folds
fuIImoon folds
P1xel7 raises 500 to 700
Wago7 folds
Whynot v calls 600
DUICEETDELOR calls 500
*** FLOP *** [Jc Ad 9d]
Whynot v checks
DUICEETDELOR checks
P1xel7 bets 788
Whynot v calls 788
DUICEETDELOR calls 788
*** TURN *** [Jc Ad 9d][5c]
Whynot v checks
DUICEETDELOR checks
P1xel7 bets 2307
Whynot v folds
DUICEETDELOR folds
P1xel7 collected 6921 from pot
*** SUMMARY ***
Total pot 6921 | No rake
Board: [Jc Ad 9d 5c]
Seat 2: P1xel7 won 6921


Winamax Poker - Tournament "X-MAS FEVER 5 € - DAY 1" buyIn: 4.50€ + 0.50€ level: 1 - HandId: #3150633295033663601-36-1703360946 - Holdem no limit (25/100/200) - 2023/12/23 19:49:06 UTC
Table: 'X-MAS FEVER 5 € - DAY 1(733563978)#0112' 6-max (real money) Seat #4 is the button
Seat 1: fuIImoon (42168)
Seat 2: P1xel7 (16206)
Seat 3: Wago7 (21043)
Seat 4: Whynot v (30108)
Seat 5: DUICEETDELOR (38992)
Seat 6: KAZAAR (16310)
*** ANTE/BLINDS ***
DUICEETDELOR posts ante 25
KAZAAR posts ante 25
fuIImoon posts ante 25
P1xel7 posts ante 25
Wago7 posts ante 25
Whynot v posts ante 25
DUICEETDELOR posts small blind 100
KAZAAR posts big blind 200
Dealt to P1xel7 [5s 4c]
*** PRE-FLOP *** 
fuIImoon folds
P1xel7 folds
Wago7 folds
Whynot v raises 650 to 850
DUICEETDELOR folds
KAZAAR raises 1950 to 2800
Whynot v calls 1950
*** FLOP *** [Js 5c As]
KAZAAR bets 2925
Whynot v calls 2925
*** TURN *** [Js 5c As][2c]
KAZAAR bets 10560 and is all-in
Whynot v folds
KAZAAR collected 22260 from pot
*** SUMMARY ***
Total pot 22260 | No rake
Board: [Js 5c As 2c]
Seat 6: KAZAAR (big blind) won 22260


Winamax Poker - Tournament "X-MAS FEVER 5 € - DAY 1" buyIn: 4.50€ + 0.50€ level: 1 - HandId: #3150633295033663601-37-1703361000 - Holdem no limit (25/100/200) - 2023/12/23 19:50:00 UTC
Table: 'X-MAS FEVER 5 € - DAY 1(733563978)#0112' 6-max (real money) Seat #5 is the button
Seat 1: fuIImoon (42143)
Seat 2: P1xel7 (16181)
Seat 3: Wago7 (21018)
Seat 4: Whynot v (24358)
Seat 5: DUICEETDELOR (38867)
Seat 6: KAZAAR (22260)
*** ANTE/BLINDS ***
KAZAAR posts ante 25
fuIImoon posts ante 25
P1xel7 posts ante 25
Wago7 posts ante 25
Whynot v posts ante 25
DUICEETDELOR posts ante 25
KAZAAR posts small blind 100
fuIImoon posts big blind 200
Dealt to P1xel7 [Qd Jh]
*** PRE-FLOP *** 
P1xel7 folds
Wago7 folds
Whynot v folds
DUICEETDELOR folds
KAZAAR folds
fuIImoon collected 450 from pot
*** SUMMARY ***
Total pot 450 | No rake
Seat 1: fuIImoon (big blind) won 450


Winamax Poker - Tournament "X-MAS FEVER 5 € - DAY 1" buyIn: 4.50€ + 0.50€ level: 1 - HandId: #3150633295033663601-38-1703361027 - Holdem no limit (25/100/200) - 2023/12/23 19:50:27 UTC
Table: 'X-MAS FEVER 5 € - DAY 1(733563978)#0112' 6-max (real money) Seat #6 is the button
Seat 1: fuIImoon (42368)
Seat 2: P1xel7 (16156)
Seat 3: Wago7 (20993)
Seat 4: Whynot v (24333)
Seat 5: DUICEETDELOR (38842)
Seat 6: KAZAAR (22135)
*** ANTE/BLINDS ***
fuIImoon posts ante 25
P1xel7 posts ante 25
Wago7 posts ante 25
Whynot v posts ante 25
DUICEETDELOR posts ante 25
KAZAAR posts ante 25
fuIImoon posts small blind 100
P1xel7 posts big blind 200
Dealt to P1xel7 [5d 8s]
*** PRE-FLOP *** 
Wago7 folds
Whynot v raises 650 to 850
DUICEETDELOR folds
KAZAAR calls 850
fuIImoon folds
P1xel7 folds
*** FLOP *** [4c 4h 5h]
Whynot v checks
KAZAAR checks
*** TURN *** [4c 4h 5h][7s]
Whynot v bets 2150
KAZAAR folds
Whynot v collected 4300 from pot
*** SUMMARY ***
Total pot 4300 | No rake
Board: [4c 4h 5h 7s]
Seat 4: Whynot v won 4300


Winamax Poker - Tournament "X-MAS FEVER 5 € - DAY 1" buyIn: 4.50€ + 0.50€ level: 1 - HandId: #3150633295033663601-39-1703361091 - Holdem no limit (25/100/200) - 2023/12/23 19:51:31 UTC
Table: 'X-MAS FEVER 5 € - DAY 1(733563978)#0112' 6-max (real money) Seat #1 is the button
Seat 1: fuIImoon (42243)
Seat 2: P1xel7 (15931)
Seat 3: Wago7 (20968)
Seat 4: Whynot v (25608)
Seat 5: DUICEETDELOR (38817)
Seat 6: KAZAAR (21260)
*** ANTE/BLINDS ***
P1xel7 posts ante 25
Wago7 posts ante 25
fuIImoon posts ante 25
Whynot v posts ante 25
DUICEETDELOR posts ante 25
KAZAAR posts ante 25
P1xel7 posts small blind 100
Wago7 posts big blind 200
Dealt to P1xel7 [Ac 7h]
*** PRE-FLOP *** 
Whynot v calls 200
DUICEETDELOR raises 800 to 1000
KAZAAR folds
fuIImoon folds
P1xel7 folds
Wago7 folds
Whynot v calls 800
*** FLOP *** [2d 4h Jd]
Whynot v checks
DUICEETDELOR bets 858
Whynot v calls 858
*** TURN *** [2d 4h Jd][6c]
Whynot v checks
DUICEETDELOR checks
*** RIVER *** [2d 4h Jd 6c][9d]
Whynot v checks
DUICEETDELOR checks
*** SHOW DOWN ***
DUICEETDELOR shows [Kd Qs] (High card : King)
Whynot v shows [4c 3c] (One pair : 4)
Whynot v collected 4166 from pot
*** SUMMARY ***
Total pot 4166 | No rake
Board: [2d 4h Jd 6c 9d]
Seat 4: Whynot v showed [4c 3c] and won 4166 with One pair : 4
Seat 5: DUICEETDELOR showed [Kd Qs] and lost with High card : King


Winamax Poker - Tournament "X-MAS FEVER 5 € - DAY 1" buyIn: 4.50€ + 0.50€ level: 1 - HandId: #3150633295033663601-40-1703361139 - Holdem no limit (25/100/200) - 2023/12/23 19:52:19 UTC
Table: 'X-MAS FEVER 5 € - DAY 1(733563978)#0112' 6-max (real money) Seat #2 is the button
Seat 1: fuIImoon (42218)
Seat 2: P1xel7 (15806)
Seat 3: Wago7 (20743)
Seat 4: Whynot v (27891)
Seat 5: DUICEETDELOR (36934)
Seat 6: KAZAAR (21235)
*** ANTE/BLINDS ***
Wago7 posts ante 25
Whynot v posts ante 25
fuIImoon posts ante 25
P1xel7 posts ante 25
DUICEETDELOR posts ante 25
KAZAAR posts ante 25
Wago7 posts small blind 100
Whynot v posts big blind 200
Dealt to P1xel7 [4s 3c]
*** PRE-FLOP *** 
DUICEETDELOR folds
KAZAAR folds
fuIImoon folds
P1xel7 folds
Wago7 raises 500 to 700
Whynot v calls 500
*** FLOP *** [Jc 9d 6c]
Wago7 checks
Whynot v bets 200
Wago7 calls 200
*** TURN *** [Jc 9d 6c][7c]
Wago7 checks
Whynot v bets 200
Wago7 calls 200
*** RIVER *** [Jc 9d 6c 7c][Kh]
Wago7 checks
Whynot v checks
*** SHOW DOWN ***
Wago7 shows [Ts Ac] (High card : Ace)
Whynot v shows [6d Ad] (One pair : 6)
Whynot v collected 2350 from pot
*** SUMMARY ***
Total pot 2350 | No rake
Board: [Jc 9d 6c 7c Kh]
Seat 3: Wago7 (small blind) showed [Ts Ac] and lost with High card : Ace
Seat 4: Whynot v (big blind) showed [6d Ad] and won 2350 with One pair : 6


Winamax Poker - Tournament "X-MAS FEVER 5 € - DAY 1" buyIn: 4.50€ + 0.50€ level: 1 - HandId: #3150633295033663601-41-1703361180 - Holdem no limit (25/100/200) - 2023/12/23 19:53:00 UTC
Table: 'X-MAS FEVER 5 € - DAY 1(733563978)#0112' 6-max (real money) Seat #3 is the button
Seat 1: fuIImoon (42193)
Seat 2: P1xel7 (15781)
Seat 3: Wago7 (19618)
Seat 4: Whynot v (29116)
Seat 5: DUICEETDELOR (36909)
Seat 6: KAZAAR (21210)
*** ANTE/BLINDS ***
Whynot v posts ante 25
DUICEETDELOR posts ante 25
fuIImoon posts ante 25
P1xel7 posts ante 25
Wago7 posts ante 25
KAZAAR posts ante 25
Whynot v posts small blind 100
DUICEETDELOR posts big blind 200
Dealt to P1xel7 [5d Td]
*** PRE-FLOP *** 
KAZAAR folds
fuIImoon folds
P1xel7 folds
Wago7 raises 300 to 500
Whynot v folds
DUICEETDELOR raises 1300 to 1800
Wago7 calls 1300
*** FLOP *** [Kd Ah 5h]
DUICEETDELOR bets 1500
Wago7 calls 1500
*** TURN *** [Kd Ah 5h][Qc]
DUICEETDELOR checks
Wago7 checks
*** RIVER *** [Kd Ah 5h Qc][4c]
DUICEETDELOR checks
Wago7 checks
*** SHOW DOWN ***
Wago7 shows [8c Kc] (One pair : Kings)
DUICEETDELOR shows [Ac 9d] (One pair : Aces)
DUICEETDELOR collected 6850 from pot
*** SUMMARY ***
Total pot 6850 | No rake
Board: [Kd Ah 5h Qc 4c]
Seat 3: Wago7 (button) showed [8c Kc] and lost with One pair : Kings
Seat 5: DUICEETDELOR (big blind) showed [Ac 9d] and won 6850 with One pair : Aces


Winamax Poker - Tournament "X-MAS FEVER 5 € - DAY 1" buyIn: 4.50€ + 0.50€ level: 1 - HandId: #3150633295033663601-42-1703361271 - Holdem no limit (25/100/200) - 2023/12/23 19:54:31 UTC
Table: 'X-MAS FEVER 5 € - DAY 1(733563978)#0112' 6-max (real money) Seat #4 is the button
Seat 2: P1xel7 (15756)
Seat 3: Wago7 (16293)
Seat 4: Whynot v (28991)
Seat 5: DUICEETDELOR (40434)
Seat 6: KAZAAR (21185)
*** ANTE/BLINDS ***
DUICEETDELOR posts ante 25
KAZAAR posts ante 25
P1xel7 posts ante 25
Wago7 posts ante 25
Whynot v posts ante 25
DUICEETDELOR posts small blind 100
KAZAAR posts big blind 200
Dealt to P1xel7 [Ac 9d]
*** PRE-FLOP *** 
P1xel7 raises 400 to 600
Wago7 raises 1200 to 1800
Whynot v folds
DUICEETDELOR folds
KAZAAR folds
P1xel7 folds
Wago7 collected 2825 from pot
*** SUMMARY ***
Total pot 2825 | No rake
Seat 3: Wago7 won 2825


Winamax Poker - Tournament "X-MAS FEVER 5 € - DAY 1" buyIn: 4.50€ + 0.50€ level: 1 - HandId: #3150633295033663601-43-1703361295 - Holdem no limit (25/100/200) - 2023/12/23 19:54:55 UTC
Table: 'X-MAS FEVER 5 € - DAY 1(733563978)#0112' 6-max (real money) Seat #5 is the button
Seat 1: chuichoWS57 (20000)
Seat 2: P1xel7 (15131)
Seat 3: Wago7 (17293)
Seat 4: Whynot v (28966)
Seat 5: DUICEETDELOR (40309)
Seat 6: KAZAAR (20960)
*** ANTE/BLINDS ***
KAZAAR posts ante 25
chuichoWS57 posts ante 25
P1xel7 posts ante 25
Wago7 posts ante 25
Whynot v posts ante 25
DUICEETDELOR posts ante 25
KAZAAR posts small blind 100
chuichoWS57 posts big blind 200
Dealt to P1xel7 [Jc 5h]
*** PRE-FLOP *** 
P1xel7 folds
Wago7 raises 300 to 500
Whynot v calls 500
DUICEETDELOR calls 500
KAZAAR folds
chuichoWS57 calls 300
*** FLOP *** [Jh 8c 7c]
chuichoWS57 checks
Wago7 bets 1463
Whynot v folds
DUICEETDELOR calls 1463
chuichoWS57 folds
*** TURN *** [Jh 8c 7c][Qd]
Wago7 bets 3764
DUICEETDELOR calls 3764
*** RIVER *** [Jh 8c 7c Qd][2s]
Wago7 bets 11541 and is all-in
DUICEETDELOR folds
Wago7 collected 24245 from pot
*** SUMMARY ***
Total pot 24245 | No rake
Board: [Jh 8c 7c Qd 2s]
Seat 3: Wago7 won 24245


Winamax Poker - Tournament "X-MAS FEVER 5 € - DAY 1" buyIn: 4.50€ + 0.50€ level: 1 - HandId: #3150633295033663601-44-1703361662 - Holdem no limit (25/100/200) - 2023/12/23 20:01:02 UTC
Table: 'X-MAS FEVER 5 € - DAY 1(733563978)#0112' 6-max (real money) Seat #6 is the button
Seat 1: chuichoWS57 (19475)
Seat 2: P1xel7 (15106)
Seat 3: Wago7 (24245)
Seat 4: Whynot v (28441)
Seat 5: DUICEETDELOR (34557)
Seat 6: KAZAAR (20835)
*** ANTE/BLINDS ***
chuichoWS57 posts ante 25
P1xel7 posts ante 25
Wago7 posts ante 25
Whynot v posts ante 25
DUICEETDELOR posts ante 25
KAZAAR posts ante 25
chuichoWS57 posts small blind 100
P1xel7 posts big blind 200
Dealt to P1xel7 [Jc Qd]
*** PRE-FLOP *** 
Wago7 raises 300 to 500
Whynot v calls 500
DUICEETDELOR folds
KAZAAR calls 500
chuichoWS57 folds
P1xel7 calls 300
*** FLOP *** [2d 7s 7h]
P1xel7 checks
Wago7 bets 788
Whynot v calls 788
KAZAAR folds
P1xel7 folds
*** TURN *** [2d 7s 7h][5d]
Wago7 checks
Whynot v checks
*** RIVER *** [2d 7s 7h 5d][Jh]
Wago7 checks
Whynot v bets 3826
Wago7 folds
Whynot v collected 7652 from pot
*** SUMMARY ***
Total pot 7652 | No rake
Board: [2d 7s 7h 5d Jh]
Seat 4: Whynot v won 7652


Winamax Poker - Tournament "X-MAS FEVER 5 € - DAY 1" buyIn: 4.50€ + 0.50€ level: 1 - HandId: #3150633295033663601-45-1703361737 - Holdem no limit (25/100/200) - 2023/12/23 20:02:17 UTC
Table: 'X-MAS FEVER 5 € - DAY 1(733563978)#0112' 6-max (real money) Seat #1 is the button
Seat 1: chuichoWS57 (19350)
Seat 2: P1xel7 (14581)
Seat 3: Wago7 (22932)
Seat 4: Whynot v (30954)
Seat 5: DUICEETDELOR (34532)
Seat 6: KAZAAR (20310)
*** ANTE/BLINDS ***
P1xel7 posts ante 25
Wago7 posts ante 25
chuichoWS57 posts ante 25
Whynot v posts ante 25
DUICEETDELOR posts ante 25
KAZAAR posts ante 25
P1xel7 posts small blind 100
Wago7 posts big blind 200
Dealt to P1xel7 [Jh 4s]
*** PRE-FLOP *** 
Whynot v calls 200
DUICEETDELOR folds
KAZAAR raises 200 to 400
chuichoWS57 folds
P1xel7 folds
Wago7 folds
Whynot v calls 200
*** FLOP *** [Tc Qd 7c]
Whynot v checks
KAZAAR bets 500
Whynot v folds
KAZAAR collected 1750 from pot
*** SUMMARY ***
Total pot 1750 | No rake
Board: [Tc Qd 7c]
Seat 6: KAZAAR won 1750


Winamax Poker - Tournament "X-MAS FEVER 5 € - DAY 1" buyIn: 4.50€ + 0.50€ level: 1 - HandId: #3150633295033663601-46-1703361790 - Holdem no limit (25/100/200) - 2023/12/23 20:03:10 UTC
Table: 'X-MAS FEVER 5 € - DAY 1(733563978)#0112' 6-max (real money) Seat #2 is the button
Seat 1: chuichoWS57 (19325)
Seat 2: P1xel7 (14456)
Seat 3: Wago7 (22707)
Seat 4: Whynot v (30529)
Seat 5: DUICEETDELOR (34507)
Seat 6: KAZAAR (21135)
*** ANTE/BLINDS ***
Wago7 posts ante 25
Whynot v posts ante 25
chuichoWS57 posts ante 25
P1xel7 posts ante 25
DUICEETDELOR posts ante 25
KAZAAR posts ante 25
Wago7 posts small blind 100
Whynot v posts big blind 200
Dealt to P1xel7 [Kh 2h]
*** PRE-FLOP *** 
DUICEETDELOR folds
KAZAAR folds
chuichoWS57 folds
P1xel7 raises 300 to 500
Wago7 raises 1300 to 1800
Whynot v folds
P1xel7 folds
Wago7 collected 2650 from pot
*** SUMMARY ***
Total pot 2650 | No rake
Seat 3: Wago7 (small blind) won 2650


Winamax Poker - Tournament "X-MAS FEVER 5 € - DAY 1" buyIn: 4.50€ + 0.50€ level: 1 - HandId: #3150633295033663601-47-1703361826 - Holdem no limit (25/100/200) - 2023/12/23 20:03:46 UTC
Table: 'X-MAS FEVER 5 € - DAY 1(733563978)#0112' 6-max (real money) Seat #3 is the button
Seat 1: chuichoWS57 (19300)
Seat 2: P1xel7 (13931)
Seat 3: Wago7 (23532)
Seat 4: Whynot v (30304)
Seat 5: DUICEETDELOR (34482)
Seat 6: KAZAAR (21110)
*** ANTE/BLINDS ***
Whynot v posts ante 25
DUICEETDELOR posts ante 25
chuichoWS57 posts ante 25
P1xel7 posts ante 25
Wago7 posts ante 25
KAZAAR posts ante 25
Whynot v posts small blind 100
DUICEETDELOR posts big blind 200
Dealt to P1xel7 [Qs Th]
*** PRE-FLOP *** 
KAZAAR raises 300 to 500
chuichoWS57 calls 500
P1xel7 folds
Wago7 folds
Whynot v folds
DUICEETDELOR calls 300
*** FLOP *** [8d 2s 9c]
DUICEETDELOR checks
KAZAAR checks
chuichoWS57 bets 875
DUICEETDELOR folds
KAZAAR folds
chuichoWS57 collected 2625 from pot
*** SUMMARY ***
Total pot 2625 | No rake
Board: [8d 2s 9c]
Seat 1: chuichoWS57 won 2625


Winamax Poker - Tournament "X-MAS FEVER 5 € - DAY 1" buyIn: 4.50€ + 0.50€ level: 1 - HandId: #3150633295033663601-48-1703361867 - Holdem no limit (25/100/200) - 2023/12/23 20:04:27 UTC
Table: 'X-MAS FEVER 5 € - DAY 1(733563978)#0112' 6-max (real money) Seat #4 is the button
Seat 1: chuichoWS57 (20525)
Seat 2: P1xel7 (13906)
Seat 3: Wago7 (23507)
Seat 4: Whynot v (30179)
Seat 5: DUICEETDELOR (33957)
Seat 6: KAZAAR (20585)
*** ANTE/BLINDS ***
DUICEETDELOR posts ante 25
KAZAAR posts ante 25
chuichoWS57 posts ante 25
P1xel7 posts ante 25
Wago7 posts ante 25
Whynot v posts ante 25
DUICEETDELOR posts small blind 100
KAZAAR posts big blind 200
Dealt to P1xel7 [2h Qd]
*** PRE-FLOP *** 
chuichoWS57 folds
P1xel7 folds
Wago7 folds
Whynot v raises 300 to 500
DUICEETDELOR folds
KAZAAR folds
Whynot v collected 950 from pot
*** SUMMARY ***
Total pot 950 | No rake
Seat 4: Whynot v (button) won 950


Winamax Poker - Tournament "X-MAS FEVER 5 € - DAY 1" buyIn: 4.50€ + 0.50€ level: 1 - HandId: #3150633295033663601-49-1703361906 - Holdem no limit (25/100/200) - 2023/12/23 20:05:06 UTC
Table: 'X-MAS FEVER 5 € - DAY 1(733563978)#0112' 6-max (real money) Seat #5 is the button
Seat 1: chuichoWS57 (20500)
Seat 2: P1xel7 (13881)
Seat 3: Wago7 (23482)
Seat 4: Whynot v (30604)
Seat 5: DUICEETDELOR (33832)
Seat 6: KAZAAR (20360)
*** ANTE/BLINDS ***
KAZAAR posts ante 25
chuichoWS57 posts ante 25
P1xel7 posts ante 25
Wago7 posts ante 25
Whynot v posts ante 25
DUICEETDELOR posts ante 25
KAZAAR posts small blind 100
chuichoWS57 posts big blind 200
Dealt to P1xel7 [Kh 2h]
*** PRE-FLOP *** 
P1xel7 folds
Wago7 folds
Whynot v folds
DUICEETDELOR folds
KAZAAR folds
chuichoWS57 collected 450 from pot
*** SUMMARY ***
Total pot 450 | No rake
Seat 1: chuichoWS57 (big blind) won 450


Winamax Poker - Tournament "X-MAS FEVER 5 € - DAY 1" buyIn: 4.50€ + 0.50€ level: 1 - HandId: #3150633295033663601-50-1703361917 - Holdem no limit (25/100/200) - 2023/12/23 20:05:17 UTC
Table: 'X-MAS FEVER 5 € - DAY 1(733563978)#0112' 6-max (real money) Seat #6 is the button
Seat 1: chuichoWS57 (20725)
Seat 2: P1xel7 (13856)
Seat 3: Wago7 (23457)
Seat 4: Whynot v (30579)
Seat 5: DUICEETDELOR (33807)
Seat 6: KAZAAR (20235)
*** ANTE/BLINDS ***
chuichoWS57 posts ante 25
P1xel7 posts ante 25
Wago7 posts ante 25
Whynot v posts ante 25
DUICEETDELOR posts ante 25
KAZAAR posts ante 25
chuichoWS57 posts small blind 100
P1xel7 posts big blind 200
Dealt to P1xel7 [Qd Qs]
*** PRE-FLOP *** 
Wago7 folds
Whynot v calls 200
DUICEETDELOR raises 900 to 1100
KAZAAR folds
chuichoWS57 folds
P1xel7 raises 1900 to 3000
Whynot v folds
DUICEETDELOR raises 30782 to 33782 and is all-in
P1xel7 calls 10831 and is all-in
*** FLOP *** [9h 4s 5c]
*** TURN *** [9h 4s 5c][8d]
*** RIVER *** [9h 4s 5c 8d][2d]
*** SHOW DOWN ***
P1xel7 shows [Qd Qs] (One pair : Queens)
DUICEETDELOR shows [Td Th] (One pair : Tens)
DUICEETDELOR collected 19951 from side pot 1
P1xel7 collected 28112 from main pot
*** SUMMARY ***
Total pot 48063 | No rake
Board: [9h 4s 5c 8d 2d]
Seat 2: P1xel7 (big blind) showed [Qd Qs] and won 28112 with One pair : Queens
Seat 5: DUICEETDELOR showed [Td Th] and won 19951 with One pair : Tens


Winamax Poker - Tournament "X-MAS FEVER 5 € - DAY 1" buyIn: 4.50€ + 0.50€ level: 2 - HandId: #3150633295033663601-51-1703361965 - Holdem no limit (30/125/250) - 2023/12/23 20:06:05 UTC
Table: 'X-MAS FEVER 5 € - DAY 1(733563978)#0112' 6-max (real money) Seat #1 is the button
Seat 1: chuichoWS57 (20600)
Seat 2: P1xel7 (28112)
Seat 3: Wago7 (23432)
Seat 4: Whynot v (30354)
Seat 5: DUICEETDELOR (19951)
Seat 6: KAZAAR (20210)
*** ANTE/BLINDS ***
P1xel7 posts ante 30
Wago7 posts ante 30
chuichoWS57 posts ante 30
Whynot v posts ante 30
DUICEETDELOR posts ante 30
KAZAAR posts ante 30
P1xel7 posts small blind 125
Wago7 posts big blind 250
Dealt to P1xel7 [2h 3c]
*** PRE-FLOP *** 
Whynot v folds
DUICEETDELOR folds
KAZAAR raises 375 to 625
chuichoWS57 calls 625
P1xel7 folds
Wago7 folds
*** FLOP *** [5s 9d 9c]
KAZAAR bets 1028
chuichoWS57 calls 1028
*** TURN *** [5s 9d 9c][5c]
KAZAAR bets 1931
chuichoWS57 calls 1931
*** RIVER *** [5s 9d 9c 5c][Qc]
KAZAAR checks
chuichoWS57 checks
*** SHOW DOWN ***
KAZAAR shows [7s Ks] (Two pairs : 9 and 5)
chuichoWS57 shows [Ad Td] (Two pairs : 9 and 5)
chuichoWS57 collected 7723 from pot
*** SUMMARY ***
Total pot 7723 | No rake
Board: [5s 9d 9c 5c Qc]
Seat 1: chuichoWS57 (button) showed [Ad Td] and won 7723 with Two pairs : 9 and 5
Seat 6: KAZAAR showed [7s Ks] and lost with Two pairs : 9 and 5


Winamax Poker - Tournament "X-MAS FEVER 5 € - DAY 1" buyIn: 4.50€ + 0.50€ level: 2 - HandId: #3150633295033663601-52-1703362024 - Holdem no limit (30/125/250) - 2023/12/23 20:07:04 UTC
Table: 'X-MAS FEVER 5 € - DAY 1(733563978)#0112' 6-max (real money) Seat #2 is the button
Seat 1: chuichoWS57 (24709)
Seat 2: P1xel7 (27957)
Seat 3: Wago7 (23152)
Seat 4: Whynot v (30324)
Seat 5: DUICEETDELOR (19921)
Seat 6: KAZAAR (16596)
*** ANTE/BLINDS ***
Wago7 posts ante 30
Whynot v posts ante 30
chuichoWS57 posts ante 30
P1xel7 posts ante 30
DUICEETDELOR posts ante 30
KAZAAR posts ante 30
Wago7 posts small blind 125
Whynot v posts big blind 250
Dealt to P1xel7 [9h Ac]
*** PRE-FLOP *** 
DUICEETDELOR folds
KAZAAR folds
chuichoWS57 folds
P1xel7 raises 375 to 625
Wago7 folds
Whynot v calls 375
*** FLOP *** [3s 3c 4h]
Whynot v checks
P1xel7 checks
*** TURN *** [3s 3c 4h][Ts]
Whynot v bets 1011
P1xel7 folds
Whynot v collected 2566 from pot
*** SUMMARY ***
Total pot 2566 | No rake
Board: [3s 3c 4h Ts]
Seat 4: Whynot v (big blind) won 2566


Winamax Poker - Tournament "X-MAS FEVER 5 € - DAY 1" buyIn: 4.50€ + 0.50€ level: 2 - HandId: #3150633295033663601-53-1703362089 - Holdem no limit (30/125/250) - 2023/12/23 20:08:09 UTC
Table: 'X-MAS FEVER 5 € - DAY 1(733563978)#0112' 6-max (real money) Seat #3 is the button
Seat 1: chuichoWS57 (24679)
Seat 2: P1xel7 (27302)
Seat 3: Wago7 (22997)
Seat 4: Whynot v (31224)
Seat 5: DUICEETDELOR (19891)
Seat 6: KAZAAR (16566)
*** ANTE/BLINDS ***
Whynot v posts ante 30
DUICEETDELOR posts ante 30
chuichoWS57 posts ante 30
P1xel7 posts ante 30
Wago7 posts ante 30
KAZAAR posts ante 30
Whynot v posts small blind 125
DUICEETDELOR posts big blind 250
Dealt to P1xel7 [3d 4h]
*** PRE-FLOP *** 
KAZAAR folds
chuichoWS57 folds
P1xel7 folds
Wago7 raises 375 to 625
Whynot v calls 500
DUICEETDELOR raises 1750 to 2375
Wago7 folds
Whynot v calls 1750
*** FLOP *** [Kc Td Th]
Whynot v checks
DUICEETDELOR bets 1944
Whynot v calls 1944
*** TURN *** [Kc Td Th][Kh]
Whynot v checks
DUICEETDELOR bets 3305
Whynot v calls 3305
*** RIVER *** [Kc Td Th Kh][9s]
Whynot v bets 23570 and is all-in
DUICEETDELOR calls 12237 and is all-in
*** SHOW DOWN ***
Whynot v shows [Ad Jc] (Two pairs : Kings and Tens)
DUICEETDELOR shows [Kd Qd] (Full of Kings and Tens)
DUICEETDELOR collected 40527 from main pot
Whynot v collected 11333 from side pot 1
*** SUMMARY ***
Total pot 51860 | No rake
Board: [Kc Td Th Kh 9s]
Seat 4: Whynot v (small blind) showed [Ad Jc] and won 11333 with Two pairs : Kings and Tens
Seat 5: DUICEETDELOR (big blind) showed [Kd Qd] and won 40527 with Full of Kings and Tens


Winamax Poker - Tournament "X-MAS FEVER 5 € - DAY 1" buyIn: 4.50€ + 0.50€ level: 2 - HandId: #3150633295033663601-54-1703362143 - Holdem no limit (30/125/250) - 2023/12/23 20:09:03 UTC
Table: 'X-MAS FEVER 5 € - DAY 1(733563978)#0112' 6-max (real money) Seat #4 is the button
Seat 1: chuichoWS57 (24649)
Seat 2: P1xel7 (27272)
Seat 3: Wago7 (22342)
Seat 4: Whynot v (11333)
Seat 5: DUICEETDELOR (40527)
Seat 6: KAZAAR (16536)
*** ANTE/BLINDS ***
DUICEETDELOR posts ante 30
KAZAAR posts ante 30
chuichoWS57 posts ante 30
P1xel7 posts ante 30
Wago7 posts ante 30
Whynot v posts ante 30
DUICEETDELOR posts small blind 125
KAZAAR posts big blind 250
Dealt to P1xel7 [Ad 7c]
*** PRE-FLOP *** 
chuichoWS57 folds
P1xel7 folds
Wago7 folds
Whynot v folds
DUICEETDELOR calls 125
KAZAAR checks
*** FLOP *** [2h 6d Ac]
DUICEETDELOR bets 375
KAZAAR folds
DUICEETDELOR collected 1055 from pot
*** SUMMARY ***
Total pot 1055 | No rake
Board: [2h 6d Ac]
Seat 5: DUICEETDELOR (small blind) won 1055


Winamax Poker - Tournament "X-MAS FEVER 5 € - DAY 1" buyIn: 4.50€ + 0.50€ level: 2 - HandId: #3150633295033663601-55-1703362177 - Holdem no limit (30/125/250) - 2023/12/23 20:09:37 UTC
Table: 'X-MAS FEVER 5 € - DAY 1(733563978)#0112' 6-max (real money) Seat #5 is the button
Seat 1: chuichoWS57 (24619)
Seat 2: P1xel7 (27242)
Seat 3: Wago7 (22312)
Seat 4: Whynot v (11303)
Seat 5: DUICEETDELOR (40927)
Seat 6: KAZAAR (16256)
*** ANTE/BLINDS ***
KAZAAR posts ante 30
chuichoWS57 posts ante 30
P1xel7 posts ante 30
Wago7 posts ante 30
Whynot v posts ante 30
DUICEETDELOR posts ante 30
KAZAAR posts small blind 125
chuichoWS57 posts big blind 250
Dealt to P1xel7 [8s 7h]
*** PRE-FLOP *** 
P1xel7 folds
Wago7 folds
Whynot v raises 805 to 1055
DUICEETDELOR folds
KAZAAR folds
chuichoWS57 folds
Whynot v collected 1610 from pot
*** SUMMARY ***
Total pot 1610 | No rake
Seat 4: Whynot v won 1610


Winamax Poker - Tournament "X-MAS FEVER 5 € - DAY 1" buyIn: 4.50€ + 0.50€ level: 2 - HandId: #3150633295033663601-56-1703362207 - Holdem no limit (30/125/250) - 2023/12/23 20:10:07 UTC
Table: 'X-MAS FEVER 5 € - DAY 1(733563978)#0112' 6-max (real money) Seat #6 is the button
Seat 1: chuichoWS57 (24339)
Seat 2: P1xel7 (27212)
Seat 3: Wago7 (22282)
Seat 4: Whynot v (11828)
Seat 5: DUICEETDELOR (40897)
Seat 6: KAZAAR (16101)
*** ANTE/BLINDS ***
chuichoWS57 posts ante 30
P1xel7 posts ante 30
Wago7 posts ante 30
Whynot v posts ante 30
DUICEETDELOR posts ante 30
KAZAAR posts ante 30
chuichoWS57 posts small blind 125
P1xel7 posts big blind 250
Dealt to P1xel7 [3d Td]
*** PRE-FLOP *** 
Wago7 folds
Whynot v folds
DUICEETDELOR folds
KAZAAR folds
chuichoWS57 folds
P1xel7 collected 555 from pot
*** SUMMARY ***
Total pot 555 | No rake
Seat 2: P1xel7 (big blind) won 555


Winamax Poker - Tournament "X-MAS FEVER 5 € - DAY 1" buyIn: 4.50€ + 0.50€ level: 2 - HandId: #3150633295033663601-57-1703362229 - Holdem no limit (30/125/250) - 2023/12/23 20:10:29 UTC
Table: 'X-MAS FEVER 5 € - DAY 1(733563978)#0112' 6-max (real money) Seat #1 is the button
Seat 1: chuichoWS57 (24184)
Seat 2: P1xel7 (27487)
Seat 3: Wago7 (22252)
Seat 4: Whynot v (11798)
Seat 5: DUICEETDELOR (40867)
Seat 6: KAZAAR (16071)
*** ANTE/BLINDS ***
P1xel7 posts ante 30
Wago7 posts ante 30
chuichoWS57 posts ante 30
Whynot v posts ante 30
DUICEETDELOR posts ante 30
KAZAAR posts ante 30
P1xel7 posts small blind 125
Wago7 posts big blind 250
Dealt to P1xel7 [7h Th]
*** PRE-FLOP *** 
Whynot v raises 805 to 1055
DUICEETDELOR folds
KAZAAR folds
chuichoWS57 folds
P1xel7 folds
Wago7 folds
Whynot v collected 1610 from pot
*** SUMMARY ***
Total pot 1610 | No rake
Seat 4: Whynot v won 1610


Winamax Poker - Tournament "X-MAS FEVER 5 € - DAY 1" buyIn: 4.50€ + 0.50€ level: 2 - HandId: #3150633295033663601-58-1703362261 - Holdem no limit (30/125/250) - 2023/12/23 20:11:01 UTC
Table: 'X-MAS FEVER 5 € - DAY 1(733563978)#0112' 6-max (real money) Seat #2 is the button
Seat 1: chuichoWS57 (24154)
Seat 2: P1xel7 (27332)
Seat 3: Wago7 (21972)
Seat 4: Whynot v (12323)
Seat 5: DUICEETDELOR (40837)
Seat 6: KAZAAR (16041)
*** ANTE/BLINDS ***
Wago7 posts ante 30
Whynot v posts ante 30
chuichoWS57 posts ante 30
P1xel7 posts ante 30
DUICEETDELOR posts ante 30
KAZAAR posts ante 30
Wago7 posts small blind 125
Whynot v posts big blind 250
Dealt to P1xel7 [8d Qs]
*** PRE-FLOP *** 
DUICEETDELOR raises 313 to 563
KAZAAR folds
chuichoWS57 folds
P1xel7 folds
Wago7 folds
Whynot v calls 313
*** FLOP *** [2c Tc Ad]
Whynot v checks
DUICEETDELOR bets 625
Whynot v calls 625
*** TURN *** [2c Tc Ad][4d]
Whynot v checks
DUICEETDELOR bets 1743
Whynot v calls 1743
*** RIVER *** [2c Tc Ad 4d][9d]
Whynot v checks
DUICEETDELOR bets 4934
Whynot v folds
DUICEETDELOR collected 11101 from pot
*** SUMMARY ***
Total pot 11101 | No rake
Board: [2c Tc Ad 4d 9d]
Seat 5: DUICEETDELOR won 11101


Winamax Poker - Tournament "X-MAS FEVER 5 € - DAY 1" buyIn: 4.50€ + 0.50€ level: 2 - HandId: #3150633295033663601-59-1703362313 - Holdem no limit (30/125/250) - 2023/12/23 20:11:53 UTC
Table: 'X-MAS FEVER 5 € - DAY 1(733563978)#0112' 6-max (real money) Seat #3 is the button
Seat 1: chuichoWS57 (24124)
Seat 2: P1xel7 (27302)
Seat 3: Wago7 (21817)
Seat 4: Whynot v (9362)
Seat 5: DUICEETDELOR (44043)
Seat 6: KAZAAR (16011)
*** ANTE/BLINDS ***
Whynot v posts ante 30
DUICEETDELOR posts ante 30
chuichoWS57 posts ante 30
P1xel7 posts ante 30
Wago7 posts ante 30
KAZAAR posts ante 30
Whynot v posts small blind 125
DUICEETDELOR posts big blind 250
Dealt to P1xel7 [6d 6c]
*** PRE-FLOP *** 
KAZAAR folds
chuichoWS57 folds
P1xel7 raises 500 to 750
Wago7 raises 1500 to 2250
Whynot v raises 7082 to 9332 and is all-in
DUICEETDELOR folds
P1xel7 folds
Wago7 calls 7082
*** FLOP *** [2d Jc 5s]
*** TURN *** [2d Jc 5s][8s]
*** RIVER *** [2d Jc 5s 8s][Ac]
*** SHOW DOWN ***
Wago7 shows [Kd As] (One pair : Aces)
Whynot v shows [Kh Ah] (One pair : Aces)
Whynot v collected 9922 from pot
Wago7 collected 9922 from pot
*** SUMMARY ***
Total pot 19844 | No rake
Board: [2d Jc 5s 8s Ac]
Seat 3: Wago7 (button) showed [Kd As] and won 9922 with One pair : Aces
Seat 4: Whynot v (small blind) showed [Kh Ah] and won 9922 with One pair : Aces


Winamax Poker - Tournament "X-MAS FEVER 5 € - DAY 1" buyIn: 4.50€ + 0.50€ level: 2 - HandId: #3150633295033663601-60-1703362350 - Holdem no limit (30/125/250) - 2023/12/23 20:12:30 UTC
Table: 'X-MAS FEVER 5 € - DAY 1(733563978)#0112' 6-max (real money) Seat #4 is the button
Seat 1: chuichoWS57 (24094)
Seat 2: P1xel7 (26522)
Seat 3: Wago7 (22377)
Seat 4: Whynot v (9922)
Seat 5: DUICEETDELOR (43763)
Seat 6: KAZAAR (15981)
*** ANTE/BLINDS ***
DUICEETDELOR posts ante 30
KAZAAR posts ante 30
chuichoWS57 posts ante 30
P1xel7 posts ante 30
Wago7 posts ante 30
Whynot v posts ante 30
DUICEETDELOR posts small blind 125
KAZAAR posts big blind 250
Dealt to P1xel7 [3h Qc]
*** PRE-FLOP *** 
chuichoWS57 raises 500 to 750
P1xel7 folds
Wago7 folds
Whynot v calls 750
DUICEETDELOR calls 625
KAZAAR folds
*** FLOP *** [5h 2s Jd]
DUICEETDELOR checks
chuichoWS57 checks
Whynot v checks
*** TURN *** [5h 2s Jd][4s]
DUICEETDELOR checks
chuichoWS57 checks
Whynot v bets 1742
DUICEETDELOR folds
chuichoWS57 calls 1742
*** RIVER *** [5h 2s Jd 4s][4h]
chuichoWS57 checks
Whynot v bets 4007
chuichoWS57 folds
Whynot v collected 10171 from pot
*** SUMMARY ***
Total pot 10171 | No rake
Board: [5h 2s Jd 4s 4h]
Seat 4: Whynot v (button) won 10171


Winamax Poker - Tournament "X-MAS FEVER 5 € - DAY 1" buyIn: 4.50€ + 0.50€ level: 2 - HandId: #3150633295033663601-61-1703362450 - Holdem no limit (30/125/250) - 2023/12/23 20:14:10 UTC
Table: 'X-MAS FEVER 5 € - DAY 1(733563978)#0112' 6-max (real money) Seat #5 is the button
Seat 1: chuichoWS57 (21572)
Seat 2: P1xel7 (26492)
Seat 3: Wago7 (22347)
Seat 4: Whynot v (13564)
Seat 5: DUICEETDELOR (42983)
Seat 6: KAZAAR (15701)
*** ANTE/BLINDS ***
KAZAAR posts ante 30
chuichoWS57 posts ante 30
P1xel7 posts ante 30
Wago7 posts ante 30
Whynot v posts ante 30
DUICEETDELOR posts ante 30
KAZAAR posts small blind 125
chuichoWS57 posts big blind 250
Dealt to P1xel7 [Ad 3d]
*** PRE-FLOP *** 
P1xel7 folds
Wago7 folds
Whynot v calls 250
DUICEETDELOR folds
KAZAAR raises 375 to 625
chuichoWS57 folds
Whynot v calls 375
*** FLOP *** [8d 3s Td]
KAZAAR bets 1159
Whynot v calls 1159
*** TURN *** [8d 3s Td][Qd]
KAZAAR checks
Whynot v checks
*** RIVER *** [8d 3s Td Qd][6d]
KAZAAR checks
Whynot v bets 1399
KAZAAR folds
Whynot v collected 5397 from pot
*** SUMMARY ***
Total pot 5397 | No rake
Board: [8d 3s Td Qd 6d]
Seat 4: Whynot v won 5397


Winamax Poker - Tournament "X-MAS FEVER 5 € - DAY 1" buyIn: 4.50€ + 0.50€ level: 2 - HandId: #3150633295033663601-62-1703362548 - Holdem no limit (30/125/250) - 2023/12/23 20:15:48 UTC
Table: 'X-MAS FEVER 5 € - DAY 1(733563978)#0112' 6-max (real money) Seat #6 is the button
Seat 1: chuichoWS57 (21292)
Seat 2: P1xel7 (26462)
Seat 3: Wago7 (22317)
Seat 4: Whynot v (15748)
Seat 5: DUICEETDELOR (42953)
Seat 6: KAZAAR (13887)
*** ANTE/BLINDS ***
chuichoWS57 posts ante 30
P1xel7 posts ante 30
Wago7 posts ante 30
Whynot v posts ante 30
DUICEETDELOR posts ante 30
KAZAAR posts ante 30
chuichoWS57 posts small blind 125
P1xel7 posts big blind 250
Dealt to P1xel7 [4h Jc]
*** PRE-FLOP *** 
Wago7 folds
Whynot v raises 805 to 1055
DUICEETDELOR folds
KAZAAR folds
chuichoWS57 folds
P1xel7 folds
Whynot v collected 1610 from pot
*** SUMMARY ***
Total pot 1610 | No rake
Seat 4: Whynot v won 1610


Winamax Poker - Tournament "X-MAS FEVER 5 € - DAY 1" buyIn: 4.50€ + 0.50€ level: 2 - HandId: #3150633295033663601-63-1703362567 - Holdem no limit (30/125/250) - 2023/12/23 20:16:07 UTC
Table: 'X-MAS FEVER 5 € - DAY 1(733563978)#0112' 6-max (real money) Seat #1 is the button
Seat 1: chuichoWS57 (21137)
Seat 2: P1xel7 (26182)
Seat 3: Wago7 (22287)
Seat 4: Whynot v (16273)
Seat 5: DUICEETDELOR (42923)
Seat 6: KAZAAR (13857)
*** ANTE/BLINDS ***
P1xel7 posts ante 30
Wago7 posts ante 30
chuichoWS57 posts ante 30
Whynot v posts ante 30
DUICEETDELOR posts ante 30
KAZAAR posts ante 30
P1xel7 posts small blind 125
Wago7 posts big blind 250
Dealt to P1xel7 [8c Td]
*** PRE-FLOP *** 
Whynot v folds
DUICEETDELOR folds
KAZAAR raises 375 to 625
chuichoWS57 folds
P1xel7 folds
Wago7 raises 1625 to 2250
KAZAAR folds
Wago7 collected 3180 from pot
*** SUMMARY ***
Total pot 3180 | No rake
Seat 3: Wago7 (big blind) won 3180


Winamax Poker - Tournament "X-MAS FEVER 5 € - DAY 1" buyIn: 4.50€ + 0.50€ level: 2 - HandId: #3150633295033663601-64-1703362618 - Holdem no limit (30/125/250) - 2023/12/23 20:16:58 UTC
Table: 'X-MAS FEVER 5 € - DAY 1(733563978)#0112' 6-max (real money) Seat #2 is the button
Seat 1: chuichoWS57 (21107)
Seat 2: P1xel7 (26027)
Seat 3: Wago7 (23187)
Seat 4: Whynot v (16243)
Seat 5: DUICEETDELOR (42893)
Seat 6: KAZAAR (13202)
*** ANTE/BLINDS ***
Wago7 posts ante 30
Whynot v posts ante 30
chuichoWS57 posts ante 30
P1xel7 posts ante 30
DUICEETDELOR posts ante 30
KAZAAR posts ante 30
Wago7 posts small blind 125
Whynot v posts big blind 250
Dealt to P1xel7 [3c 3s]
*** PRE-FLOP *** 
DUICEETDELOR folds
KAZAAR folds
chuichoWS57 folds
P1xel7 raises 375 to 625
Wago7 folds
Whynot v calls 375
*** FLOP *** [3h 4c 9s]
Whynot v checks
P1xel7 bets 389
Whynot v calls 389
*** TURN *** [3h 4c 9s][4d]
Whynot v checks
P1xel7 bets 817
Whynot v folds
P1xel7 collected 3150 from pot
*** SUMMARY ***
Total pot 3150 | No rake
Board: [3h 4c 9s 4d]
Seat 2: P1xel7 (button) won 3150


Winamax Poker - Tournament "X-MAS FEVER 5 € - DAY 1" buyIn: 4.50€ + 0.50€ level: 3 - HandId: #3150633295033663601-65-1703362661 - Holdem no limit (35/150/300) - 2023/12/23 20:17:41 UTC
Table: 'X-MAS FEVER 5 € - DAY 1(733563978)#0112' 6-max (real money) Seat #3 is the button
Seat 1: chuichoWS57 (21077)
Seat 2: P1xel7 (27316)
Seat 3: Wago7 (23032)
Seat 4: Whynot v (15199)
Seat 5: DUICEETDELOR (42863)
Seat 6: KAZAAR (13172)
*** ANTE/BLINDS ***
Whynot v posts ante 35
DUICEETDELOR posts ante 35
chuichoWS57 posts ante 35
P1xel7 posts ante 35
Wago7 posts ante 35
KAZAAR posts ante 35
Whynot v posts small blind 150
DUICEETDELOR posts big blind 300
Dealt to P1xel7 [Kh 7s]
*** PRE-FLOP *** 
KAZAAR raises 450 to 750
chuichoWS57 folds
P1xel7 folds
Wago7 folds
Whynot v folds
DUICEETDELOR folds
KAZAAR collected 1410 from pot
*** SUMMARY ***
Total pot 1410 | No rake
Seat 6: KAZAAR won 1410


Winamax Poker - Tournament "X-MAS FEVER 5 € - DAY 1" buyIn: 4.50€ + 0.50€ level: 3 - HandId: #3150633295033663601-66-1703362715 - Holdem no limit (35/150/300) - 2023/12/23 20:18:35 UTC
Table: 'X-MAS FEVER 5 € - DAY 1(733563978)#0112' 6-max (real money) Seat #4 is the button
Seat 1: chuichoWS57 (21042)
Seat 2: P1xel7 (27281)
Seat 3: Wago7 (22997)
Seat 4: Whynot v (15014)
Seat 5: DUICEETDELOR (42528)
Seat 6: KAZAAR (13797)
*** ANTE/BLINDS ***
DUICEETDELOR posts ante 35
KAZAAR posts ante 35
chuichoWS57 posts ante 35
P1xel7 posts ante 35
Wago7 posts ante 35
Whynot v posts ante 35
DUICEETDELOR posts small blind 150
KAZAAR posts big blind 300
Dealt to P1xel7 [2s 6s]
*** PRE-FLOP *** 
chuichoWS57 folds
P1xel7 folds
Wago7 raises 450 to 750
Whynot v calls 750
DUICEETDELOR folds
KAZAAR calls 450
*** FLOP *** [Qs 4h 3h]
KAZAAR checks
Wago7 checks
Whynot v bets 1697
KAZAAR folds
Wago7 folds
Whynot v collected 4307 from pot
*** SUMMARY ***
Total pot 4307 | No rake
Board: [Qs 4h 3h]
Seat 4: Whynot v (button) won 4307


Winamax Poker - Tournament "X-MAS FEVER 5 € - DAY 1" buyIn: 4.50€ + 0.50€ level: 3 - HandId: #3150633295033663601-67-1703362782 - Holdem no limit (35/150/300) - 2023/12/23 20:19:42 UTC
Table: 'X-MAS FEVER 5 € - DAY 1(733563978)#0112' 6-max (real money) Seat #5 is the button
Seat 1: chuichoWS57 (21007)
Seat 2: P1xel7 (27246)
Seat 3: Wago7 (22212)
Seat 4: Whynot v (16839)
Seat 5: DUICEETDELOR (42343)
Seat 6: KAZAAR (13012)
*** ANTE/BLINDS ***
KAZAAR posts ante 35
chuichoWS57 posts ante 35
P1xel7 posts ante 35
Wago7 posts ante 35
Whynot v posts ante 35
DUICEETDELOR posts ante 35
KAZAAR posts small blind 150
chuichoWS57 posts big blind 300
Dealt to P1xel7 [5d Tc]
*** PRE-FLOP *** 
P1xel7 folds
Wago7 folds
Whynot v folds
DUICEETDELOR raises 375 to 675
KAZAAR raises 12302 to 12977 and is all-in
chuichoWS57 folds
DUICEETDELOR folds
KAZAAR collected 14162 from pot
*** SUMMARY ***
Total pot 14162 | No rake
Seat 6: KAZAAR (small blind) won 14162


Winamax Poker - Tournament "X-MAS FEVER 5 € - DAY 1" buyIn: 4.50€ + 0.50€ level: 3 - HandId: #3150633295033663601-68-1703362826 - Holdem no limit (35/150/300) - 2023/12/23 20:20:26 UTC
Table: 'X-MAS FEVER 5 € - DAY 1(733563978)#0112' 6-max (real money) Seat #6 is the button
Seat 1: chuichoWS57 (20672)
Seat 2: P1xel7 (27211)
Seat 3: Wago7 (22177)
Seat 4: Whynot v (16804)
Seat 5: DUICEETDELOR (41633)
Seat 6: KAZAAR (14162)
*** ANTE/BLINDS ***
chuichoWS57 posts ante 35
P1xel7 posts ante 35
Wago7 posts ante 35
Whynot v posts ante 35
DUICEETDELOR posts ante 35
KAZAAR posts ante 35
chuichoWS57 posts small blind 150
P1xel7 posts big blind 300
Dealt to P1xel7 [Qd Qh]
*** PRE-FLOP *** 
Wago7 folds
Whynot v folds
DUICEETDELOR folds
KAZAAR folds
chuichoWS57 calls 150
P1xel7 raises 360 to 660
chuichoWS57 calls 360
*** FLOP *** [9c 7c 9d]
chuichoWS57 checks
P1xel7 bets 536
chuichoWS57 calls 536
*** TURN *** [9c 7c 9d][3h]
chuichoWS57 checks
P1xel7 bets 1301
chuichoWS57 calls 1301
*** RIVER *** [9c 7c 9d 3h][8s]
chuichoWS57 checks
P1xel7 checks
*** SHOW DOWN ***
chuichoWS57 shows [8c Th] (Two pairs : 9 and 8)
P1xel7 shows [Qd Qh] (Two pairs : Queens and 9)
P1xel7 collected 5204 from pot
*** SUMMARY ***
Total pot 5204 | No rake
Board: [9c 7c 9d 3h 8s]
Seat 1: chuichoWS57 (small blind) showed [8c Th] and lost with Two pairs : 9 and 8
Seat 2: P1xel7 (big blind) showed [Qd Qh] and won 5204 with Two pairs : Queens and 9


Winamax Poker - Tournament "X-MAS FEVER 5 € - DAY 1" buyIn: 4.50€ + 0.50€ level: 3 - HandId: #3150633295033663601-69-1703362874 - Holdem no limit (35/150/300) - 2023/12/23 20:21:14 UTC
Table: 'X-MAS FEVER 5 € - DAY 1(733563978)#0112' 6-max (real money) Seat #1 is the button
Seat 1: chuichoWS57 (18140)
Seat 2: P1xel7 (29883)
Seat 3: Wago7 (22142)
Seat 4: Whynot v (16769)
Seat 5: DUICEETDELOR (41598)
Seat 6: KAZAAR (14127)
*** ANTE/BLINDS ***
P1xel7 posts ante 35
Wago7 posts ante 35
chuichoWS57 posts ante 35
Whynot v posts ante 35
DUICEETDELOR posts ante 35
KAZAAR posts ante 35
P1xel7 posts small blind 150
Wago7 posts big blind 300
Dealt to P1xel7 [8c 8d]
*** PRE-FLOP *** 
Whynot v calls 300
DUICEETDELOR folds
KAZAAR raises 450 to 750
chuichoWS57 folds
P1xel7 calls 600
Wago7 folds
Whynot v raises 2760 to 3510
KAZAAR folds
P1xel7 raises 26338 to 29848 and is all-in
Whynot v calls 13224 and is all-in
*** FLOP *** [Ad 4s 3h]
*** TURN *** [Ad 4s 3h][7s]
*** RIVER *** [Ad 4s 3h 7s][Kh]
*** SHOW DOWN ***
P1xel7 shows [8c 8d] (One pair : 8)
Whynot v shows [Jh Jd] (One pair : Jacks)
Whynot v collected 34728 from main pot
P1xel7 collected 13114 from side pot 1
*** SUMMARY ***
Total pot 47842 | No rake
Board: [Ad 4s 3h 7s Kh]
Seat 2: P1xel7 (small blind) showed [8c 8d] and won 13114 with One pair : 8
Seat 4: Whynot v showed [Jh Jd] and won 34728 with One pair : Jacks


Winamax Poker - Tournament "X-MAS FEVER 5 € - DAY 1" buyIn: 4.50€ + 0.50€ level: 3 - HandId: #3150633295033663601-70-1703362943 - Holdem no limit (35/150/300) - 2023/12/23 20:22:23 UTC
Table: 'X-MAS FEVER 5 € - DAY 1(733563978)#0112' 6-max (real money) Seat #2 is the button
Seat 1: chuichoWS57 (18105)
Seat 2: P1xel7 (13114)
Seat 3: Wago7 (21807)
Seat 4: Whynot v (34728)
Seat 5: DUICEETDELOR (41563)
Seat 6: KAZAAR (13342)
*** ANTE/BLINDS ***
Wago7 posts ante 35
Whynot v posts ante 35
chuichoWS57 posts ante 35
P1xel7 posts ante 35
DUICEETDELOR posts ante 35
KAZAAR posts ante 35
Wago7 posts small blind 150
Whynot v posts big blind 300
Dealt to P1xel7 [9h 7h]
*** PRE-FLOP *** 
DUICEETDELOR folds
KAZAAR folds
chuichoWS57 raises 600 to 900
P1xel7 folds
Wago7 folds
Whynot v calls 600
*** FLOP *** [9c Th 4c]
Whynot v checks
chuichoWS57 checks
*** TURN *** [9c Th 4c][5h]
Whynot v bets 2160
chuichoWS57 folds
Whynot v collected 4320 from pot
*** SUMMARY ***
Total pot 4320 | No rake
Board: [9c Th 4c 5h]
Seat 4: Whynot v (big blind) won 4320


Winamax Poker - Tournament "X-MAS FEVER 5 € - DAY 1" buyIn: 4.50€ + 0.50€ level: 3 - HandId: #3150633295033663601-71-1703362977 - Holdem no limit (35/150/300) - 2023/12/23 20:22:57 UTC
Table: 'X-MAS FEVER 5 € - DAY 1(733563978)#0112' 6-max (real money) Seat #3 is the button
Seat 1: chuichoWS57 (17170)
Seat 2: P1xel7 (13079)
Seat 3: Wago7 (21622)
Seat 4: Whynot v (35953)
Seat 5: DUICEETDELOR (41528)
Seat 6: KAZAAR (13307)
*** ANTE/BLINDS ***
Whynot v posts ante 35
DUICEETDELOR posts ante 35
chuichoWS57 posts ante 35
P1xel7 posts ante 35
Wago7 posts ante 35
KAZAAR posts ante 35
Whynot v posts small blind 150
DUICEETDELOR posts big blind 300
Dealt to P1xel7 [2h 9c]
*** PRE-FLOP *** 
KAZAAR folds
chuichoWS57 folds
P1xel7 folds
Wago7 folds
Whynot v calls 150
DUICEETDELOR checks
*** FLOP *** [8s 6s Js]
Whynot v checks
DUICEETDELOR bets 750
Whynot v calls 750
*** TURN *** [8s 6s Js][Ah]
Whynot v checks
DUICEETDELOR bets 1502
Whynot v calls 1502
*** RIVER *** [8s 6s Js Ah][Qs]
Whynot v checks
DUICEETDELOR checks
*** SHOW DOWN ***
DUICEETDELOR shows [2s Kc] (Flush Queen high)
Whynot v shows [Ts 5c] (Flush Queen high)
Whynot v collected 5314 from pot
*** SUMMARY ***
Total pot 5314 | No rake
Board: [8s 6s Js Ah Qs]
Seat 4: Whynot v (small blind) showed [Ts 5c] and won 5314 with Flush Queen high
Seat 5: DUICEETDELOR (big blind) showed [2s Kc] and lost with Flush Queen high


Winamax Poker - Tournament "X-MAS FEVER 5 € - DAY 1" buyIn: 4.50€ + 0.50€ level: 3 - HandId: #3150633295033663601-72-1703363007 - Holdem no limit (35/150/300) - 2023/12/23 20:23:27 UTC
Table: 'X-MAS FEVER 5 € - DAY 1(733563978)#0112' 6-max (real money) Seat #4 is the button
Seat 1: chuichoWS57 (17135)
Seat 2: P1xel7 (13044)
Seat 3: Wago7 (21587)
Seat 4: Whynot v (38680)
Seat 5: DUICEETDELOR (38941)
Seat 6: KAZAAR (13272)
*** ANTE/BLINDS ***
DUICEETDELOR posts ante 35
KAZAAR posts ante 35
chuichoWS57 posts ante 35
P1xel7 posts ante 35
Wago7 posts ante 35
Whynot v posts ante 35
DUICEETDELOR posts small blind 150
KAZAAR posts big blind 300
Dealt to P1xel7 [6s 9s]
*** PRE-FLOP *** 
chuichoWS57 folds
P1xel7 folds
Wago7 folds
Whynot v folds
DUICEETDELOR calls 150
KAZAAR checks
*** FLOP *** [4c As 2s]
DUICEETDELOR checks
KAZAAR checks
*** TURN *** [4c As 2s][7c]
DUICEETDELOR bets 648
KAZAAR folds
DUICEETDELOR collected 1458 from pot
*** SUMMARY ***
Total pot 1458 | No rake
Board: [4c As 2s 7c]
Seat 5: DUICEETDELOR (small blind) won 1458


Winamax Poker - Tournament "X-MAS FEVER 5 € - DAY 1" buyIn: 4.50€ + 0.50€ level: 3 - HandId: #3150633295033663601-73-1703363040 - Holdem no limit (35/150/300) - 2023/12/23 20:24:00 UTC
Table: 'X-MAS FEVER 5 € - DAY 1(733563978)#0112' 6-max (real money) Seat #5 is the button
Seat 1: chuichoWS57 (17100)
Seat 2: P1xel7 (13009)
Seat 3: Wago7 (21552)
Seat 4: Whynot v (38645)
Seat 5: DUICEETDELOR (39416)
Seat 6: KAZAAR (12937)
*** ANTE/BLINDS ***
KAZAAR posts ante 35
chuichoWS57 posts ante 35
P1xel7 posts ante 35
Wago7 posts ante 35
Whynot v posts ante 35
DUICEETDELOR posts ante 35
KAZAAR posts small blind 150
chuichoWS57 posts big blind 300
Dealt to P1xel7 [As Th]
*** PRE-FLOP *** 
P1xel7 raises 360 to 660
Wago7 folds
Whynot v folds
DUICEETDELOR folds
KAZAAR folds
chuichoWS57 folds
P1xel7 collected 1320 from pot
*** SUMMARY ***
Total pot 1320 | No rake
Seat 2: P1xel7 won 1320


Winamax Poker - Tournament "X-MAS FEVER 5 € - DAY 1" buyIn: 4.50€ + 0.50€ level: 3 - HandId: #3150633295033663601-74-1703363080 - Holdem no limit (35/150/300) - 2023/12/23 20:24:40 UTC
Table: 'X-MAS FEVER 5 € - DAY 1(733563978)#0112' 6-max (real money) Seat #6 is the button
Seat 1: chuichoWS57 (16765)
Seat 2: P1xel7 (13634)
Seat 3: Wago7 (21517)
Seat 4: Whynot v (38610)
Seat 5: DUICEETDELOR (39381)
Seat 6: KAZAAR (12752)
*** ANTE/BLINDS ***
chuichoWS57 posts ante 35
P1xel7 posts ante 35
Wago7 posts ante 35
Whynot v posts ante 35
DUICEETDELOR posts ante 35
KAZAAR posts ante 35
chuichoWS57 posts small blind 150
P1xel7 posts big blind 300
Dealt to P1xel7 [Qs Kh]
*** PRE-FLOP *** 
Wago7 folds
Whynot v calls 300
DUICEETDELOR folds
KAZAAR folds
chuichoWS57 folds
P1xel7 checks
*** FLOP *** [8d Js Qc]
P1xel7 checks
Whynot v checks
*** TURN *** [8d Js Qc][Tc]
P1xel7 bets 336
Whynot v calls 336
*** RIVER *** [8d Js Qc Tc][Ks]
P1xel7 bets 571
Whynot v calls 571
*** SHOW DOWN ***
Whynot v shows [Ts Jd] (Two pairs : Jacks and Tens)
P1xel7 shows [Qs Kh] (Two pairs : Kings and Queens)
P1xel7 collected 2774 from pot
*** SUMMARY ***
Total pot 2774 | No rake
Board: [8d Js Qc Tc Ks]
Seat 2: P1xel7 (big blind) showed [Qs Kh] and won 2774 with Two pairs : Kings and Queens
Seat 4: Whynot v showed [Ts Jd] and lost with Two pairs : Jacks and Tens


Winamax Poker - Tournament "X-MAS FEVER 5 € - DAY 1" buyIn: 4.50€ + 0.50€ level: 3 - HandId: #3150633295033663601-75-1703363116 - Holdem no limit (35/150/300) - 2023/12/23 20:25:16 UTC
Table: 'X-MAS FEVER 5 € - DAY 1(733563978)#0112' 6-max (real money) Seat #1 is the button
Seat 1: chuichoWS57 (16580)
Seat 2: P1xel7 (15166)
Seat 3: Wago7 (21482)
Seat 4: Whynot v (37368)
Seat 5: DUICEETDELOR (39346)
Seat 6: KAZAAR (12717)
*** ANTE/BLINDS ***
P1xel7 posts ante 35
Wago7 posts ante 35
chuichoWS57 posts ante 35
Whynot v posts ante 35
DUICEETDELOR posts ante 35
KAZAAR posts ante 35
P1xel7 posts small blind 150
Wago7 posts big blind 300
Dealt to P1xel7 [Jd 8d]
*** PRE-FLOP *** 
Whynot v raises 960 to 1260
DUICEETDELOR folds
KAZAAR folds
chuichoWS57 folds
P1xel7 folds
Wago7 folds
Whynot v collected 1920 from pot
*** SUMMARY ***
Total pot 1920 | No rake
Seat 4: Whynot v won 1920


Winamax Poker - Tournament "X-MAS FEVER 5 € - DAY 1" buyIn: 4.50€ + 0.50€ level: 3 - HandId: #3150633295033663601-76-1703363131 - Holdem no limit (35/150/300) - 2023/12/23 20:25:31 UTC
Table: 'X-MAS FEVER 5 € - DAY 1(733563978)#0112' 6-max (real money) Seat #2 is the button
Seat 1: chuichoWS57 (16545)
Seat 2: P1xel7 (14981)
Seat 3: Wago7 (21147)
Seat 4: Whynot v (37993)
Seat 5: DUICEETDELOR (39311)
Seat 6: KAZAAR (12682)
*** ANTE/BLINDS ***
Wago7 posts ante 35
Whynot v posts ante 35
chuichoWS57 posts ante 35
P1xel7 posts ante 35
DUICEETDELOR posts ante 35
KAZAAR posts ante 35
Wago7 posts small blind 150
Whynot v posts big blind 300
Dealt to P1xel7 [Td 8s]
*** PRE-FLOP *** 
DUICEETDELOR folds
KAZAAR folds
chuichoWS57 folds
P1xel7 folds
Wago7 folds
Whynot v collected 660 from pot
*** SUMMARY ***
Total pot 660 | No rake
Seat 4: Whynot v (big blind) won 660


Winamax Poker - Tournament "X-MAS FEVER 5 € - DAY 1" buyIn: 4.50€ + 0.50€ level: 3 - HandId: #3150633295033663601-77-1703363141 - Holdem no limit (35/150/300) - 2023/12/23 20:25:41 UTC
Table: 'X-MAS FEVER 5 € - DAY 1(733563978)#0112' 6-max (real money) Seat #3 is the button
Seat 1: chuichoWS57 (16510)
Seat 2: P1xel7 (14946)
Seat 3: Wago7 (20962)
Seat 4: Whynot v (38318)
Seat 5: DUICEETDELOR (39276)
Seat 6: KAZAAR (12647)
*** ANTE/BLINDS ***
Whynot v posts ante 35
DUICEETDELOR posts ante 35
chuichoWS57 posts ante 35
P1xel7 posts ante 35
Wago7 posts ante 35
KAZAAR posts ante 35
Whynot v posts small blind 150
DUICEETDELOR posts big blind 300
Dealt to P1xel7 [3c Tc]
*** PRE-FLOP *** 
KAZAAR raises 300 to 600
chuichoWS57 folds
P1xel7 folds
Wago7 folds
Whynot v calls 450
DUICEETDELOR folds
*** FLOP *** [3s Jc Td]
Whynot v checks
KAZAAR bets 1180
Whynot v calls 1180
*** TURN *** [3s Jc Td][Ad]
Whynot v checks
KAZAAR bets 2335
Whynot v folds
KAZAAR collected 6405 from pot
*** SUMMARY ***
Total pot 6405 | No rake
Board: [3s Jc Td Ad]
Seat 6: KAZAAR won 6405


Winamax Poker - Tournament "X-MAS FEVER 5 € - DAY 1" buyIn: 4.50€ + 0.50€ level: 3 - HandId: #3150633295033663601-78-1703363171 - Holdem no limit (35/150/300) - 2023/12/23 20:26:11 UTC
Table: 'X-MAS FEVER 5 € - DAY 1(733563978)#0112' 6-max (real money) Seat #4 is the button
Seat 1: chuichoWS57 (16475)
Seat 2: P1xel7 (14911)
Seat 3: Wago7 (20927)
Seat 4: Whynot v (36503)
Seat 5: DUICEETDELOR (38941)
Seat 6: KAZAAR (14902)
*** ANTE/BLINDS ***
DUICEETDELOR posts ante 35
KAZAAR posts ante 35
chuichoWS57 posts ante 35
P1xel7 posts ante 35
Wago7 posts ante 35
Whynot v posts ante 35
DUICEETDELOR posts small blind 150
KAZAAR posts big blind 300
Dealt to P1xel7 [Qd 7h]
*** PRE-FLOP *** 
chuichoWS57 folds
P1xel7 folds
Wago7 folds
Whynot v folds
DUICEETDELOR calls 150
KAZAAR checks
*** FLOP *** [Jc 5h 9d]
DUICEETDELOR bets 450
KAZAAR folds
DUICEETDELOR collected 1260 from pot
*** SUMMARY ***
Total pot 1260 | No rake
Board: [Jc 5h 9d]
Seat 5: DUICEETDELOR (small blind) won 1260


Winamax Poker - Tournament "X-MAS FEVER 5 € - DAY 1" buyIn: 4.50€ + 0.50€ level: 3 - HandId: #3150633295033663601-79-1703363199 - Holdem no limit (35/150/300) - 2023/12/23 20:26:39 UTC
Table: 'X-MAS FEVER 5 € - DAY 1(733563978)#0112' 6-max (real money) Seat #5 is the button
Seat 1: chuichoWS57 (16440)
Seat 2: P1xel7 (14876)
Seat 3: Wago7 (20892)
Seat 4: Whynot v (36468)
Seat 5: DUICEETDELOR (39416)
Seat 6: KAZAAR (14567)
*** ANTE/BLINDS ***
KAZAAR posts ante 35
chuichoWS57 posts ante 35
P1xel7 posts ante 35
Wago7 posts ante 35
Whynot v posts ante 35
DUICEETDELOR posts ante 35
KAZAAR posts small blind 150
chuichoWS57 posts big blind 300
Dealt to P1xel7 [2c 6h]
*** PRE-FLOP *** 
P1xel7 folds
Wago7 folds
Whynot v folds
DUICEETDELOR folds
KAZAAR folds
chuichoWS57 collected 660 from pot
*** SUMMARY ***
Total pot 660 | No rake
Seat 1: chuichoWS57 (big blind) won 660


Winamax Poker - Tournament "X-MAS FEVER 5 € - DAY 1" buyIn: 4.50€ + 0.50€ level: 3 - HandId: #3150633295033663601-80-1703363212 - Holdem no limit (35/150/300) - 2023/12/23 20:26:52 UTC
Table: 'X-MAS FEVER 5 € - DAY 1(733563978)#0112' 6-max (real money) Seat #6 is the button
Seat 1: chuichoWS57 (16765)
Seat 2: P1xel7 (14841)
Seat 3: Wago7 (20857)
Seat 4: Whynot v (36433)
Seat 5: DUICEETDELOR (39381)
Seat 6: KAZAAR (14382)
*** ANTE/BLINDS ***
chuichoWS57 posts ante 35
P1xel7 posts ante 35
Wago7 posts ante 35
Whynot v posts ante 35
DUICEETDELOR posts ante 35
KAZAAR posts ante 35
chuichoWS57 posts small blind 150
P1xel7 posts big blind 300
Dealt to P1xel7 [5h Qs]
*** PRE-FLOP *** 
Wago7 raises 450 to 750
Whynot v folds
DUICEETDELOR folds
KAZAAR folds
chuichoWS57 folds
P1xel7 folds
Wago7 collected 1410 from pot
*** SUMMARY ***
Total pot 1410 | No rake
Seat 3: Wago7 won 1410


Winamax Poker - Tournament "X-MAS FEVER 5 € - DAY 1" buyIn: 4.50€ + 0.50€ level: 3 - HandId: #3150633295033663601-81-1703363248 - Holdem no limit (35/150/300) - 2023/12/23 20:27:28 UTC
Table: 'X-MAS FEVER 5 € - DAY 1(733563978)#0112' 6-max (real money) Seat #1 is the button
Seat 1: chuichoWS57 (16580)
Seat 2: P1xel7 (14506)
Seat 3: Wago7 (21482)
Seat 4: Whynot v (36398)
Seat 5: DUICEETDELOR (39346)
Seat 6: KAZAAR (14347)
*** ANTE/BLINDS ***
P1xel7 posts ante 35
Wago7 posts ante 35
chuichoWS57 posts ante 35
Whynot v posts ante 35
DUICEETDELOR posts ante 35
KAZAAR posts ante 35
P1xel7 posts small blind 150
Wago7 posts big blind 300
Dealt to P1xel7 [3s 6h]
*** PRE-FLOP *** 
Whynot v calls 300
DUICEETDELOR folds
KAZAAR raises 450 to 750
chuichoWS57 folds
P1xel7 folds
Wago7 calls 450
Whynot v calls 450
*** FLOP *** [6d 2c Kc]
Wago7 checks
Whynot v checks
KAZAAR bets 1305
Wago7 calls 1305
Whynot v calls 1305
*** TURN *** [6d 2c Kc][8h]
Wago7 checks
Whynot v checks
KAZAAR checks
*** RIVER *** [6d 2c Kc 8h][Kd]
Wago7 checks
Whynot v checks
KAZAAR checks
*** SHOW DOWN ***
Whynot v shows [4s 3h] (One pair : Kings)
KAZAAR shows [Tc Ac] (One pair : Kings)
Wago7 shows [7d 7c] (Two pairs : Kings and 7)
Wago7 collected 6525 from pot
*** SUMMARY ***
Total pot 6525 | No rake
Board: [6d 2c Kc 8h Kd]
Seat 3: Wago7 (big blind) showed [7d 7c] and won 6525 with Two pairs : Kings and 7
Seat 4: Whynot v showed [4s 3h] and lost with One pair : Kings
Seat 6: KAZAAR showed [Tc Ac] and lost with One pair : Kings


Winamax Poker - Tournament "X-MAS FEVER 5 € - DAY 1" buyIn: 4.50€ + 0.50€ level: 4 - HandId: #3150633295033663601-82-1703363349 - Holdem no limit (40/175/350) - 2023/12/23 20:29:09 UTC
Table: 'X-MAS FEVER 5 € - DAY 1(733563978)#0112' 6-max (real money) Seat #2 is the button
Seat 1: chuichoWS57 (16545)
Seat 2: P1xel7 (14321)
Seat 3: Wago7 (25917)
Seat 4: Whynot v (34308)
Seat 5: DUICEETDELOR (39311)
Seat 6: KAZAAR (12257)
*** ANTE/BLINDS ***
Wago7 posts ante 40
Whynot v posts ante 40
chuichoWS57 posts ante 40
P1xel7 posts ante 40
DUICEETDELOR posts ante 40
KAZAAR posts ante 40
Wago7 posts small blind 175
Whynot v posts big blind 350
Dealt to P1xel7 [3h Th]
*** PRE-FLOP *** 
DUICEETDELOR folds
KAZAAR folds
chuichoWS57 folds
P1xel7 folds
Wago7 folds
Whynot v collected 765 from pot
*** SUMMARY ***
Total pot 765 | No rake
Seat 4: Whynot v (big blind) won 765


Winamax Poker - Tournament "X-MAS FEVER 5 € - DAY 1" buyIn: 4.50€ + 0.50€ level: 4 - HandId: #3150633295033663601-83-1703363364 - Holdem no limit (40/175/350) - 2023/12/23 20:29:24 UTC
Table: 'X-MAS FEVER 5 € - DAY 1(733563978)#0112' 6-max (real money) Seat #3 is the button
Seat 1: chuichoWS57 (16505)
Seat 2: P1xel7 (14281)
Seat 3: Wago7 (25702)
Seat 4: Whynot v (34683)
Seat 5: DUICEETDELOR (39271)
Seat 6: KAZAAR (12217)
*** ANTE/BLINDS ***
Whynot v posts ante 40
DUICEETDELOR posts ante 40
chuichoWS57 posts ante 40
P1xel7 posts ante 40
Wago7 posts ante 40
KAZAAR posts ante 40
Whynot v posts small blind 175
DUICEETDELOR posts big blind 350
Dealt to P1xel7 [3d Ad]
*** PRE-FLOP *** 
KAZAAR folds
chuichoWS57 folds
P1xel7 raises 525 to 875
Wago7 folds
Whynot v folds
DUICEETDELOR calls 525
*** FLOP *** [6d 8d Tc]
DUICEETDELOR checks
P1xel7 bets 758
DUICEETDELOR calls 758
*** TURN *** [6d 8d Tc][7c]
DUICEETDELOR checks
P1xel7 checks
*** RIVER *** [6d 8d Tc 7c][As]
DUICEETDELOR bets 2393
P1xel7 calls 2393
*** SHOW DOWN ***
P1xel7 shows [3d Ad] (One pair : Aces)
DUICEETDELOR shows [Qc 9d] (Straight Ten high)
DUICEETDELOR collected 8467 from pot
*** SUMMARY ***
Total pot 8467 | No rake
Board: [6d 8d Tc 7c As]
Seat 2: P1xel7 showed [3d Ad] and lost with One pair : Aces
Seat 5: DUICEETDELOR (big blind) showed [Qc 9d] and won 8467 with Straight Ten high


Winamax Poker - Tournament "X-MAS FEVER 5 € - DAY 1" buyIn: 4.50€ + 0.50€ level: 4 - HandId: #3150633295033663601-84-1703363473 - Holdem no limit (40/175/350) - 2023/12/23 20:31:13 UTC
Table: 'X-MAS FEVER 5 € - DAY 1(733563978)#0112' 6-max (real money) Seat #4 is the button
Seat 1: chuichoWS57 (16465)
Seat 2: P1xel7 (10215)
Seat 3: Wago7 (25662)
Seat 4: Whynot v (34468)
Seat 5: DUICEETDELOR (43672)
Seat 6: KAZAAR (12177)
*** ANTE/BLINDS ***
DUICEETDELOR posts ante 40
KAZAAR posts ante 40
chuichoWS57 posts ante 40
P1xel7 posts ante 40
Wago7 posts ante 40
Whynot v posts ante 40
DUICEETDELOR posts small blind 175
KAZAAR posts big blind 350
Dealt to P1xel7 [Th Ad]
*** PRE-FLOP *** 
chuichoWS57 folds
P1xel7 raises 525 to 875
Wago7 folds
Whynot v folds
DUICEETDELOR raises 42757 to 43632 and is all-in
KAZAAR folds
P1xel7 folds
DUICEETDELOR collected 45097 from pot
*** SUMMARY ***
Total pot 45097 | No rake
Seat 5: DUICEETDELOR (small blind) won 45097


Winamax Poker - Tournament "X-MAS FEVER 5 € - DAY 1" buyIn: 4.50€ + 0.50€ level: 4 - HandId: #3150633295033663601-85-1703363508 - Holdem no limit (40/175/350) - 2023/12/23 20:31:48 UTC
Table: 'X-MAS FEVER 5 € - DAY 1(733563978)#0112' 6-max (real money) Seat #5 is the button
Seat 1: chuichoWS57 (16425)
Seat 2: P1xel7 (9300)
Seat 3: Wago7 (25622)
Seat 4: Whynot v (34428)
Seat 5: DUICEETDELOR (45097)
Seat 6: KAZAAR (11787)
*** ANTE/BLINDS ***
KAZAAR posts ante 40
chuichoWS57 posts ante 40
P1xel7 posts ante 40
Wago7 posts ante 40
Whynot v posts ante 40
DUICEETDELOR posts ante 40
KAZAAR posts small blind 175
chuichoWS57 posts big blind 350
Dealt to P1xel7 [8s 6d]
*** PRE-FLOP *** 
P1xel7 folds
Wago7 folds
Whynot v folds
DUICEETDELOR raises 438 to 788
KAZAAR calls 613
chuichoWS57 calls 438
*** FLOP *** [8h Qh 8d]
KAZAAR checks
chuichoWS57 checks
DUICEETDELOR bets 911
KAZAAR calls 911
chuichoWS57 folds
*** TURN *** [8h Qh 8d][3d]
KAZAAR checks
DUICEETDELOR checks
*** RIVER *** [8h Qh 8d 3d][6c]
KAZAAR bets 1682
DUICEETDELOR folds
KAZAAR collected 6108 from pot
*** SUMMARY ***
Total pot 6108 | No rake
Board: [8h Qh 8d 3d 6c]
Seat 6: KAZAAR (small blind) won 6108


Winamax Poker - Tournament "X-MAS FEVER 5 € - DAY 1" buyIn: 4.50€ + 0.50€ level: 4 - HandId: #3150633295033663601-86-1703363610 - Holdem no limit (40/175/350) - 2023/12/23 20:33:30 UTC
Table: 'X-MAS FEVER 5 € - DAY 1(733563978)#0112' 6-max (real money) Seat #6 is the button
Seat 1: chuichoWS57 (15597)
Seat 2: P1xel7 (9260)
Seat 3: Wago7 (25582)
Seat 4: Whynot v (34388)
Seat 5: DUICEETDELOR (43358)
Seat 6: KAZAAR (14474)
*** ANTE/BLINDS ***
chuichoWS57 posts ante 40
P1xel7 posts ante 40
Wago7 posts ante 40
Whynot v posts ante 40
DUICEETDELOR posts ante 40
KAZAAR posts ante 40
chuichoWS57 posts small blind 175
P1xel7 posts big blind 350
Dealt to P1xel7 [8c 3c]
*** PRE-FLOP *** 
Wago7 folds
Whynot v raises 525 to 875
DUICEETDELOR folds
KAZAAR folds
chuichoWS57 raises 2340 to 3215
P1xel7 folds
Whynot v calls 2340
*** FLOP *** [6c Jd 7c]
chuichoWS57 bets 4563
Whynot v folds
chuichoWS57 collected 11583 from pot
*** SUMMARY ***
Total pot 11583 | No rake
Board: [6c Jd 7c]
Seat 1: chuichoWS57 (small blind) won 11583


Winamax Poker - Tournament "X-MAS FEVER 5 € - DAY 1" buyIn: 4.50€ + 0.50€ level: 4 - HandId: #3150633295033663601-87-1703363667 - Holdem no limit (40/175/350) - 2023/12/23 20:34:27 UTC
Table: 'X-MAS FEVER 5 € - DAY 1(733563978)#0112' 6-max (real money) Seat #1 is the button
Seat 1: chuichoWS57 (19362)
Seat 2: P1xel7 (8870)
Seat 3: Wago7 (25542)
Seat 4: Whynot v (31133)
Seat 5: DUICEETDELOR (43318)
Seat 6: KAZAAR (14434)
*** ANTE/BLINDS ***
P1xel7 posts ante 40
Wago7 posts ante 40
chuichoWS57 posts ante 40
Whynot v posts ante 40
DUICEETDELOR posts ante 40
KAZAAR posts ante 40
P1xel7 posts small blind 175
Wago7 posts big blind 350
Dealt to P1xel7 [4s Qs]
*** PRE-FLOP *** 
Whynot v folds
DUICEETDELOR folds
KAZAAR folds
chuichoWS57 folds
P1xel7 folds
Wago7 collected 765 from pot
*** SUMMARY ***
Total pot 765 | No rake
Seat 3: Wago7 (big blind) won 765


Winamax Poker - Tournament "X-MAS FEVER 5 € - DAY 1" buyIn: 4.50€ + 0.50€ level: 4 - HandId: #3150633295033663601-88-1703363696 - Holdem no limit (40/175/350) - 2023/12/23 20:34:56 UTC
Table: 'X-MAS FEVER 5 € - DAY 1(733563978)#0112' 6-max (real money) Seat #2 is the button
Seat 1: chuichoWS57 (19322)
Seat 2: P1xel7 (8655)
Seat 3: Wago7 (25917)
Seat 4: Whynot v (31093)
Seat 5: DUICEETDELOR (43278)
Seat 6: KAZAAR (14394)
*** ANTE/BLINDS ***
Wago7 posts ante 40
Whynot v posts ante 40
chuichoWS57 posts ante 40
P1xel7 posts ante 40
DUICEETDELOR posts ante 40
KAZAAR posts ante 40
Wago7 posts small blind 175
Whynot v posts big blind 350
Dealt to P1xel7 [8h Qd]
*** PRE-FLOP *** 
DUICEETDELOR folds
KAZAAR folds
chuichoWS57 raises 700 to 1050
P1xel7 folds
Wago7 folds
Whynot v calls 700
*** FLOP *** [6h 4c 2s]
Whynot v checks
chuichoWS57 bets 1635
Whynot v calls 1635
*** TURN *** [6h 4c 2s][Jh]
Whynot v checks
chuichoWS57 bets 3760
Whynot v raises 13305 to 17065
chuichoWS57 calls 12837 and is all-in
*** RIVER *** [6h 4c 2s Jh][4d]
*** SHOW DOWN ***
chuichoWS57 shows [Ts Th] (Two pairs : Tens and 4)
Whynot v shows [Ad Jd] (Two pairs : Jacks and 4)
Whynot v collected 39447 from pot
*** SUMMARY ***
Total pot 39447 | No rake
Board: [6h 4c 2s Jh 4d]
Seat 1: chuichoWS57 showed [Ts Th] and lost with Two pairs : Tens and 4
Seat 4: Whynot v (big blind) showed [Ad Jd] and won 39447 with Two pairs : Jacks and 4


Winamax Poker - Tournament "X-MAS FEVER 5 € - DAY 1" buyIn: 4.50€ + 0.50€ level: 4 - HandId: #3150633295033663601-89-1703363743 - Holdem no limit (40/175/350) - 2023/12/23 20:35:43 UTC
Table: 'X-MAS FEVER 5 € - DAY 1(733563978)#0112' 6-max (real money) Seat #3 is the button
Seat 2: P1xel7 (8615)
Seat 3: Wago7 (25702)
Seat 4: Whynot v (50750)
Seat 5: DUICEETDELOR (43238)
Seat 6: KAZAAR (14354)
*** ANTE/BLINDS ***
Whynot v posts ante 40
DUICEETDELOR posts ante 40
P1xel7 posts ante 40
Wago7 posts ante 40
KAZAAR posts ante 40
Whynot v posts small blind 175
DUICEETDELOR posts big blind 350
Dealt to P1xel7 [8d 8h]
*** PRE-FLOP *** 
KAZAAR folds
P1xel7 raises 420 to 770
Wago7 calls 770
Whynot v calls 595
DUICEETDELOR calls 420
*** FLOP *** [9s Tc Js]
Whynot v checks
DUICEETDELOR checks
P1xel7 checks
Wago7 checks
*** TURN *** [9s Tc Js][Kc]
Whynot v checks
DUICEETDELOR bets 2132
P1xel7 folds
Wago7 folds
Whynot v folds
DUICEETDELOR collected 5412 from pot
*** SUMMARY ***
Total pot 5412 | No rake
Board: [9s Tc Js Kc]
Seat 5: DUICEETDELOR (big blind) won 5412


Winamax Poker - Tournament "X-MAS FEVER 5 € - DAY 1" buyIn: 4.50€ + 0.50€ level: 4 - HandId: #3150633295033663601-90-1703363787 - Holdem no limit (40/175/350) - 2023/12/23 20:36:27 UTC
Table: 'X-MAS FEVER 5 € - DAY 1(733563978)#0112' 6-max (real money) Seat #4 is the button
Seat 2: P1xel7 (7805)
Seat 3: Wago7 (24892)
Seat 4: Whynot v (49940)
Seat 5: DUICEETDELOR (45708)
Seat 6: KAZAAR (14314)
*** ANTE/BLINDS ***
DUICEETDELOR posts ante 40
KAZAAR posts ante 40
P1xel7 posts ante 40
Wago7 posts ante 40
Whynot v posts ante 40
DUICEETDELOR posts small blind 175
KAZAAR posts big blind 350
Dealt to P1xel7 [3s 4h]
*** PRE-FLOP *** 
P1xel7 folds
Wago7 folds
Whynot v raises 1075 to 1425
DUICEETDELOR folds
KAZAAR calls 1075
*** FLOP *** [Ks 7d Qc]
KAZAAR checks
Whynot v bets 3225
KAZAAR raises 9624 to 12849 and is all-in
Whynot v folds
KAZAAR collected 19299 from pot
*** SUMMARY ***
Total pot 19299 | No rake
Board: [Ks 7d Qc]
Seat 6: KAZAAR (big blind) won 19299


Winamax Poker - Tournament "X-MAS FEVER 5 € - DAY 1" buyIn: 4.50€ + 0.50€ level: 4 - HandId: #3150633295033663601-91-1703363839 - Holdem no limit (40/175/350) - 2023/12/23 20:37:19 UTC
Table: 'X-MAS FEVER 5 € - DAY 1(733563978)#0112' 6-max (real money) Seat #5 is the button
Seat 1: POKPOKPK9 (20000)
Seat 2: P1xel7 (7765)
Seat 3: Wago7 (24852)
Seat 4: Whynot v (45250)
Seat 5: DUICEETDELOR (45493)
Seat 6: KAZAAR (19299)
*** ANTE/BLINDS ***
KAZAAR posts ante 40
POKPOKPK9 posts ante 40
P1xel7 posts ante 40
Wago7 posts ante 40
Whynot v posts ante 40
DUICEETDELOR posts ante 40
KAZAAR posts small blind 175
POKPOKPK9 posts big blind 350
Dealt to P1xel7 [Ts 5c]
*** PRE-FLOP *** 
P1xel7 folds
Wago7 folds
Whynot v folds
DUICEETDELOR folds
KAZAAR raises 350 to 700
POKPOKPK9 raises 1225 to 1925
KAZAAR calls 1225
*** FLOP *** [6d 8d 4d]
KAZAAR checks
POKPOKPK9 bets 2659
KAZAAR raises 14675 to 17334 and is all-in
POKPOKPK9 folds
KAZAAR collected 24083 from pot
*** SUMMARY ***
Total pot 24083 | No rake
Board: [6d 8d 4d]
Seat 6: KAZAAR (small blind) won 24083


Winamax Poker - Tournament "X-MAS FEVER 5 € - DAY 1" buyIn: 4.50€ + 0.50€ level: 4 - HandId: #3150633295033663601-92-1703363897 - Holdem no limit (40/175/350) - 2023/12/23 20:38:17 UTC
Table: 'X-MAS FEVER 5 € - DAY 1(733563978)#0112' 6-max (real money) Seat #6 is the button
Seat 1: POKPOKPK9 (15376)
Seat 2: P1xel7 (7725)
Seat 3: Wago7 (24812)
Seat 4: Whynot v (45210)
Seat 5: DUICEETDELOR (45453)
Seat 6: KAZAAR (24083)
*** ANTE/BLINDS ***
POKPOKPK9 posts ante 40
P1xel7 posts ante 40
Wago7 posts ante 40
Whynot v posts ante 40
DUICEETDELOR posts ante 40
KAZAAR posts ante 40
POKPOKPK9 posts small blind 175
P1xel7 posts big blind 350
Dealt to P1xel7 [As Qs]
*** PRE-FLOP *** 
Wago7 folds
Whynot v calls 350
DUICEETDELOR folds
KAZAAR folds
POKPOKPK9 calls 175
P1xel7 raises 7335 to 7685 and is all-in
Whynot v calls 7335
POKPOKPK9 raises 7651 to 15336 and is all-in
Whynot v calls 7651
*** FLOP *** [6h 7c Jc]
*** TURN *** [6h 7c Jc][5d]
*** RIVER *** [6h 7c Jc 5d][Qc]
*** SHOW DOWN ***
Whynot v shows [8d 8h] (One pair : 8)
POKPOKPK9 shows [Kd Qd] (One pair : Queens)
P1xel7 shows [As Qs] (One pair : Queens)
P1xel7 collected 23295 from main pot
POKPOKPK9 collected 15302 from side pot 1
*** SUMMARY ***
Total pot 38597 | No rake
Board: [6h 7c Jc 5d Qc]
Seat 1: POKPOKPK9 (small blind) showed [Kd Qd] and won 15302 with One pair : Queens
Seat 2: P1xel7 (big blind) showed [As Qs] and won 23295 with One pair : Queens
Seat 4: Whynot v showed [8d 8h] and lost with One pair : 8


Winamax Poker - Tournament "X-MAS FEVER 5 € - DAY 1" buyIn: 4.50€ + 0.50€ level: 5 - HandId: #3150633295033663601-93-1703363942 - Holdem no limit (50/200/400) - 2023/12/23 20:39:02 UTC
Table: 'X-MAS FEVER 5 € - DAY 1(733563978)#0112' 6-max (real money) Seat #1 is the button
Seat 1: POKPOKPK9 (15302)
Seat 2: P1xel7 (23295)
Seat 3: Wago7 (24772)
Seat 4: Whynot v (29834)
Seat 5: DUICEETDELOR (45413)
Seat 6: KAZAAR (24043)
*** ANTE/BLINDS ***
P1xel7 posts ante 50
Wago7 posts ante 50
POKPOKPK9 posts ante 50
Whynot v posts ante 50
DUICEETDELOR posts ante 50
KAZAAR posts ante 50
P1xel7 posts small blind 200
Wago7 posts big blind 400
Dealt to P1xel7 [6s 3h]
*** PRE-FLOP *** 
Whynot v raises 1300 to 1700
DUICEETDELOR calls 1700
KAZAAR folds
POKPOKPK9 folds
P1xel7 folds
Wago7 folds
*** FLOP *** [7s Qs 5s]
Whynot v checks
DUICEETDELOR bets 2150
Whynot v folds
DUICEETDELOR collected 6450 from pot
*** SUMMARY ***
Total pot 6450 | No rake
Board: [7s Qs 5s]
Seat 5: DUICEETDELOR won 6450


Winamax Poker - Tournament "X-MAS FEVER 5 € - DAY 1" buyIn: 4.50€ + 0.50€ level: 5 - HandId: #3150633295033663601-94-1703363976 - Holdem no limit (50/200/400) - 2023/12/23 20:39:36 UTC
Table: 'X-MAS FEVER 5 € - DAY 1(733563978)#0112' 6-max (real money) Seat #2 is the button
Seat 1: POKPOKPK9 (15252)
Seat 2: P1xel7 (23045)
Seat 3: Wago7 (24322)
Seat 4: Whynot v (28084)
Seat 5: DUICEETDELOR (47963)
Seat 6: KAZAAR (23993)
*** ANTE/BLINDS ***
Wago7 posts ante 50
Whynot v posts ante 50
POKPOKPK9 posts ante 50
P1xel7 posts ante 50
DUICEETDELOR posts ante 50
KAZAAR posts ante 50
Wago7 posts small blind 200
Whynot v posts big blind 400
Dealt to P1xel7 [Kd Ah]
*** PRE-FLOP *** 
DUICEETDELOR raises 500 to 900
KAZAAR folds
POKPOKPK9 folds
P1xel7 raises 2900 to 3800
Wago7 folds
Whynot v folds
DUICEETDELOR folds
P1xel7 collected 5600 from pot
*** SUMMARY ***
Total pot 5600 | No rake
Seat 2: P1xel7 (button) won 5600


Winamax Poker - Tournament "X-MAS FEVER 5 € - DAY 1" buyIn: 4.50€ + 0.50€ level: 5 - HandId: #3150633295033663601-95-1703364013 - Holdem no limit (50/200/400) - 2023/12/23 20:40:13 UTC
Table: 'X-MAS FEVER 5 € - DAY 1(733563978)#0112' 6-max (real money) Seat #3 is the button
Seat 1: POKPOKPK9 (15202)
Seat 2: P1xel7 (24795)
Seat 3: Wago7 (24072)
Seat 4: Whynot v (27634)
Seat 5: DUICEETDELOR (47013)
Seat 6: KAZAAR (23943)
*** ANTE/BLINDS ***
Whynot v posts ante 50
DUICEETDELOR posts ante 50
POKPOKPK9 posts ante 50
P1xel7 posts ante 50
Wago7 posts ante 50
KAZAAR posts ante 50
Whynot v posts small blind 200
DUICEETDELOR posts big blind 400
Dealt to P1xel7 [Js Ac]
*** PRE-FLOP *** 
KAZAAR folds
POKPOKPK9 folds
P1xel7 raises 680 to 1080
Wago7 folds
Whynot v calls 880
DUICEETDELOR folds
*** FLOP *** [8c 6h Td]
Whynot v checks
P1xel7 checks
*** TURN *** [8c 6h Td][Ts]
Whynot v bets 2860
P1xel7 folds
Whynot v collected 5720 from pot
*** SUMMARY ***
Total pot 5720 | No rake
Board: [8c 6h Td Ts]
Seat 4: Whynot v (small blind) won 5720


Winamax Poker - Tournament "X-MAS FEVER 5 € - DAY 1" buyIn: 4.50€ + 0.50€ level: 5 - HandId: #3150633295033663601-96-1703364090 - Holdem no limit (50/200/400) - 2023/12/23 20:41:30 UTC
Table: 'X-MAS FEVER 5 € - DAY 1(733563978)#0112' 6-max (real money) Seat #4 is the button
Seat 1: POKPOKPK9 (15152)
Seat 2: P1xel7 (23665)
Seat 3: Wago7 (24022)
Seat 4: Whynot v (29364)
Seat 5: DUICEETDELOR (46563)
Seat 6: KAZAAR (23893)
*** ANTE/BLINDS ***
DUICEETDELOR posts ante 50
KAZAAR posts ante 50
POKPOKPK9 posts ante 50
P1xel7 posts ante 50
Wago7 posts ante 50
Whynot v posts ante 50
DUICEETDELOR posts small blind 200
KAZAAR posts big blind 400
Dealt to P1xel7 [7h 9h]
*** PRE-FLOP *** 
POKPOKPK9 calls 400
P1xel7 folds
Wago7 folds
Whynot v raises 1700 to 2100
DUICEETDELOR folds
KAZAAR raises 21743 to 23843 and is all-in
POKPOKPK9 folds
Whynot v calls 21743
*** FLOP *** [Kc 8c 3d]
*** TURN *** [Kc 8c 3d][2h]
*** RIVER *** [Kc 8c 3d 2h][4d]
*** SHOW DOWN ***
Whynot v shows [6c 6h] (One pair : 6)
KAZAAR shows [Kh Kd] (Trips of Kings)
KAZAAR collected 48586 from pot
*** SUMMARY ***
Total pot 48586 | No rake
Board: [Kc 8c 3d 2h 4d]
Seat 4: Whynot v (button) showed [6c 6h] and lost with One pair : 6
Seat 6: KAZAAR (big blind) showed [Kh Kd] and won 48586 with Trips of Kings


Winamax Poker - Tournament "X-MAS FEVER 5 € - DAY 1" buyIn: 4.50€ + 0.50€ level: 5 - HandId: #3150633295033663601-97-1703364118 - Holdem no limit (50/200/400) - 2023/12/23 20:41:58 UTC
Table: 'X-MAS FEVER 5 € - DAY 1(733563978)#0112' 6-max (real money) Seat #5 is the button
Seat 1: POKPOKPK9 (14702)
Seat 2: P1xel7 (23615)
Seat 3: Wago7 (23972)
Seat 4: Whynot v (5471)
Seat 5: DUICEETDELOR (46313)
Seat 6: KAZAAR (48586)
*** ANTE/BLINDS ***
KAZAAR posts ante 50
POKPOKPK9 posts ante 50
P1xel7 posts ante 50
Wago7 posts ante 50
Whynot v posts ante 50
DUICEETDELOR posts ante 50
KAZAAR posts small blind 200
POKPOKPK9 posts big blind 400
Dealt to P1xel7 [Js Td]
*** PRE-FLOP *** 
P1xel7 folds
Wago7 folds
Whynot v folds
DUICEETDELOR folds
KAZAAR raises 400 to 800
POKPOKPK9 calls 400
*** FLOP *** [5h 5c 2h]
KAZAAR bets 1200
POKPOKPK9 calls 1200
*** TURN *** [5h 5c 2h][6h]
KAZAAR checks
POKPOKPK9 bets 2150
KAZAAR calls 2150
*** RIVER *** [5h 5c 2h 6h][Th]
KAZAAR bets 11000
POKPOKPK9 folds
KAZAAR collected 19600 from pot
*** SUMMARY ***
Total pot 19600 | No rake
Board: [5h 5c 2h 6h Th]
Seat 6: KAZAAR (small blind) won 19600


Winamax Poker - Tournament "X-MAS FEVER 5 € - DAY 1" buyIn: 4.50€ + 0.50€ level: 5 - HandId: #3150633295033663601-98-1703364201 - Holdem no limit (50/200/400) - 2023/12/23 20:43:21 UTC
Table: 'X-MAS FEVER 5 € - DAY 1(733563978)#0112' 6-max (real money) Seat #6 is the button
Seat 1: POKPOKPK9 (10502)
Seat 2: P1xel7 (23565)
Seat 3: Wago7 (23922)
Seat 4: Whynot v (5421)
Seat 5: DUICEETDELOR (46263)
Seat 6: KAZAAR (52986)
*** ANTE/BLINDS ***
POKPOKPK9 posts ante 50
P1xel7 posts ante 50
Wago7 posts ante 50
Whynot v posts ante 50
DUICEETDELOR posts ante 50
KAZAAR posts ante 50
POKPOKPK9 posts small blind 200
P1xel7 posts big blind 400
Dealt to P1xel7 [7d Ks]
*** PRE-FLOP *** 
Wago7 folds
Whynot v raises 4971 to 5371 and is all-in
DUICEETDELOR folds
KAZAAR folds
POKPOKPK9 folds
P1xel7 folds
Whynot v collected 6271 from pot
*** SUMMARY ***
Total pot 6271 | No rake
Seat 4: Whynot v won 6271


Winamax Poker - Tournament "X-MAS FEVER 5 € - DAY 1" buyIn: 4.50€ + 0.50€ level: 5 - HandId: #3150633295033663601-99-1703364217 - Holdem no limit (50/200/400) - 2023/12/23 20:43:37 UTC
Table: 'X-MAS FEVER 5 € - DAY 1(733563978)#0112' 6-max (real money) Seat #1 is the button
Seat 1: POKPOKPK9 (10252)
Seat 2: P1xel7 (23115)
Seat 3: Wago7 (23872)
Seat 4: Whynot v (6271)
Seat 5: DUICEETDELOR (46213)
Seat 6: KAZAAR (52936)
*** ANTE/BLINDS ***
P1xel7 posts ante 50
Wago7 posts ante 50
POKPOKPK9 posts ante 50
Whynot v posts ante 50
DUICEETDELOR posts ante 50
KAZAAR posts ante 50
P1xel7 posts small blind 200
Wago7 posts big blind 400
Dealt to P1xel7 [8s 8d]
*** PRE-FLOP *** 
Whynot v raises 5821 to 6221 and is all-in
DUICEETDELOR folds
KAZAAR folds
POKPOKPK9 folds
P1xel7 calls 6021
Wago7 folds
*** FLOP *** [As 9s Ks]
*** TURN *** [As 9s Ks][6s]
*** RIVER *** [As 9s Ks 6s][Kc]
*** SHOW DOWN ***
P1xel7 shows [8s 8d] (Flush Ace high)
Whynot v shows [Kh Kd] (Quads of Kings)
Whynot v collected 13142 from pot
*** SUMMARY ***
Total pot 13142 | No rake
Board: [As 9s Ks 6s Kc]
Seat 2: P1xel7 (small blind) showed [8s 8d] and lost with Flush Ace high
Seat 4: Whynot v showed [Kh Kd] and won 13142 with Quads of Kings


Winamax Poker - Tournament "X-MAS FEVER 5 € - DAY 1" buyIn: 4.50€ + 0.50€ level: 5 - HandId: #3150633295033663601-100-1703364240 - Holdem no limit (50/200/400) - 2023/12/23 20:44:00 UTC
Table: 'X-MAS FEVER 5 € - DAY 1(733563978)#0112' 6-max (real money) Seat #2 is the button
Seat 1: POKPOKPK9 (10202)
Seat 2: P1xel7 (16844)
Seat 3: Wago7 (23422)
Seat 4: Whynot v (13142)
Seat 5: DUICEETDELOR (46163)
Seat 6: KAZAAR (52886)
*** ANTE/BLINDS ***
Wago7 posts ante 50
Whynot v posts ante 50
POKPOKPK9 posts ante 50
P1xel7 posts ante 50
DUICEETDELOR posts ante 50
KAZAAR posts ante 50
Wago7 posts small blind 200
Whynot v posts big blind 400
Dealt to P1xel7 [Jc Qc]
*** PRE-FLOP *** 
DUICEETDELOR folds
KAZAAR folds
POKPOKPK9 folds
P1xel7 raises 600 to 1000
Wago7 folds
Whynot v calls 600
*** FLOP *** [6s Ac Tc]
Whynot v checks
P1xel7 bets 875
Whynot v calls 875
*** TURN *** [6s Ac Tc][4s]
Whynot v checks
P1xel7 checks
*** RIVER *** [6s Ac Tc 4s][6d]
Whynot v bets 2763
P1xel7 folds
Whynot v collected 7013 from pot
*** SUMMARY ***
Total pot 7013 | No rake
Board: [6s Ac Tc 4s 6d]
Seat 4: Whynot v (big blind) won 7013


Winamax Poker - Tournament "X-MAS FEVER 5 € - DAY 1" buyIn: 4.50€ + 0.50€ level: 5 - HandId: #3150633295033663601-101-1703364282 - Holdem no limit (50/200/400) - 2023/12/23 20:44:42 UTC
Table: 'X-MAS FEVER 5 € - DAY 1(733563978)#0112' 6-max (real money) Seat #3 is the button
Seat 1: POKPOKPK9 (10152)
Seat 2: P1xel7 (14919)
Seat 3: Wago7 (23172)
Seat 4: Whynot v (15467)
Seat 5: DUICEETDELOR (46113)
Seat 6: KAZAAR (52836)
*** ANTE/BLINDS ***
Whynot v posts ante 50
DUICEETDELOR posts ante 50
POKPOKPK9 posts ante 50
P1xel7 posts ante 50
Wago7 posts ante 50
KAZAAR posts ante 50
Whynot v posts small blind 200
DUICEETDELOR posts big blind 400
Dealt to P1xel7 [As 6s]
*** PRE-FLOP *** 
KAZAAR folds
POKPOKPK9 raises 9702 to 10102 and is all-in
P1xel7 folds
Wago7 folds
Whynot v folds
DUICEETDELOR folds
POKPOKPK9 collected 11002 from pot
*** SUMMARY ***
Total pot 11002 | No rake
Seat 1: POKPOKPK9 won 11002


Winamax Poker - Tournament "X-MAS FEVER 5 € - DAY 1" buyIn: 4.50€ + 0.50€ level: 5 - HandId: #3150633295033663601-102-1703364323 - Holdem no limit (50/200/400) - 2023/12/23 20:45:23 UTC
Table: 'X-MAS FEVER 5 € - DAY 1(733563978)#0112' 6-max (real money) Seat #4 is the button
Seat 1: POKPOKPK9 (11002)
Seat 2: P1xel7 (14869)
Seat 3: Wago7 (23122)
Seat 4: Whynot v (15217)
Seat 5: DUICEETDELOR (45663)
Seat 6: KAZAAR (52786)
*** ANTE/BLINDS ***
DUICEETDELOR posts ante 50
KAZAAR posts ante 50
POKPOKPK9 posts ante 50
P1xel7 posts ante 50
Wago7 posts ante 50
Whynot v posts ante 50
DUICEETDELOR posts small blind 200
KAZAAR posts big blind 400
Dealt to P1xel7 [3s Qh]
*** PRE-FLOP *** 
POKPOKPK9 folds
P1xel7 folds
Wago7 folds
Whynot v calls 400
DUICEETDELOR raises 1000 to 1400
KAZAAR folds
Whynot v calls 1000
*** FLOP *** [9c Jh Qc]
DUICEETDELOR bets 1225
Whynot v folds
DUICEETDELOR collected 4725 from pot
*** SUMMARY ***
Total pot 4725 | No rake
Board: [9c Jh Qc]
Seat 5: DUICEETDELOR (small blind) won 4725


Winamax Poker - Tournament "X-MAS FEVER 5 € - DAY 1" buyIn: 4.50€ + 0.50€ level: 5 - HandId: #3150633295033663601-103-1703364360 - Holdem no limit (50/200/400) - 2023/12/23 20:46:00 UTC
Table: 'X-MAS FEVER 5 € - DAY 1(733563978)#0112' 6-max (real money) Seat #5 is the button
Seat 1: POKPOKPK9 (10952)
Seat 2: P1xel7 (14819)
Seat 3: Wago7 (23072)
Seat 4: Whynot v (13767)
Seat 5: DUICEETDELOR (47713)
Seat 6: KAZAAR (52336)
*** ANTE/BLINDS ***
KAZAAR posts ante 50
POKPOKPK9 posts ante 50
P1xel7 posts ante 50
Wago7 posts ante 50
Whynot v posts ante 50
DUICEETDELOR posts ante 50
KAZAAR posts small blind 200
POKPOKPK9 posts big blind 400
Dealt to P1xel7 [9s Qc]
*** PRE-FLOP *** 
P1xel7 folds
Wago7 folds
Whynot v calls 400
DUICEETDELOR folds
KAZAAR folds
POKPOKPK9 checks
*** FLOP *** [7s 2c 3c]
POKPOKPK9 bets 400
Whynot v calls 400
*** TURN *** [7s 2c 3c][Th]
POKPOKPK9 bets 400
Whynot v calls 400
*** RIVER *** [7s 2c 3c Th][7c]
POKPOKPK9 checks
Whynot v bets 1015
POKPOKPK9 folds
Whynot v collected 3915 from pot
*** SUMMARY ***
Total pot 3915 | No rake
Board: [7s 2c 3c Th 7c]
Seat 4: Whynot v won 3915


Winamax Poker - Tournament "X-MAS FEVER 5 € - DAY 1" buyIn: 4.50€ + 0.50€ level: 5 - HandId: #3150633295033663601-104-1703364420 - Holdem no limit (50/200/400) - 2023/12/23 20:47:00 UTC
Table: 'X-MAS FEVER 5 € - DAY 1(733563978)#0112' 6-max (real money) Seat #6 is the button
Seat 1: POKPOKPK9 (9702)
Seat 2: P1xel7 (14769)
Seat 3: Wago7 (23022)
Seat 4: Whynot v (15417)
Seat 5: DUICEETDELOR (47663)
Seat 6: KAZAAR (52086)
*** ANTE/BLINDS ***
POKPOKPK9 posts ante 50
P1xel7 posts ante 50
Wago7 posts ante 50
Whynot v posts ante 50
DUICEETDELOR posts ante 50
KAZAAR posts ante 50
POKPOKPK9 posts small blind 200
P1xel7 posts big blind 400
Dealt to P1xel7 [Ad 7d]
*** PRE-FLOP *** 
Wago7 folds
Whynot v folds
DUICEETDELOR raises 500 to 900
KAZAAR folds
POKPOKPK9 folds
P1xel7 calls 500
*** FLOP *** [Kd Kc 3h]
P1xel7 checks
DUICEETDELOR bets 805
P1xel7 calls 805
*** TURN *** [Kd Kc 3h][As]
P1xel7 checks
DUICEETDELOR checks
*** RIVER *** [Kd Kc 3h As][2s]
P1xel7 bets 3128
DUICEETDELOR calls 3128
*** SHOW DOWN ***
DUICEETDELOR shows [Qc Qd] (Two pairs : Kings and Queens)
P1xel7 shows [Ad 7d] (Two pairs : Aces and Kings)
P1xel7 collected 10166 from pot
*** SUMMARY ***
Total pot 10166 | No rake
Board: [Kd Kc 3h As 2s]
Seat 2: P1xel7 (big blind) showed [Ad 7d] and won 10166 with Two pairs : Aces and Kings
Seat 5: DUICEETDELOR showed [Qc Qd] and lost with Two pairs : Kings and Queens


Winamax Poker - Tournament "X-MAS FEVER 5 € - DAY 1" buyIn: 4.50€ + 0.50€ level: 5 - HandId: #3150633295033663601-105-1703364472 - Holdem no limit (50/200/400) - 2023/12/23 20:47:52 UTC
Table: 'X-MAS FEVER 5 € - DAY 1(733563978)#0112' 6-max (real money) Seat #1 is the button
Seat 1: POKPOKPK9 (9452)
Seat 2: P1xel7 (20052)
Seat 3: Wago7 (22972)
Seat 4: Whynot v (15367)
Seat 5: DUICEETDELOR (42780)
Seat 6: KAZAAR (52036)
*** ANTE/BLINDS ***
P1xel7 posts ante 50
Wago7 posts ante 50
POKPOKPK9 posts ante 50
Whynot v posts ante 50
DUICEETDELOR posts ante 50
KAZAAR posts ante 50
P1xel7 posts small blind 200
Wago7 posts big blind 400
Dealt to P1xel7 [6s 3d]
*** PRE-FLOP *** 
Whynot v calls 400
DUICEETDELOR folds
KAZAAR raises 800 to 1200
POKPOKPK9 folds
P1xel7 folds
Wago7 folds
Whynot v calls 800
*** FLOP *** [7h Jd 8h]
Whynot v checks
KAZAAR bets 2277
Whynot v calls 2277
*** TURN *** [7h Jd 8h][9c]
Whynot v checks
KAZAAR checks
*** RIVER *** [7h Jd 8h 9c][8d]
Whynot v checks
KAZAAR checks
*** SHOW DOWN ***
Whynot v shows [7c Kc] (Two pairs : 8 and 7)
KAZAAR shows [As Ac] (Two pairs : Aces and 8)
KAZAAR collected 7854 from pot
*** SUMMARY ***
Total pot 7854 | No rake
Board: [7h Jd 8h 9c 8d]
Seat 4: Whynot v showed [7c Kc] and lost with Two pairs : 8 and 7
Seat 6: KAZAAR showed [As Ac] and won 7854 with Two pairs : Aces and 8


Winamax Poker - Tournament "X-MAS FEVER 5 € - DAY 1" buyIn: 4.50€ + 0.50€ level: 5 - HandId: #3150633295033663601-106-1703364516 - Holdem no limit (50/200/400) - 2023/12/23 20:48:36 UTC
Table: 'X-MAS FEVER 5 € - DAY 1(733563978)#0112' 6-max (real money) Seat #2 is the button
Seat 1: POKPOKPK9 (9402)
Seat 2: P1xel7 (19802)
Seat 3: Wago7 (22522)
Seat 4: Whynot v (11840)
Seat 5: DUICEETDELOR (42730)
Seat 6: KAZAAR (56363)
*** ANTE/BLINDS ***
Wago7 posts ante 50
Whynot v posts ante 50
POKPOKPK9 posts ante 50
P1xel7 posts ante 50
DUICEETDELOR posts ante 50
KAZAAR posts ante 50
Wago7 posts small blind 200
Whynot v posts big blind 400
Dealt to P1xel7 [8h 2c]
*** PRE-FLOP *** 
DUICEETDELOR folds
KAZAAR folds
POKPOKPK9 folds
P1xel7 folds
Wago7 folds
Whynot v collected 900 from pot
*** SUMMARY ***
Total pot 900 | No rake
Seat 4: Whynot v (big blind) won 900


Winamax Poker - Tournament "X-MAS FEVER 5 € - DAY 1" buyIn: 4.50€ + 0.50€ level: 5 - HandId: #3150633295033663601-107-1703364555 - Holdem no limit (50/200/400) - 2023/12/23 20:49:15 UTC
Table: 'X-MAS FEVER 5 € - DAY 1(733563978)#0112' 6-max (real money) Seat #3 is the button
Seat 1: POKPOKPK9 (9352)
Seat 2: P1xel7 (19752)
Seat 3: Wago7 (22272)
Seat 4: Whynot v (12290)
Seat 5: DUICEETDELOR (42680)
Seat 6: KAZAAR (56313)
*** ANTE/BLINDS ***
Whynot v posts ante 50
DUICEETDELOR posts ante 50
POKPOKPK9 posts ante 50
P1xel7 posts ante 50
Wago7 posts ante 50
KAZAAR posts ante 50
Whynot v posts small blind 200
DUICEETDELOR posts big blind 400
Dealt to P1xel7 [Jd 4h]
*** PRE-FLOP *** 
KAZAAR folds
POKPOKPK9 folds
P1xel7 folds
Wago7 raises 400 to 800
Whynot v folds
DUICEETDELOR calls 400
*** FLOP *** [Qd Ac 9s]
DUICEETDELOR checks
Wago7 bets 735
DUICEETDELOR calls 735
*** TURN *** [Qd Ac 9s][Th]
DUICEETDELOR checks
Wago7 checks
*** RIVER *** [Qd Ac 9s Th][2h]
DUICEETDELOR checks
Wago7 bets 1785
DUICEETDELOR calls 1785
*** SHOW DOWN ***
DUICEETDELOR shows [Qc 5c] (One pair : Queens)
Wago7 shows [As 8d] (One pair : Aces)
Wago7 collected 7140 from pot
*** SUMMARY ***
Total pot 7140 | No rake
Board: [Qd Ac 9s Th 2h]
Seat 3: Wago7 (button) showed [As 8d] and won 7140 with One pair : Aces
Seat 5: DUICEETDELOR (big blind) showed [Qc 5c] and lost with One pair : Queens


Winamax Poker - Tournament "X-MAS FEVER 5 € - DAY 1" buyIn: 4.50€ + 0.50€ level: 6 - HandId: #3150633295033663601-108-1703364638 - Holdem no limit (60/250/500) - 2023/12/23 20:50:38 UTC
Table: 'X-MAS FEVER 5 € - DAY 1(733563978)#0112' 6-max (real money) Seat #4 is the button
Seat 1: POKPOKPK9 (9302)
Seat 2: P1xel7 (19702)
Seat 3: Wago7 (26042)
Seat 4: Whynot v (12040)
Seat 5: DUICEETDELOR (39310)
Seat 6: KAZAAR (56263)
*** ANTE/BLINDS ***
DUICEETDELOR posts ante 60
KAZAAR posts ante 60
POKPOKPK9 posts ante 60
P1xel7 posts ante 60
Wago7 posts ante 60
Whynot v posts ante 60
DUICEETDELOR posts small blind 250
KAZAAR posts big blind 500
Dealt to P1xel7 [Jc 5h]
*** PRE-FLOP *** 
POKPOKPK9 calls 500
P1xel7 folds
Wago7 folds
Whynot v folds
DUICEETDELOR folds
KAZAAR checks
*** FLOP *** [Tc 8s 2c]
KAZAAR checks
POKPOKPK9 checks
*** TURN *** [Tc 8s 2c][4c]
KAZAAR bets 750
POKPOKPK9 calls 750
*** RIVER *** [Tc 8s 2c 4c][4d]
KAZAAR bets 1500
POKPOKPK9 raises 2305 to 3805
KAZAAR calls 2305
*** SHOW DOWN ***
KAZAAR shows [Qc Ts] (Two pairs : Tens and 4)
POKPOKPK9 shows [4h 3c] (Trips of 4)
POKPOKPK9 collected 10720 from pot
*** SUMMARY ***
Total pot 10720 | No rake
Board: [Tc 8s 2c 4c 4d]
Seat 1: POKPOKPK9 showed [4h 3c] and won 10720 with Trips of 4
Seat 6: KAZAAR (big blind) showed [Qc Ts] and lost with Two pairs : Tens and 4


Winamax Poker - Tournament "X-MAS FEVER 5 € - DAY 1" buyIn: 4.50€ + 0.50€ level: 6 - HandId: #3150633295033663601-109-1703364776 - Holdem no limit (60/250/500) - 2023/12/23 20:52:56 UTC
Table: 'X-MAS FEVER 5 € - DAY 1(733563978)#0112' 6-max (real money) Seat #5 is the button
Seat 1: POKPOKPK9 (14907)
Seat 2: P1xel7 (19642)
Seat 3: Wago7 (25982)
Seat 4: Whynot v (11980)
Seat 5: DUICEETDELOR (39000)
Seat 6: KAZAAR (51148)
*** ANTE/BLINDS ***
KAZAAR posts ante 60
POKPOKPK9 posts ante 60
P1xel7 posts ante 60
Wago7 posts ante 60
Whynot v posts ante 60
DUICEETDELOR posts ante 60
KAZAAR posts small blind 250
POKPOKPK9 posts big blind 500
Dealt to P1xel7 [5s Qc]
*** PRE-FLOP *** 
P1xel7 folds
Wago7 raises 500 to 1000
Whynot v folds
DUICEETDELOR folds
KAZAAR folds
POKPOKPK9 calls 500
*** FLOP *** [Jc 4d 6s]
POKPOKPK9 checks
Wago7 bets 914
POKPOKPK9 folds
Wago7 collected 3524 from pot
*** SUMMARY ***
Total pot 3524 | No rake
Board: [Jc 4d 6s]
Seat 3: Wago7 won 3524


Winamax Poker - Tournament "X-MAS FEVER 5 € - DAY 1" buyIn: 4.50€ + 0.50€ level: 6 - HandId: #3150633295033663601-110-1703364838 - Holdem no limit (60/250/500) - 2023/12/23 20:53:58 UTC
Table: 'X-MAS FEVER 5 € - DAY 1(733563978)#0112' 6-max (real money) Seat #6 is the button
Seat 1: POKPOKPK9 (13847)
Seat 2: P1xel7 (19582)
Seat 3: Wago7 (27532)
Seat 4: Whynot v (11920)
Seat 5: DUICEETDELOR (38940)
Seat 6: KAZAAR (50838)
*** ANTE/BLINDS ***
POKPOKPK9 posts ante 60
P1xel7 posts ante 60
Wago7 posts ante 60
Whynot v posts ante 60
DUICEETDELOR posts ante 60
KAZAAR posts ante 60
POKPOKPK9 posts small blind 250
P1xel7 posts big blind 500
Dealt to P1xel7 [5d Td]
*** PRE-FLOP *** 
Wago7 raises 750 to 1250
Whynot v folds
DUICEETDELOR calls 1250
KAZAAR calls 1250
POKPOKPK9 calls 1000
P1xel7 folds
*** FLOP *** [Ac Jh Tc]
POKPOKPK9 checks
Wago7 checks
DUICEETDELOR bets 2930
KAZAAR folds
POKPOKPK9 folds
Wago7 folds
DUICEETDELOR collected 8790 from pot
*** SUMMARY ***
Total pot 8790 | No rake
Board: [Ac Jh Tc]
Seat 5: DUICEETDELOR won 8790


Winamax Poker - Tournament "X-MAS FEVER 5 € - DAY 1" buyIn: 4.50€ + 0.50€ level: 6 - HandId: #3150633295033663601-111-1703365261 - Holdem no limit (60/250/500) - 2023/12/23 21:01:01 UTC
Table: 'X-MAS FEVER 5 € - DAY 1(733563978)#0112' 6-max (real money) Seat #1 is the button
Seat 1: POKPOKPK9 (12537)
Seat 2: P1xel7 (19022)
Seat 3: Wago7 (26222)
Seat 4: Whynot v (11860)
Seat 5: DUICEETDELOR (43490)
Seat 6: KAZAAR (49528)
*** ANTE/BLINDS ***
P1xel7 posts ante 60
Wago7 posts ante 60
POKPOKPK9 posts ante 60
Whynot v posts ante 60
DUICEETDELOR posts ante 60
KAZAAR posts ante 60
P1xel7 posts small blind 250
Wago7 posts big blind 500
Dealt to P1xel7 [Kd Qd]
*** PRE-FLOP *** 
Whynot v folds
DUICEETDELOR folds
KAZAAR raises 750 to 1250
POKPOKPK9 folds
P1xel7 calls 1000
Wago7 raises 3250 to 4500
KAZAAR folds
P1xel7 calls 3250
*** FLOP *** [Kh 6h 8d]
P1xel7 checks
Wago7 bets 2653
P1xel7 raises 11809 to 14462 and is all-in
Wago7 folds
P1xel7 collected 27725 from pot
*** SUMMARY ***
Total pot 27725 | No rake
Board: [Kh 6h 8d]
Seat 2: P1xel7 (small blind) won 27725


Winamax Poker - Tournament "X-MAS FEVER 5 € - DAY 1" buyIn: 4.50€ + 0.50€ level: 6 - HandId: #3150633295033663601-112-1703365340 - Holdem no limit (60/250/500) - 2023/12/23 21:02:20 UTC
Table: 'X-MAS FEVER 5 € - DAY 1(733563978)#0112' 6-max (real money) Seat #2 is the button
Seat 1: POKPOKPK9 (12477)
Seat 2: P1xel7 (27725)
Seat 3: Wago7 (19009)
Seat 4: Whynot v (11800)
Seat 5: DUICEETDELOR (43430)
Seat 6: KAZAAR (48218)
*** ANTE/BLINDS ***
Wago7 posts ante 60
Whynot v posts ante 60
POKPOKPK9 posts ante 60
P1xel7 posts ante 60
DUICEETDELOR posts ante 60
KAZAAR posts ante 60
Wago7 posts small blind 250
Whynot v posts big blind 500
Dealt to P1xel7 [4d Tc]
*** PRE-FLOP *** 
DUICEETDELOR folds
KAZAAR folds
POKPOKPK9 folds
P1xel7 folds
Wago7 folds
Whynot v collected 1110 from pot
*** SUMMARY ***
Total pot 1110 | No rake
Seat 4: Whynot v (big blind) won 1110


Winamax Poker - Tournament "X-MAS FEVER 5 € - DAY 1" buyIn: 4.50€ + 0.50€ level: 6 - HandId: #3150633295033663601-113-1703365359 - Holdem no limit (60/250/500) - 2023/12/23 21:02:39 UTC
Table: 'X-MAS FEVER 5 € - DAY 1(733563978)#0112' 6-max (real money) Seat #3 is the button
Seat 1: POKPOKPK9 (12417)
Seat 2: P1xel7 (27665)
Seat 3: Wago7 (18699)
Seat 4: Whynot v (12350)
Seat 5: DUICEETDELOR (43370)
Seat 6: KAZAAR (48158)
*** ANTE/BLINDS ***
Whynot v posts ante 60
DUICEETDELOR posts ante 60
POKPOKPK9 posts ante 60
P1xel7 posts ante 60
Wago7 posts ante 60
KAZAAR posts ante 60
Whynot v posts small blind 250
DUICEETDELOR posts big blind 500
Dealt to P1xel7 [Tc 5c]
*** PRE-FLOP *** 
KAZAAR folds
POKPOKPK9 calls 500
P1xel7 folds
Wago7 raises 1250 to 1750
Whynot v folds
DUICEETDELOR folds
POKPOKPK9 calls 1250
*** FLOP *** [4c Ac Th]
POKPOKPK9 checks
Wago7 bets 1614
POKPOKPK9 raises 1614 to 3228
Wago7 calls 1614
*** TURN *** [4c Ac Th][9h]
POKPOKPK9 bets 3873
Wago7 folds
POKPOKPK9 collected 14939 from pot
*** SUMMARY ***
Total pot 14939 | No rake
Board: [4c Ac Th 9h]
Seat 1: POKPOKPK9 won 14939


Winamax Poker - Tournament "X-MAS FEVER 5 € - DAY 1" buyIn: 4.50€ + 0.50€ level: 6 - HandId: #3150633295033663601-114-1703365470 - Holdem no limit (60/250/500) - 2023/12/23 21:04:30 UTC
Table: 'X-MAS FEVER 5 € - DAY 1(733563978)#0112' 6-max (real money) Seat #4 is the button
Seat 1: POKPOKPK9 (18445)
Seat 2: P1xel7 (27605)
Seat 3: Wago7 (13661)
Seat 4: Whynot v (12040)
Seat 5: DUICEETDELOR (42810)
Seat 6: KAZAAR (48098)
*** ANTE/BLINDS ***
DUICEETDELOR posts ante 60
KAZAAR posts ante 60
POKPOKPK9 posts ante 60
P1xel7 posts ante 60
Wago7 posts ante 60
Whynot v posts ante 60
DUICEETDELOR posts small blind 250
KAZAAR posts big blind 500
Dealt to P1xel7 [8h Js]
*** PRE-FLOP *** 
POKPOKPK9 calls 500
P1xel7 folds
Wago7 folds
Whynot v raises 11480 to 11980 and is all-in
DUICEETDELOR folds
KAZAAR folds
POKPOKPK9 folds
Whynot v collected 13590 from pot
*** SUMMARY ***
Total pot 13590 | No rake
Seat 4: Whynot v (button) won 13590


Winamax Poker - Tournament "X-MAS FEVER 5 € - DAY 1" buyIn: 4.50€ + 0.50€ level: 6 - HandId: #3150633295033663601-115-1703365526 - Holdem no limit (60/250/500) - 2023/12/23 21:05:26 UTC
Table: 'X-MAS FEVER 5 € - DAY 1(733563978)#0112' 6-max (real money) Seat #5 is the button
Seat 1: POKPOKPK9 (17885)
Seat 2: P1xel7 (27545)
Seat 3: Wago7 (13601)
Seat 4: Whynot v (13590)
Seat 5: DUICEETDELOR (42500)
Seat 6: KAZAAR (47538)
*** ANTE/BLINDS ***
KAZAAR posts ante 60
POKPOKPK9 posts ante 60
P1xel7 posts ante 60
Wago7 posts ante 60
Whynot v posts ante 60
DUICEETDELOR posts ante 60
KAZAAR posts small blind 250
POKPOKPK9 posts big blind 500
Dealt to P1xel7 [8s 2c]
*** PRE-FLOP *** 
P1xel7 folds
Wago7 folds
Whynot v raises 1610 to 2110
DUICEETDELOR folds
KAZAAR raises 45368 to 47478 and is all-in
POKPOKPK9 folds
Whynot v calls 11420 and is all-in
*** FLOP *** [Kh Ad Qd]
*** TURN *** [Kh Ad Qd][6s]
*** RIVER *** [Kh Ad Qd 6s][Ks]
*** SHOW DOWN ***
Whynot v shows [Kc Js] (Trips of Kings)
KAZAAR shows [Ac 9h] (Two pairs : Aces and Kings)
KAZAAR collected 33948 from side pot 1
Whynot v collected 27920 from main pot
*** SUMMARY ***
Total pot 61868 | No rake
Board: [Kh Ad Qd 6s Ks]
Seat 4: Whynot v showed [Kc Js] and won 27920 with Trips of Kings
Seat 6: KAZAAR (small blind) showed [Ac 9h] and won 33948 with Two pairs : Aces and Kings


Winamax Poker - Tournament "X-MAS FEVER 5 € - DAY 1" buyIn: 4.50€ + 0.50€ level: 6 - HandId: #3150633295033663601-116-1703365570 - Holdem no limit (60/250/500) - 2023/12/23 21:06:10 UTC
Table: 'X-MAS FEVER 5 € - DAY 1(733563978)#0112' 6-max (real money) Seat #6 is the button
Seat 1: POKPOKPK9 (17325)
Seat 2: P1xel7 (27485)
Seat 3: Wago7 (13541)
Seat 4: Whynot v (27920)
Seat 5: DUICEETDELOR (42440)
Seat 6: KAZAAR (33948)
*** ANTE/BLINDS ***
POKPOKPK9 posts ante 60
P1xel7 posts ante 60
Wago7 posts ante 60
Whynot v posts ante 60
DUICEETDELOR posts ante 60
KAZAAR posts ante 60
POKPOKPK9 posts small blind 250
P1xel7 posts big blind 500
Dealt to P1xel7 [Td Jh]
*** PRE-FLOP *** 
Wago7 folds
Whynot v folds
DUICEETDELOR folds
KAZAAR folds
POKPOKPK9 calls 250
P1xel7 checks
*** FLOP *** [2d 4h Ac]
POKPOKPK9 checks
P1xel7 bets 680
POKPOKPK9 calls 680
*** TURN *** [2d 4h Ac][Tc]
POKPOKPK9 checks
P1xel7 bets 952
POKPOKPK9 calls 952
*** RIVER *** [2d 4h Ac Tc][Qs]
POKPOKPK9 checks
P1xel7 checks
*** SHOW DOWN ***
POKPOKPK9 shows [2s Kh] (One pair : 2)
P1xel7 shows [Td Jh] (One pair : Tens)
P1xel7 collected 4624 from pot
*** SUMMARY ***
Total pot 4624 | No rake
Board: [2d 4h Ac Tc Qs]
Seat 1: POKPOKPK9 (small blind) showed [2s Kh] and lost with One pair : 2
Seat 2: P1xel7 (big blind) showed [Td Jh] and won 4624 with One pair : Tens


Winamax Poker - Tournament "X-MAS FEVER 5 € - DAY 1" buyIn: 4.50€ + 0.50€ level: 7 - HandId: #3150633295033663601-117-1703365658 - Holdem no limit (70/300/600) - 2023/12/23 21:07:38 UTC
Table: 'X-MAS FEVER 5 € - DAY 1(733563978)#0112' 6-max (real money) Seat #1 is the button
Seat 1: POKPOKPK9 (15133)
Seat 2: P1xel7 (29917)
Seat 3: Wago7 (13481)
Seat 4: Whynot v (27860)
Seat 5: DUICEETDELOR (42380)
Seat 6: KAZAAR (33888)
*** ANTE/BLINDS ***
P1xel7 posts ante 70
Wago7 posts ante 70
POKPOKPK9 posts ante 70
Whynot v posts ante 70
DUICEETDELOR posts ante 70
KAZAAR posts ante 70
P1xel7 posts small blind 300
Wago7 posts big blind 600
Dealt to P1xel7 [Jc 9d]
*** PRE-FLOP *** 
Whynot v folds
DUICEETDELOR folds
KAZAAR folds
POKPOKPK9 folds
P1xel7 raises 900 to 1500
Wago7 folds
P1xel7 collected 2520 from pot
*** SUMMARY ***
Total pot 2520 | No rake
Seat 2: P1xel7 (small blind) won 2520


Winamax Poker - Tournament "X-MAS FEVER 5 € - DAY 1" buyIn: 4.50€ + 0.50€ level: 7 - HandId: #3150633295033663601-118-1703365703 - Holdem no limit (70/300/600) - 2023/12/23 21:08:23 UTC
Table: 'X-MAS FEVER 5 € - DAY 1(733563978)#0112' 6-max (real money) Seat #2 is the button
Seat 1: POKPOKPK9 (15063)
Seat 2: P1xel7 (30867)
Seat 3: Wago7 (12811)
Seat 4: Whynot v (27790)
Seat 5: DUICEETDELOR (42310)
Seat 6: KAZAAR (33818)
*** ANTE/BLINDS ***
Wago7 posts ante 70
Whynot v posts ante 70
POKPOKPK9 posts ante 70
P1xel7 posts ante 70
DUICEETDELOR posts ante 70
KAZAAR posts ante 70
Wago7 posts small blind 300
Whynot v posts big blind 600
Dealt to P1xel7 [9c 5h]
*** PRE-FLOP *** 
DUICEETDELOR folds
KAZAAR folds
POKPOKPK9 folds
P1xel7 folds
Wago7 folds
Whynot v collected 1320 from pot
*** SUMMARY ***
Total pot 1320 | No rake
Seat 4: Whynot v (big blind) won 1320


Winamax Poker - Tournament "X-MAS FEVER 5 € - DAY 1" buyIn: 4.50€ + 0.50€ level: 7 - HandId: #3150633295033663601-119-1703365729 - Holdem no limit (70/300/600) - 2023/12/23 21:08:49 UTC
Table: 'X-MAS FEVER 5 € - DAY 1(733563978)#0112' 6-max (real money) Seat #3 is the button
Seat 1: POKPOKPK9 (14993)
Seat 2: P1xel7 (30797)
Seat 3: Wago7 (12441)
Seat 4: Whynot v (28440)
Seat 5: DUICEETDELOR (42240)
Seat 6: KAZAAR (33748)
*** ANTE/BLINDS ***
Whynot v posts ante 70
DUICEETDELOR posts ante 70
POKPOKPK9 posts ante 70
P1xel7 posts ante 70
Wago7 posts ante 70
KAZAAR posts ante 70
Whynot v posts small blind 300
DUICEETDELOR posts big blind 600
Dealt to P1xel7 [6c Ad]
*** PRE-FLOP *** 
KAZAAR raises 600 to 1200
POKPOKPK9 folds
P1xel7 folds
Wago7 folds
Whynot v calls 900
DUICEETDELOR folds
*** FLOP *** [9c 8d 9s]
Whynot v checks
KAZAAR checks
*** TURN *** [9c 8d 9s][Jh]
Whynot v checks
KAZAAR bets 1200
Whynot v calls 1200
*** RIVER *** [9c 8d 9s Jh][Kc]
Whynot v bets 3783
KAZAAR folds
Whynot v collected 9603 from pot
*** SUMMARY ***
Total pot 9603 | No rake
Board: [9c 8d 9s Jh Kc]
Seat 4: Whynot v (small blind) won 9603


Winamax Poker - Tournament "X-MAS FEVER 5 € - DAY 1" buyIn: 4.50€ + 0.50€ level: 7 - HandId: #3150633295033663601-120-1703365787 - Holdem no limit (70/300/600) - 2023/12/23 21:09:47 UTC
Table: 'X-MAS FEVER 5 € - DAY 1(733563978)#0112' 6-max (real money) Seat #4 is the button
Seat 1: POKPOKPK9 (14923)
Seat 2: P1xel7 (30727)
Seat 3: Wago7 (12371)
Seat 4: Whynot v (31790)
Seat 5: DUICEETDELOR (41570)
Seat 6: KAZAAR (31278)
*** ANTE/BLINDS ***
DUICEETDELOR posts ante 70
KAZAAR posts ante 70
POKPOKPK9 posts ante 70
P1xel7 posts ante 70
Wago7 posts ante 70
Whynot v posts ante 70
DUICEETDELOR posts small blind 300
KAZAAR posts big blind 600
Dealt to P1xel7 [Qh 5d]
*** PRE-FLOP *** 
POKPOKPK9 raises 600 to 1200
P1xel7 folds
Wago7 raises 11101 to 12301 and is all-in
Whynot v folds
DUICEETDELOR folds
KAZAAR folds
POKPOKPK9 folds
Wago7 collected 14821 from pot
*** SUMMARY ***
Total pot 14821 | No rake
Seat 3: Wago7 won 14821


Winamax Poker - Tournament "X-MAS FEVER 5 € - DAY 1" buyIn: 4.50€ + 0.50€ level: 7 - HandId: #3150633295033663601-121-1703365828 - Holdem no limit (70/300/600) - 2023/12/23 21:10:28 UTC
Table: 'X-MAS FEVER 5 € - DAY 1(733563978)#0112' 6-max (real money) Seat #5 is the button
Seat 1: POKPOKPK9 (13653)
Seat 2: P1xel7 (30657)
Seat 3: Wago7 (14821)
Seat 4: Whynot v (31720)
Seat 5: DUICEETDELOR (41200)
Seat 6: KAZAAR (30608)
*** ANTE/BLINDS ***
KAZAAR posts ante 70
POKPOKPK9 posts ante 70
P1xel7 posts ante 70
Wago7 posts ante 70
Whynot v posts ante 70
DUICEETDELOR posts ante 70
KAZAAR posts small blind 300
POKPOKPK9 posts big blind 600
Dealt to P1xel7 [4h Ad]
*** PRE-FLOP *** 
P1xel7 folds
Wago7 raises 600 to 1200
Whynot v calls 1200
DUICEETDELOR folds
KAZAAR folds
POKPOKPK9 calls 600
*** FLOP *** [Qh 3s Kh]
POKPOKPK9 checks
Wago7 checks
Whynot v checks
*** TURN *** [Qh 3s Kh][5c]
POKPOKPK9 bets 600
Wago7 folds
Whynot v calls 600
*** RIVER *** [Qh 3s Kh 5c][Ah]
POKPOKPK9 bets 600
Whynot v raises 1962 to 2562
POKPOKPK9 calls 1962
*** SHOW DOWN ***
Whynot v shows [8s Jc] (High card : Ace)
POKPOKPK9 shows [Qc Js] (One pair : Queens)
POKPOKPK9 collected 10644 from pot
*** SUMMARY ***
Total pot 10644 | No rake
Board: [Qh 3s Kh 5c Ah]
Seat 1: POKPOKPK9 (big blind) showed [Qc Js] and won 10644 with One pair : Queens
Seat 4: Whynot v showed [8s Jc] and lost with High card : Ace


Winamax Poker - Tournament "X-MAS FEVER 5 € - DAY 1" buyIn: 4.50€ + 0.50€ level: 7 - HandId: #3150633295033663601-122-1703365868 - Holdem no limit (70/300/600) - 2023/12/23 21:11:08 UTC
Table: 'X-MAS FEVER 5 € - DAY 1(733563978)#0112' 6-max (real money) Seat #6 is the button
Seat 1: POKPOKPK9 (19865)
Seat 2: P1xel7 (30587)
Seat 3: Wago7 (13551)
Seat 4: Whynot v (27288)
Seat 5: DUICEETDELOR (41130)
Seat 6: KAZAAR (30238)
*** ANTE/BLINDS ***
POKPOKPK9 posts ante 70
P1xel7 posts ante 70
Wago7 posts ante 70
Whynot v posts ante 70
DUICEETDELOR posts ante 70
KAZAAR posts ante 70
POKPOKPK9 posts small blind 300
P1xel7 posts big blind 600
Dealt to P1xel7 [2h 9h]
*** PRE-FLOP *** 
Wago7 folds
Whynot v calls 600
DUICEETDELOR folds
KAZAAR folds
POKPOKPK9 calls 300
P1xel7 checks
*** FLOP *** [Jd Ks 2s]
POKPOKPK9 bets 600
P1xel7 folds
Whynot v folds
POKPOKPK9 collected 2820 from pot
*** SUMMARY ***
Total pot 2820 | No rake
Board: [Jd Ks 2s]
Seat 1: POKPOKPK9 (small blind) won 2820


Winamax Poker - Tournament "X-MAS FEVER 5 € - DAY 1" buyIn: 4.50€ + 0.50€ level: 7 - HandId: #3150633295033663601-123-1703365912 - Holdem no limit (70/300/600) - 2023/12/23 21:11:52 UTC
Table: 'X-MAS FEVER 5 € - DAY 1(733563978)#0112' 6-max (real money) Seat #1 is the button
Seat 1: POKPOKPK9 (21415)
Seat 2: P1xel7 (29917)
Seat 3: Wago7 (13481)
Seat 4: Whynot v (26618)
Seat 5: DUICEETDELOR (41060)
Seat 6: KAZAAR (30168)
*** ANTE/BLINDS ***
P1xel7 posts ante 70
Wago7 posts ante 70
POKPOKPK9 posts ante 70
Whynot v posts ante 70
DUICEETDELOR posts ante 70
KAZAAR posts ante 70
P1xel7 posts small blind 300
Wago7 posts big blind 600
Dealt to P1xel7 [4s 4h]
*** PRE-FLOP *** 
Whynot v folds
DUICEETDELOR folds
KAZAAR raises 600 to 1200
POKPOKPK9 folds
P1xel7 calls 900
Wago7 calls 600
*** FLOP *** [7d 8h 4d]
P1xel7 checks
Wago7 checks
KAZAAR bets 2774
P1xel7 raises 3397 to 6171
Wago7 folds
KAZAAR raises 22727 to 28898 and is all-in
P1xel7 calls 22476 and is all-in
*** TURN *** [7d 8h 4d][8d]
*** RIVER *** [7d 8h 4d 8d][9c]
*** SHOW DOWN ***
P1xel7 shows [4s 4h] (Full of 4 and 8)
KAZAAR shows [Jd Td] (Flush Jack high)
KAZAAR collected 251 from side pot 1
P1xel7 collected 61314 from main pot
*** SUMMARY ***
Total pot 61565 | No rake
Board: [7d 8h 4d 8d 9c]
Seat 2: P1xel7 (small blind) showed [4s 4h] and won 61314 with Full of 4 and 8
Seat 6: KAZAAR showed [Jd Td] and won 251 with Flush Jack high


Winamax Poker - Tournament "X-MAS FEVER 5 € - DAY 1" buyIn: 4.50€ + 0.50€ level: 7 - HandId: #3150633295033663601-124-1703365999 - Holdem no limit (70/300/600) - 2023/12/23 21:13:19 UTC
Table: 'X-MAS FEVER 5 € - DAY 1(733563978)#0112' 6-max (real money) Seat #2 is the button
Seat 1: POKPOKPK9 (21345)
Seat 2: P1xel7 (61314)
Seat 3: Wago7 (12211)
Seat 4: Whynot v (26548)
Seat 5: DUICEETDELOR (40990)
Seat 6: KAZAAR (251)
*** ANTE/BLINDS ***
Wago7 posts ante 70
Whynot v posts ante 70
POKPOKPK9 posts ante 70
P1xel7 posts ante 70
DUICEETDELOR posts ante 70
KAZAAR posts ante 70
Wago7 posts small blind 300
Whynot v posts big blind 600
Dealt to P1xel7 [9s Kc]
*** PRE-FLOP *** 
DUICEETDELOR raises 600 to 1200
KAZAAR calls 181 and is all-in
POKPOKPK9 raises 20075 to 21275 and is all-in
P1xel7 folds
Wago7 folds
Whynot v folds
DUICEETDELOR folds
*** FLOP *** [Ad 8d 9h]
*** TURN *** [Ad 8d 9h][7h]
*** RIVER *** [Ad 8d 9h 7h][Qc]
*** SHOW DOWN ***
POKPOKPK9 shows [4s 4d] (One pair : 4)
KAZAAR shows [8s Tc] (One pair : 8)
KAZAAR collected 1325 from main pot
POKPOKPK9 collected 22651 from side pot 1
*** SUMMARY ***
Total pot 23976 | No rake
Board: [Ad 8d 9h 7h Qc]
Seat 1: POKPOKPK9 showed [4s 4d] and won 22651 with One pair : 4
Seat 6: KAZAAR showed [8s Tc] and won 1325 with One pair : 8


Winamax Poker - Tournament "X-MAS FEVER 5 € - DAY 1" buyIn: 4.50€ + 0.50€ level: 7 - HandId: #3150633295033663601-125-1703366027 - Holdem no limit (70/300/600) - 2023/12/23 21:13:47 UTC
Table: 'X-MAS FEVER 5 € - DAY 1(733563978)#0112' 6-max (real money) Seat #3 is the button
Seat 1: POKPOKPK9 (22651)
Seat 2: P1xel7 (61244)
Seat 3: Wago7 (11841)
Seat 4: Whynot v (25878)
Seat 5: DUICEETDELOR (39720)
Seat 6: KAZAAR (1325)
*** ANTE/BLINDS ***
Whynot v posts ante 70
DUICEETDELOR posts ante 70
POKPOKPK9 posts ante 70
P1xel7 posts ante 70
Wago7 posts ante 70
KAZAAR posts ante 70
Whynot v posts small blind 300
DUICEETDELOR posts big blind 600
Dealt to P1xel7 [7s Qs]
*** PRE-FLOP *** 
KAZAAR raises 655 to 1255 and is all-in
POKPOKPK9 folds
P1xel7 folds
Wago7 folds
Whynot v calls 955
DUICEETDELOR calls 655
*** FLOP *** [4d 5s As]
Whynot v bets 1465
DUICEETDELOR folds
*** TURN *** [4d 5s As][2c]
*** RIVER *** [4d 5s As 2c][Td]
*** SHOW DOWN ***
KAZAAR shows [Qd 6c] (High card : Ace)
Whynot v shows [Kc 6h] (High card : Ace)
Whynot v collected 5650 from pot
*** SUMMARY ***
Total pot 5650 | No rake
Board: [4d 5s As 2c Td]
Seat 4: Whynot v (small blind) showed [Kc 6h] and won 5650 with High card : Ace
Seat 6: KAZAAR showed [Qd 6c] and lost with High card : Ace


Winamax Poker - Tournament "X-MAS FEVER 5 € - DAY 1" buyIn: 4.50€ + 0.50€ level: 7 - HandId: #3150633295033663601-126-1703366062 - Holdem no limit (70/300/600) - 2023/12/23 21:14:22 UTC
Table: 'X-MAS FEVER 5 € - DAY 1(733563978)#0112' 6-max (real money) Seat #4 is the button
Seat 1: POKPOKPK9 (22581)
Seat 2: P1xel7 (61174)
Seat 3: Wago7 (11771)
Seat 4: Whynot v (28738)
Seat 5: DUICEETDELOR (38395)
*** ANTE/BLINDS ***
DUICEETDELOR posts ante 70
POKPOKPK9 posts ante 70
P1xel7 posts ante 70
Wago7 posts ante 70
Whynot v posts ante 70
DUICEETDELOR posts small blind 300
POKPOKPK9 posts big blind 600
Dealt to P1xel7 [5s Kc]
*** PRE-FLOP *** 
P1xel7 folds
Wago7 folds
Whynot v folds
DUICEETDELOR calls 300
POKPOKPK9 checks
*** FLOP *** [9s 7c Ad]
DUICEETDELOR bets 900
POKPOKPK9 folds
DUICEETDELOR collected 2450 from pot
*** SUMMARY ***
Total pot 2450 | No rake
Board: [9s 7c Ad]
Seat 5: DUICEETDELOR (small blind) won 2450


Winamax Poker - Tournament "X-MAS FEVER 5 € - DAY 1" buyIn: 4.50€ + 0.50€ level: 7 - HandId: #3150633295033663601-127-1703366115 - Holdem no limit (70/300/600) - 2023/12/23 21:15:15 UTC
Table: 'X-MAS FEVER 5 € - DAY 1(733563978)#0112' 6-max (real money) Seat #5 is the button
Seat 1: POKPOKPK9 (21911)
Seat 2: P1xel7 (61104)
Seat 3: Wago7 (11701)
Seat 4: Whynot v (28668)
Seat 5: DUICEETDELOR (39275)
*** ANTE/BLINDS ***
POKPOKPK9 posts ante 70
P1xel7 posts ante 70
Wago7 posts ante 70
Whynot v posts ante 70
DUICEETDELOR posts ante 70
POKPOKPK9 posts small blind 300
P1xel7 posts big blind 600
Dealt to P1xel7 [Kd As]
*** PRE-FLOP *** 
Wago7 folds
Whynot v raises 1850 to 2450
DUICEETDELOR folds
POKPOKPK9 folds
P1xel7 raises 58584 to 61034 and is all-in
Whynot v calls 26148 and is all-in
*** FLOP *** [8c 6d Kc]
*** TURN *** [8c 6d Kc][4d]
*** RIVER *** [8c 6d Kc 4d][6h]
*** SHOW DOWN ***
Whynot v shows [Ac Qc] (One pair : 6)
P1xel7 shows [Kd As] (Two pairs : Kings and 6)
P1xel7 collected 90282 from pot
*** SUMMARY ***
Total pot 90282 | No rake
Board: [8c 6d Kc 4d 6h]
Seat 2: P1xel7 (big blind) showed [Kd As] and won 90282 with Two pairs : Kings and 6
Seat 4: Whynot v showed [Ac Qc] and lost with One pair : 6


Winamax Poker - Tournament "X-MAS FEVER 5 € - DAY 1" buyIn: 4.50€ + 0.50€ level: 7 - HandId: #3150633295033663601-128-1703366165 - Holdem no limit (70/300/600) - 2023/12/23 21:16:05 UTC
Table: 'X-MAS FEVER 5 € - DAY 1(733563978)#0112' 6-max (real money) Seat #1 is the button
Seat 1: POKPOKPK9 (21541)
Seat 2: P1xel7 (90282)
Seat 3: Wago7 (11631)
Seat 5: DUICEETDELOR (39205)
*** ANTE/BLINDS ***
P1xel7 posts ante 70
Wago7 posts ante 70
POKPOKPK9 posts ante 70
DUICEETDELOR posts ante 70
P1xel7 posts small blind 300
Wago7 posts big blind 600
Dealt to P1xel7 [2d Tc]
*** PRE-FLOP *** 
DUICEETDELOR folds
POKPOKPK9 calls 600
P1xel7 folds
Wago7 raises 10961 to 11561 and is all-in
POKPOKPK9 folds
Wago7 collected 12741 from pot
*** SUMMARY ***
Total pot 12741 | No rake
Seat 3: Wago7 (big blind) won 12741


Winamax Poker - Tournament "X-MAS FEVER 5 € - DAY 1" buyIn: 4.50€ + 0.50€ level: 7 - HandId: #3150633295033663601-129-1703366196 - Holdem no limit (70/300/600) - 2023/12/23 21:16:36 UTC
Table: 'X-MAS FEVER 5 € - DAY 1(733563978)#0112' 6-max (real money) Seat #2 is the button
Seat 1: POKPOKPK9 (20871)
Seat 2: P1xel7 (89912)
Seat 3: Wago7 (12741)
Seat 5: DUICEETDELOR (39135)
Seat 6: charmant-468 (20000)
*** ANTE/BLINDS ***
Wago7 posts ante 70
DUICEETDELOR posts ante 70
POKPOKPK9 posts ante 70
P1xel7 posts ante 70
charmant-468 posts ante 70
Wago7 posts small blind 300
DUICEETDELOR posts big blind 600
Dealt to P1xel7 [9c Kh]
*** PRE-FLOP *** 
charmant-468 folds
POKPOKPK9 calls 600
P1xel7 folds
Wago7 folds
DUICEETDELOR raises 1500 to 2100
POKPOKPK9 calls 1500
*** FLOP *** [Kc Ad 5d]
DUICEETDELOR bets 2425
POKPOKPK9 folds
DUICEETDELOR collected 7275 from pot
*** SUMMARY ***
Total pot 7275 | No rake
Board: [Kc Ad 5d]
Seat 5: DUICEETDELOR (big blind) won 7275


Winamax Poker - Tournament "X-MAS FEVER 5 € - DAY 1" buyIn: 4.50€ + 0.50€ level: 7 - HandId: #3150633295033663601-130-1703366281 - Holdem no limit (70/300/600) - 2023/12/23 21:18:01 UTC
Table: 'X-MAS FEVER 5 € - DAY 1(733563978)#0112' 6-max (real money) Seat #3 is the button
Seat 1: POKPOKPK9 (18701)
Seat 2: P1xel7 (89842)
Seat 3: Wago7 (12371)
Seat 4: SheepLeader- (25679)
Seat 5: DUICEETDELOR (41815)
Seat 6: charmant-468 (19930)
*** ANTE/BLINDS ***
DUICEETDELOR posts ante 70
charmant-468 posts ante 70
POKPOKPK9 posts ante 70
P1xel7 posts ante 70
Wago7 posts ante 70
DUICEETDELOR posts small blind 300
charmant-468 posts big blind 600
Dealt to P1xel7 [Qc 9s]
*** PRE-FLOP *** 
POKPOKPK9 raises 600 to 1200
P1xel7 folds
Wago7 raises 11101 to 12301 and is all-in
DUICEETDELOR raises 29444 to 41745 and is all-in
charmant-468 folds
POKPOKPK9 folds
*** FLOP *** [Jc 4c 2h]
*** TURN *** [Jc 4c 2h][2d]
*** RIVER *** [Jc 4c 2h 2d][9h]
*** SHOW DOWN ***
Wago7 shows [8c 8d] (Two pairs : 8 and 2)
DUICEETDELOR shows [Ad Ks] (One pair : 2)
DUICEETDELOR collected 29444 from side pot 1
Wago7 collected 26752 from main pot
*** SUMMARY ***
Total pot 56196 | No rake
Board: [Jc 4c 2h 2d 9h]
Seat 3: Wago7 (button) showed [8c 8d] and won 26752 with Two pairs : 8 and 2
Seat 5: DUICEETDELOR (small blind) showed [Ad Ks] and won 29444 with One pair : 2


Winamax Poker - Tournament "X-MAS FEVER 5 € - DAY 1" buyIn: 4.50€ + 0.50€ level: 8 - HandId: #3150633295033663601-131-1703366355 - Holdem no limit (80/350/700) - 2023/12/23 21:19:15 UTC
Table: 'X-MAS FEVER 5 € - DAY 1(733563978)#0112' 6-max (real money) Seat #5 is the button
Seat 1: POKPOKPK9 (17431)
Seat 2: P1xel7 (89772)
Seat 3: Wago7 (26752)
Seat 4: SheepLeader- (25679)
Seat 5: DUICEETDELOR (29444)
Seat 6: charmant-468 (19260)
*** ANTE/BLINDS ***
charmant-468 posts ante 80
POKPOKPK9 posts ante 80
P1xel7 posts ante 80
Wago7 posts ante 80
SheepLeader- posts ante 80
DUICEETDELOR posts ante 80
charmant-468 posts small blind 350
POKPOKPK9 posts big blind 700
Dealt to P1xel7 [Ks Td]
*** PRE-FLOP *** 
P1xel7 folds
Wago7 raises 1050 to 1750
SheepLeader- folds
DUICEETDELOR folds
charmant-468 calls 1400
POKPOKPK9 calls 1050
*** FLOP *** [5d 3d 8h]
charmant-468 checks
POKPOKPK9 checks
Wago7 bets 3725
charmant-468 calls 3725
POKPOKPK9 calls 3725
*** TURN *** [5d 3d 8h][8s]
charmant-468 checks
POKPOKPK9 checks
Wago7 checks
*** RIVER *** [5d 3d 8h 8s][8d]
charmant-468 bets 13705 and is all-in
POKPOKPK9 calls 11876 and is all-in
Wago7 folds
*** SHOW DOWN ***
POKPOKPK9 shows [9c 5s] (Full of 8 and 5)
charmant-468 shows [2h Ac] (Trips of 8)
charmant-468 collected 1829 from side pot 1
POKPOKPK9 collected 40657 from main pot
*** SUMMARY ***
Total pot 42486 | No rake
Board: [5d 3d 8h 8s 8d]
Seat 1: POKPOKPK9 (big blind) showed [9c 5s] and won 40657 with Full of 8 and 5
Seat 6: charmant-468 (small blind) showed [2h Ac] and won 1829 with Trips of 8


Winamax Poker - Tournament "X-MAS FEVER 5 € - DAY 1" buyIn: 4.50€ + 0.50€ level: 8 - HandId: #3150633295033663601-132-1703366432 - Holdem no limit (80/350/700) - 2023/12/23 21:20:32 UTC
Table: 'X-MAS FEVER 5 € - DAY 1(733563978)#0112' 6-max (real money) Seat #6 is the button
Seat 1: POKPOKPK9 (40657)
Seat 2: P1xel7 (89692)
Seat 3: Wago7 (21197)
Seat 4: SheepLeader- (25599)
Seat 5: DUICEETDELOR (29364)
Seat 6: charmant-468 (1829)
*** ANTE/BLINDS ***
POKPOKPK9 posts ante 80
P1xel7 posts ante 80
Wago7 posts ante 80
SheepLeader- posts ante 80
DUICEETDELOR posts ante 80
charmant-468 posts ante 80
POKPOKPK9 posts small blind 350
P1xel7 posts big blind 700
Dealt to P1xel7 [5c Kc]
*** PRE-FLOP *** 
Wago7 raises 700 to 1400
SheepLeader- folds
DUICEETDELOR folds
charmant-468 raises 349 to 1749 and is all-in
POKPOKPK9 calls 1399
P1xel7 folds
Wago7 calls 349
*** FLOP *** [Js 2s 3s]
POKPOKPK9 checks
Wago7 bets 2249
POKPOKPK9 folds
*** TURN *** [Js 2s 3s][9s]
*** RIVER *** [Js 2s 3s 9s][4h]
*** SHOW DOWN ***
charmant-468 shows [2h Kd] (One pair : 2)
Wago7 shows [8s 7s] (Flush Jack high)
Wago7 collected 8676 from pot
*** SUMMARY ***
Total pot 8676 | No rake
Board: [Js 2s 3s 9s 4h]
Seat 3: Wago7 showed [8s 7s] and won 8676 with Flush Jack high
Seat 6: charmant-468 (button) showed [2h Kd] and lost with One pair : 2


Winamax Poker - Tournament "X-MAS FEVER 5 € - DAY 1" buyIn: 4.50€ + 0.50€ level: 8 - HandId: #3150633295033663601-133-1703366477 - Holdem no limit (80/350/700) - 2023/12/23 21:21:17 UTC
Table: 'X-MAS FEVER 5 € - DAY 1(733563978)#0112' 6-max (real money) Seat #1 is the button
Seat 1: POKPOKPK9 (38828)
Seat 2: P1xel7 (88912)
Seat 3: Wago7 (25795)
Seat 4: SheepLeader- (25519)
Seat 5: DUICEETDELOR (29284)
*** ANTE/BLINDS ***
P1xel7 posts ante 80
Wago7 posts ante 80
POKPOKPK9 posts ante 80
SheepLeader- posts ante 80
DUICEETDELOR posts ante 80
P1xel7 posts small blind 350
Wago7 posts big blind 700
Dealt to P1xel7 [7h 6h]
*** PRE-FLOP *** 
SheepLeader- folds
DUICEETDELOR folds
POKPOKPK9 raises 700 to 1400
P1xel7 folds
Wago7 calls 700
*** FLOP *** [5s Tc Ts]
Wago7 checks
POKPOKPK9 checks
*** TURN *** [5s Tc Ts][4s]
Wago7 checks
POKPOKPK9 bets 1243
Wago7 folds
POKPOKPK9 collected 4793 from pot
*** SUMMARY ***
Total pot 4793 | No rake
Board: [5s Tc Ts 4s]
Seat 1: POKPOKPK9 (button) won 4793


Winamax Poker - Tournament "X-MAS FEVER 5 € - DAY 1" buyIn: 4.50€ + 0.50€ level: 8 - HandId: #3150633295033663601-134-1703366517 - Holdem no limit (80/350/700) - 2023/12/23 21:21:57 UTC
Table: 'X-MAS FEVER 5 € - DAY 1(733563978)#0112' 6-max (real money) Seat #2 is the button
Seat 1: POKPOKPK9 (40898)
Seat 2: P1xel7 (88482)
Seat 3: Wago7 (24315)
Seat 4: SheepLeader- (25439)
Seat 5: DUICEETDELOR (29204)
Seat 6: Dirty Bazaar (14333)
*** ANTE/BLINDS ***
Wago7 posts ante 80
SheepLeader- posts ante 80
POKPOKPK9 posts ante 80
P1xel7 posts ante 80
DUICEETDELOR posts ante 80
Dirty Bazaar posts ante 80
Wago7 posts small blind 350
SheepLeader- posts big blind 700
Dealt to P1xel7 [4c 2h]
*** PRE-FLOP *** 
DUICEETDELOR folds
Dirty Bazaar folds
POKPOKPK9 calls 700
P1xel7 folds
Wago7 folds
SheepLeader- checks
*** FLOP *** [Ad 3s Jc]
SheepLeader- checks
POKPOKPK9 checks
*** TURN *** [Ad 3s Jc][Qc]
SheepLeader- checks
POKPOKPK9 bets 1115
SheepLeader- folds
POKPOKPK9 collected 3345 from pot
*** SUMMARY ***
Total pot 3345 | No rake
Board: [Ad 3s Jc Qc]
Seat 1: POKPOKPK9 won 3345


Winamax Poker - Tournament "X-MAS FEVER 5 € - DAY 1" buyIn: 4.50€ + 0.50€ level: 8 - HandId: #3150633295033663601-135-1703366547 - Holdem no limit (80/350/700) - 2023/12/23 21:22:27 UTC
Table: 'X-MAS FEVER 5 € - DAY 1(733563978)#0112' 6-max (real money) Seat #3 is the button
Seat 1: POKPOKPK9 (42348)
Seat 2: P1xel7 (88402)
Seat 3: Wago7 (23885)
Seat 4: SheepLeader- (24659)
Seat 5: DUICEETDELOR (29124)
Seat 6: Dirty Bazaar (14253)
*** ANTE/BLINDS ***
SheepLeader- posts ante 80
DUICEETDELOR posts ante 80
POKPOKPK9 posts ante 80
P1xel7 posts ante 80
Wago7 posts ante 80
Dirty Bazaar posts ante 80
SheepLeader- posts small blind 350
DUICEETDELOR posts big blind 700
Dealt to P1xel7 [Kh 5h]
*** PRE-FLOP *** 
Dirty Bazaar folds
POKPOKPK9 folds
P1xel7 folds
Wago7 raises 700 to 1400
SheepLeader- folds
DUICEETDELOR calls 700
*** FLOP *** [7c 4c 5d]
DUICEETDELOR checks
Wago7 bets 2360
DUICEETDELOR folds
Wago7 collected 5990 from pot
*** SUMMARY ***
Total pot 5990 | No rake
Board: [7c 4c 5d]
Seat 3: Wago7 (button) won 5990


Winamax Poker - Tournament "X-MAS FEVER 5 € - DAY 1" buyIn: 4.50€ + 0.50€ level: 8 - HandId: #3150633295033663601-136-1703366599 - Holdem no limit (80/350/700) - 2023/12/23 21:23:19 UTC
Table: 'X-MAS FEVER 5 € - DAY 1(733563978)#0112' 6-max (real money) Seat #4 is the button
Seat 1: POKPOKPK9 (42268)
Seat 2: P1xel7 (88322)
Seat 3: Wago7 (26035)
Seat 4: SheepLeader- (24229)
Seat 5: DUICEETDELOR (27644)
Seat 6: Dirty Bazaar (14173)
*** ANTE/BLINDS ***
DUICEETDELOR posts ante 80
Dirty Bazaar posts ante 80
POKPOKPK9 posts ante 80
P1xel7 posts ante 80
Wago7 posts ante 80
SheepLeader- posts ante 80
DUICEETDELOR posts small blind 350
Dirty Bazaar posts big blind 700
Dealt to P1xel7 [2h As]
*** PRE-FLOP *** 
POKPOKPK9 folds
P1xel7 folds
Wago7 folds
SheepLeader- folds
DUICEETDELOR raises 26864 to 27564 and is all-in
Dirty Bazaar folds
DUICEETDELOR collected 28744 from pot
*** SUMMARY ***
Total pot 28744 | No rake
Seat 5: DUICEETDELOR (small blind) won 28744


Winamax Poker - Tournament "X-MAS FEVER 5 € - DAY 1" buyIn: 4.50€ + 0.50€ level: 8 - HandId: #3150633295033663601-137-1703366629 - Holdem no limit (80/350/700) - 2023/12/23 21:23:49 UTC
Table: 'X-MAS FEVER 5 € - DAY 1(733563978)#0112' 6-max (real money) Seat #5 is the button
Seat 1: POKPOKPK9 (42188)
Seat 2: P1xel7 (88242)
Seat 3: Wago7 (25955)
Seat 4: SheepLeader- (24149)
Seat 5: DUICEETDELOR (28744)
Seat 6: Dirty Bazaar (13393)
*** ANTE/BLINDS ***
Dirty Bazaar posts ante 80
POKPOKPK9 posts ante 80
P1xel7 posts ante 80
Wago7 posts ante 80
SheepLeader- posts ante 80
DUICEETDELOR posts ante 80
Dirty Bazaar posts small blind 350
POKPOKPK9 posts big blind 700
Dealt to P1xel7 [As 2s]
*** PRE-FLOP *** 
P1xel7 folds
Wago7 folds
SheepLeader- folds
DUICEETDELOR folds
Dirty Bazaar folds
POKPOKPK9 collected 1530 from pot
*** SUMMARY ***
Total pot 1530 | No rake
Seat 1: POKPOKPK9 (big blind) won 1530


Winamax Poker - Tournament "X-MAS FEVER 5 € - DAY 1" buyIn: 4.50€ + 0.50€ level: 8 - HandId: #3150633295033663601-138-1703366645 - Holdem no limit (80/350/700) - 2023/12/23 21:24:05 UTC
Table: 'X-MAS FEVER 5 € - DAY 1(733563978)#0112' 6-max (real money) Seat #6 is the button
Seat 1: POKPOKPK9 (42938)
Seat 2: P1xel7 (88162)
Seat 3: Wago7 (25875)
Seat 4: SheepLeader- (24069)
Seat 5: DUICEETDELOR (28664)
Seat 6: Dirty Bazaar (12963)
*** ANTE/BLINDS ***
POKPOKPK9 posts ante 80
P1xel7 posts ante 80
Wago7 posts ante 80
SheepLeader- posts ante 80
DUICEETDELOR posts ante 80
Dirty Bazaar posts ante 80
POKPOKPK9 posts small blind 350
P1xel7 posts big blind 700
Dealt to P1xel7 [5h 7h]
*** PRE-FLOP *** 
Wago7 folds
SheepLeader- folds
DUICEETDELOR folds
Dirty Bazaar folds
POKPOKPK9 raises 1400 to 2100
P1xel7 calls 1400
*** FLOP *** [7d 2h As]
POKPOKPK9 checks
P1xel7 bets 1638
POKPOKPK9 calls 1638
*** TURN *** [7d 2h As][Th]
POKPOKPK9 checks
P1xel7 bets 2785
POKPOKPK9 calls 2785
*** RIVER *** [7d 2h As Th][5s]
POKPOKPK9 checks
P1xel7 bets 6763
POKPOKPK9 calls 6763
*** SHOW DOWN ***
POKPOKPK9 shows [Jd Jh] (One pair : Jacks)
P1xel7 shows [5h 7h] (Two pairs : 7 and 5)
P1xel7 collected 27052 from pot
*** SUMMARY ***
Total pot 27052 | No rake
Board: [7d 2h As Th 5s]
Seat 1: POKPOKPK9 (small blind) showed [Jd Jh] and lost with One pair : Jacks
Seat 2: P1xel7 (big blind) showed [5h 7h] and won 27052 with Two pairs : 7 and 5


Winamax Poker - Tournament "X-MAS FEVER 5 € - DAY 1" buyIn: 4.50€ + 0.50€ level: 8 - HandId: #3150633295033663601-139-1703366688 - Holdem no limit (80/350/700) - 2023/12/23 21:24:48 UTC
Table: 'X-MAS FEVER 5 € - DAY 1(733563978)#0112' 6-max (real money) Seat #1 is the button
Seat 1: POKPOKPK9 (29572)
Seat 2: P1xel7 (101848)
Seat 3: Wago7 (25795)
Seat 4: SheepLeader- (23989)
Seat 5: DUICEETDELOR (28584)
Seat 6: Dirty Bazaar (12883)
*** ANTE/BLINDS ***
P1xel7 posts ante 80
Wago7 posts ante 80
POKPOKPK9 posts ante 80
SheepLeader- posts ante 80
DUICEETDELOR posts ante 80
Dirty Bazaar posts ante 80
P1xel7 posts small blind 350
Wago7 posts big blind 700
Dealt to P1xel7 [7s 2c]
*** PRE-FLOP *** 
SheepLeader- folds
DUICEETDELOR folds
Dirty Bazaar folds
POKPOKPK9 folds
P1xel7 folds
Wago7 collected 1530 from pot
*** SUMMARY ***
Total pot 1530 | No rake
Seat 3: Wago7 (big blind) won 1530


Winamax Poker - Tournament "X-MAS FEVER 5 € - DAY 1" buyIn: 4.50€ + 0.50€ level: 8 - HandId: #3150633295033663601-140-1703366725 - Holdem no limit (80/350/700) - 2023/12/23 21:25:25 UTC
Table: 'X-MAS FEVER 5 € - DAY 1(733563978)#0112' 6-max (real money) Seat #2 is the button
Seat 1: POKPOKPK9 (29492)
Seat 2: P1xel7 (101418)
Seat 3: Wago7 (26545)
Seat 4: SheepLeader- (23909)
Seat 5: DUICEETDELOR (28504)
Seat 6: Dirty Bazaar (12803)
*** ANTE/BLINDS ***
Wago7 posts ante 80
SheepLeader- posts ante 80
POKPOKPK9 posts ante 80
P1xel7 posts ante 80
DUICEETDELOR posts ante 80
Dirty Bazaar posts ante 80
Wago7 posts small blind 350
SheepLeader- posts big blind 700
Dealt to P1xel7 [5s 9d]
*** PRE-FLOP *** 
DUICEETDELOR folds
Dirty Bazaar folds
POKPOKPK9 folds
P1xel7 folds
Wago7 calls 350
SheepLeader- checks
*** FLOP *** [7s 5h Kc]
Wago7 checks
SheepLeader- checks
*** TURN *** [7s 5h Kc][Jh]
Wago7 checks
SheepLeader- bets 1241
Wago7 folds
SheepLeader- collected 3121 from pot
*** SUMMARY ***
Total pot 3121 | No rake
Board: [7s 5h Kc Jh]
Seat 4: SheepLeader- (big blind) won 3121


Winamax Poker - Tournament "X-MAS FEVER 5 € - DAY 1" buyIn: 4.50€ + 0.50€ level: 8 - HandId: #3150633295033663601-141-1703366773 - Holdem no limit (80/350/700) - 2023/12/23 21:26:13 UTC
Table: 'X-MAS FEVER 5 € - DAY 1(733563978)#0112' 6-max (real money) Seat #3 is the button
Seat 1: POKPOKPK9 (29412)
Seat 2: P1xel7 (101338)
Seat 3: Wago7 (25765)
Seat 4: SheepLeader- (25009)
Seat 5: DUICEETDELOR (28424)
Seat 6: Dirty Bazaar (12723)
*** ANTE/BLINDS ***
SheepLeader- posts ante 80
DUICEETDELOR posts ante 80
POKPOKPK9 posts ante 80
P1xel7 posts ante 80
Wago7 posts ante 80
Dirty Bazaar posts ante 80
SheepLeader- posts small blind 350
DUICEETDELOR posts big blind 700
Dealt to P1xel7 [Th Jd]
*** PRE-FLOP *** 
Dirty Bazaar folds
POKPOKPK9 raises 875 to 1575
P1xel7 folds
Wago7 folds
SheepLeader- folds
DUICEETDELOR calls 875
*** FLOP *** [2h 4s 4h]
DUICEETDELOR checks
POKPOKPK9 checks
*** TURN *** [2h 4s 4h][Jh]
DUICEETDELOR checks
POKPOKPK9 bets 2587
DUICEETDELOR raises 2587 to 5174
POKPOKPK9 folds
DUICEETDELOR collected 11741 from pot
*** SUMMARY ***
Total pot 11741 | No rake
Board: [2h 4s 4h Jh]
Seat 5: DUICEETDELOR (big blind) won 11741


Winamax Poker - Tournament "X-MAS FEVER 5 € - DAY 1" buyIn: 4.50€ + 0.50€ level: 8 - HandId: #3150633295033663601-142-1703366835 - Holdem no limit (80/350/700) - 2023/12/23 21:27:15 UTC
Table: 'X-MAS FEVER 5 € - DAY 1(733563978)#0112' 6-max (real money) Seat #4 is the button
Seat 1: POKPOKPK9 (25170)
Seat 2: P1xel7 (101258)
Seat 3: Wago7 (25685)
Seat 4: SheepLeader- (24579)
Seat 5: DUICEETDELOR (33336)
Seat 6: Dirty Bazaar (12643)
*** ANTE/BLINDS ***
DUICEETDELOR posts ante 80
Dirty Bazaar posts ante 80
POKPOKPK9 posts ante 80
P1xel7 posts ante 80
Wago7 posts ante 80
SheepLeader- posts ante 80
DUICEETDELOR posts small blind 350
Dirty Bazaar posts big blind 700
Dealt to P1xel7 [4c Qc]
*** PRE-FLOP *** 
POKPOKPK9 calls 700
P1xel7 folds
Wago7 folds
SheepLeader- folds
DUICEETDELOR folds
Dirty Bazaar checks
*** FLOP *** [5s Kd 3c]
Dirty Bazaar checks
POKPOKPK9 bets 1784
Dirty Bazaar folds
POKPOKPK9 collected 4014 from pot
*** SUMMARY ***
Total pot 4014 | No rake
Board: [5s Kd 3c]
Seat 1: POKPOKPK9 won 4014


Winamax Poker - Tournament "X-MAS FEVER 5 € - DAY 1" buyIn: 4.50€ + 0.50€ level: 8 - HandId: #3150633295033663601-143-1703366887 - Holdem no limit (80/350/700) - 2023/12/23 21:28:07 UTC
Table: 'X-MAS FEVER 5 € - DAY 1(733563978)#0112' 6-max (real money) Seat #5 is the button
Seat 1: POKPOKPK9 (26620)
Seat 2: P1xel7 (101178)
Seat 3: Wago7 (25605)
Seat 4: SheepLeader- (24499)
Seat 5: DUICEETDELOR (32906)
Seat 6: Dirty Bazaar (11863)
*** ANTE/BLINDS ***
Dirty Bazaar posts ante 80
POKPOKPK9 posts ante 80
P1xel7 posts ante 80
Wago7 posts ante 80
SheepLeader- posts ante 80
DUICEETDELOR posts ante 80
Dirty Bazaar posts small blind 350
POKPOKPK9 posts big blind 700
Dealt to P1xel7 [Js 7h]
*** PRE-FLOP *** 
P1xel7 folds
Wago7 folds
SheepLeader- folds
DUICEETDELOR folds
Dirty Bazaar raises 11083 to 11783 and is all-in
POKPOKPK9 raises 14757 to 26540 and is all-in
*** FLOP *** [5c 8d 6h]
*** TURN *** [5c 8d 6h][6d]
*** RIVER *** [5c 8d 6h 6d][Ts]
*** SHOW DOWN ***
POKPOKPK9 shows [2s As] (One pair : 6)
Dirty Bazaar shows [7d 8h] (Two pairs : 8 and 6)
Dirty Bazaar collected 24046 from main pot
POKPOKPK9 collected 14757 from side pot 1
*** SUMMARY ***
Total pot 38803 | No rake
Board: [5c 8d 6h 6d Ts]
Seat 1: POKPOKPK9 (big blind) showed [2s As] and won 14757 with One pair : 6
Seat 6: Dirty Bazaar (small blind) showed [7d 8h] and won 24046 with Two pairs : 8 and 6


Winamax Poker - Tournament "X-MAS FEVER 5 € - DAY 1" buyIn: 4.50€ + 0.50€ level: 8 - HandId: #3150633295033663601-144-1703366921 - Holdem no limit (80/350/700) - 2023/12/23 21:28:41 UTC
Table: 'X-MAS FEVER 5 € - DAY 1(733563978)#0112' 6-max (real money) Seat #6 is the button
Seat 1: POKPOKPK9 (14757)
Seat 2: P1xel7 (101098)
Seat 3: Wago7 (25525)
Seat 4: SheepLeader- (24419)
Seat 5: DUICEETDELOR (32826)
Seat 6: Dirty Bazaar (24046)
*** ANTE/BLINDS ***
POKPOKPK9 posts ante 80
P1xel7 posts ante 80
Wago7 posts ante 80
SheepLeader- posts ante 80
DUICEETDELOR posts ante 80
Dirty Bazaar posts ante 80
POKPOKPK9 posts small blind 350
P1xel7 posts big blind 700
Dealt to P1xel7 [6h 7h]
*** PRE-FLOP *** 
Wago7 folds
SheepLeader- folds
DUICEETDELOR folds
Dirty Bazaar raises 875 to 1575
POKPOKPK9 raises 13102 to 14677 and is all-in
P1xel7 folds
Dirty Bazaar folds
POKPOKPK9 collected 17432 from pot
*** SUMMARY ***
Total pot 17432 | No rake
Seat 1: POKPOKPK9 (small blind) won 17432


Winamax Poker - Tournament "X-MAS FEVER 5 € - DAY 1" buyIn: 4.50€ + 0.50€ level: 9 - HandId: #3150633295033663601-145-1703366967 - Holdem no limit (100/400/800) - 2023/12/23 21:29:27 UTC
Table: 'X-MAS FEVER 5 € - DAY 1(733563978)#0112' 6-max (real money) Seat #1 is the button
Seat 1: POKPOKPK9 (17432)
Seat 2: P1xel7 (100318)
Seat 3: Wago7 (25445)
Seat 4: SheepLeader- (24339)
Seat 5: DUICEETDELOR (32746)
Seat 6: Dirty Bazaar (22391)
*** ANTE/BLINDS ***
P1xel7 posts ante 100
Wago7 posts ante 100
POKPOKPK9 posts ante 100
SheepLeader- posts ante 100
DUICEETDELOR posts ante 100
Dirty Bazaar posts ante 100
P1xel7 posts small blind 400
Wago7 posts big blind 800
Dealt to P1xel7 [8d 8c]
*** PRE-FLOP *** 
SheepLeader- raises 944 to 1744
DUICEETDELOR folds
Dirty Bazaar folds
POKPOKPK9 folds
P1xel7 calls 1344
Wago7 folds
*** FLOP *** [Jd 8s 9s]
P1xel7 checks
SheepLeader- checks
*** TURN *** [Jd 8s 9s][Qh]
P1xel7 bets 1711
SheepLeader- folds
P1xel7 collected 6599 from pot
*** SUMMARY ***
Total pot 6599 | No rake
Board: [Jd 8s 9s Qh]
Seat 2: P1xel7 (small blind) won 6599


Winamax Poker - Tournament "X-MAS FEVER 5 € - DAY 1" buyIn: 4.50€ + 0.50€ level: 9 - HandId: #3150633295033663601-146-1703367037 - Holdem no limit (100/400/800) - 2023/12/23 21:30:37 UTC
Table: 'X-MAS FEVER 5 € - DAY 1(733563978)#0112' 6-max (real money) Seat #2 is the button
Seat 1: POKPOKPK9 (17332)
Seat 2: P1xel7 (103362)
Seat 3: Wago7 (24545)
Seat 4: SheepLeader- (22495)
Seat 5: DUICEETDELOR (32646)
Seat 6: Dirty Bazaar (22291)
*** ANTE/BLINDS ***
Wago7 posts ante 100
SheepLeader- posts ante 100
POKPOKPK9 posts ante 100
P1xel7 posts ante 100
DUICEETDELOR posts ante 100
Dirty Bazaar posts ante 100
Wago7 posts small blind 400
SheepLeader- posts big blind 800
Dealt to P1xel7 [8h 4h]
*** PRE-FLOP *** 
DUICEETDELOR folds
Dirty Bazaar folds
POKPOKPK9 raises 800 to 1600
P1xel7 folds
Wago7 folds
SheepLeader- calls 800
*** FLOP *** [Ks 3h 6h]
SheepLeader- checks
POKPOKPK9 bets 1470
SheepLeader- folds
POKPOKPK9 collected 5670 from pot
*** SUMMARY ***
Total pot 5670 | No rake
Board: [Ks 3h 6h]
Seat 1: POKPOKPK9 won 5670


Winamax Poker - Tournament "X-MAS FEVER 5 € - DAY 1" buyIn: 4.50€ + 0.50€ level: 9 - HandId: #3150633295033663601-147-1703367088 - Holdem no limit (100/400/800) - 2023/12/23 21:31:28 UTC
Table: 'X-MAS FEVER 5 € - DAY 1(733563978)#0112' 6-max (real money) Seat #3 is the button
Seat 1: POKPOKPK9 (19832)
Seat 2: P1xel7 (103262)
Seat 3: Wago7 (24045)
Seat 4: SheepLeader- (20795)
Seat 5: DUICEETDELOR (32546)
Seat 6: Dirty Bazaar (22191)
*** ANTE/BLINDS ***
SheepLeader- posts ante 100
DUICEETDELOR posts ante 100
POKPOKPK9 posts ante 100
P1xel7 posts ante 100
Wago7 posts ante 100
Dirty Bazaar posts ante 100
SheepLeader- posts small blind 400
DUICEETDELOR posts big blind 800
Dealt to P1xel7 [Td 4d]
*** PRE-FLOP *** 
Dirty Bazaar folds
POKPOKPK9 calls 800
P1xel7 folds
Wago7 folds
SheepLeader- folds
DUICEETDELOR checks
*** FLOP *** [6d 4c 9h]
DUICEETDELOR checks
POKPOKPK9 checks
*** TURN *** [6d 4c 9h][Js]
DUICEETDELOR checks
POKPOKPK9 bets 800
DUICEETDELOR folds
POKPOKPK9 collected 3400 from pot
*** SUMMARY ***
Total pot 3400 | No rake
Board: [6d 4c 9h Js]
Seat 1: POKPOKPK9 won 3400


Winamax Poker - Tournament "X-MAS FEVER 5 € - DAY 1" buyIn: 4.50€ + 0.50€ level: 9 - HandId: #3150633295033663601-148-1703367148 - Holdem no limit (100/400/800) - 2023/12/23 21:32:28 UTC
Table: 'X-MAS FEVER 5 € - DAY 1(733563978)#0112' 6-max (real money) Seat #4 is the button
Seat 1: POKPOKPK9 (21532)
Seat 2: P1xel7 (103162)
Seat 3: Wago7 (23945)
Seat 4: SheepLeader- (20295)
Seat 5: DUICEETDELOR (31646)
Seat 6: Dirty Bazaar (22091)
*** ANTE/BLINDS ***
DUICEETDELOR posts ante 100
Dirty Bazaar posts ante 100
POKPOKPK9 posts ante 100
P1xel7 posts ante 100
Wago7 posts ante 100
SheepLeader- posts ante 100
DUICEETDELOR posts small blind 400
Dirty Bazaar posts big blind 800
Dealt to P1xel7 [7h 2s]
*** PRE-FLOP *** 
POKPOKPK9 folds
P1xel7 folds
Wago7 folds
SheepLeader- raises 800 to 1600
DUICEETDELOR folds
Dirty Bazaar folds
SheepLeader- collected 3400 from pot
*** SUMMARY ***
Total pot 3400 | No rake
Seat 4: SheepLeader- (button) won 3400


Winamax Poker - Tournament "X-MAS FEVER 5 € - DAY 1" buyIn: 4.50€ + 0.50€ level: 9 - HandId: #3150633295033663601-149-1703367171 - Holdem no limit (100/400/800) - 2023/12/23 21:32:51 UTC
Table: 'X-MAS FEVER 5 € - DAY 1(733563978)#0112' 6-max (real money) Seat #5 is the button
Seat 1: POKPOKPK9 (21432)
Seat 2: P1xel7 (103062)
Seat 3: Wago7 (23845)
Seat 4: SheepLeader- (21995)
Seat 5: DUICEETDELOR (31146)
Seat 6: Dirty Bazaar (21191)
*** ANTE/BLINDS ***
Dirty Bazaar posts ante 100
POKPOKPK9 posts ante 100
P1xel7 posts ante 100
Wago7 posts ante 100
SheepLeader- posts ante 100
DUICEETDELOR posts ante 100
Dirty Bazaar posts small blind 400
POKPOKPK9 posts big blind 800
Dealt to P1xel7 [Ks 2c]
*** PRE-FLOP *** 
P1xel7 folds
Wago7 raises 800 to 1600
SheepLeader- folds
DUICEETDELOR folds
Dirty Bazaar folds
POKPOKPK9 folds
Wago7 collected 3400 from pot
*** SUMMARY ***
Total pot 3400 | No rake
Seat 3: Wago7 won 3400


Winamax Poker - Tournament "X-MAS FEVER 5 € - DAY 1" buyIn: 4.50€ + 0.50€ level: 9 - HandId: #3150633295033663601-150-1703367233 - Holdem no limit (100/400/800) - 2023/12/23 21:33:53 UTC
Table: 'X-MAS FEVER 5 € - DAY 1(733563978)#0112' 6-max (real money) Seat #6 is the button
Seat 1: POKPOKPK9 (20532)
Seat 2: P1xel7 (102962)
Seat 3: Wago7 (25545)
Seat 4: SheepLeader- (21895)
Seat 5: DUICEETDELOR (31046)
Seat 6: Dirty Bazaar (20691)
*** ANTE/BLINDS ***
POKPOKPK9 posts ante 100
P1xel7 posts ante 100
Wago7 posts ante 100
SheepLeader- posts ante 100
DUICEETDELOR posts ante 100
Dirty Bazaar posts ante 100
POKPOKPK9 posts small blind 400
P1xel7 posts big blind 800
Dealt to P1xel7 [2s Jh]
*** PRE-FLOP *** 
Wago7 folds
SheepLeader- raises 800 to 1600
DUICEETDELOR folds
Dirty Bazaar raises 18991 to 20591 and is all-in
POKPOKPK9 folds
P1xel7 folds
SheepLeader- folds
Dirty Bazaar collected 23991 from pot
*** SUMMARY ***
Total pot 23991 | No rake
Seat 6: Dirty Bazaar (button) won 23991


Winamax Poker - Tournament "X-MAS FEVER 5 € - DAY 1" buyIn: 4.50€ + 0.50€ level: 9 - HandId: #3150633295033663601-151-1703367267 - Holdem no limit (100/400/800) - 2023/12/23 21:34:27 UTC
Table: 'X-MAS FEVER 5 € - DAY 1(733563978)#0112' 6-max (real money) Seat #1 is the button
Seat 1: POKPOKPK9 (20032)
Seat 2: P1xel7 (102062)
Seat 3: Wago7 (25445)
Seat 4: SheepLeader- (20195)
Seat 5: DUICEETDELOR (30946)
Seat 6: Dirty Bazaar (23991)
*** ANTE/BLINDS ***
P1xel7 posts ante 100
Wago7 posts ante 100
POKPOKPK9 posts ante 100
SheepLeader- posts ante 100
DUICEETDELOR posts ante 100
Dirty Bazaar posts ante 100
P1xel7 posts small blind 400
Wago7 posts big blind 800
Dealt to P1xel7 [Tc Jh]
*** PRE-FLOP *** 
SheepLeader- raises 800 to 1600
DUICEETDELOR folds
Dirty Bazaar folds
POKPOKPK9 calls 1600
P1xel7 folds
Wago7 calls 800
*** FLOP *** [8c Qc 5s]
Wago7 checks
SheepLeader- checks
POKPOKPK9 checks
*** TURN *** [8c Qc 5s][Ad]
Wago7 checks
SheepLeader- checks
POKPOKPK9 checks
*** RIVER *** [8c Qc 5s Ad][4d]
Wago7 bets 3770
SheepLeader- folds
POKPOKPK9 folds
Wago7 collected 9570 from pot
*** SUMMARY ***
Total pot 9570 | No rake
Board: [8c Qc 5s Ad 4d]
Seat 3: Wago7 (big blind) won 9570


Winamax Poker - Tournament "X-MAS FEVER 5 € - DAY 1" buyIn: 4.50€ + 0.50€ level: 9 - HandId: #3150633295033663601-152-1703367333 - Holdem no limit (100/400/800) - 2023/12/23 21:35:33 UTC
Table: 'X-MAS FEVER 5 € - DAY 1(733563978)#0112' 6-max (real money) Seat #2 is the button
Seat 1: POKPOKPK9 (18332)
Seat 2: P1xel7 (101562)
Seat 3: Wago7 (29545)
Seat 4: SheepLeader- (18495)
Seat 5: DUICEETDELOR (30846)
Seat 6: Dirty Bazaar (23891)
*** ANTE/BLINDS ***
Wago7 posts ante 100
SheepLeader- posts ante 100
POKPOKPK9 posts ante 100
P1xel7 posts ante 100
DUICEETDELOR posts ante 100
Dirty Bazaar posts ante 100
Wago7 posts small blind 400
SheepLeader- posts big blind 800
Dealt to P1xel7 [3s 8h]
*** PRE-FLOP *** 
DUICEETDELOR folds
Dirty Bazaar raises 1000 to 1800
POKPOKPK9 calls 1800
P1xel7 folds
Wago7 folds
SheepLeader- calls 1000
*** FLOP *** [2d 7h Qs]
SheepLeader- checks
Dirty Bazaar checks
POKPOKPK9 checks
*** TURN *** [2d 7h Qs][Ah]
SheepLeader- checks
Dirty Bazaar checks
POKPOKPK9 checks
*** RIVER *** [2d 7h Qs Ah][3d]
SheepLeader- bets 9600
Dirty Bazaar folds
POKPOKPK9 folds
SheepLeader- collected 16000 from pot
*** SUMMARY ***
Total pot 16000 | No rake
Board: [2d 7h Qs Ah 3d]
Seat 4: SheepLeader- (big blind) won 16000


Winamax Poker - Tournament "X-MAS FEVER 5 € - DAY 1" buyIn: 4.50€ + 0.50€ level: 9 - HandId: #3150633295033663601-153-1703367442 - Holdem no limit (100/400/800) - 2023/12/23 21:37:22 UTC
Table: 'X-MAS FEVER 5 € - DAY 1(733563978)#0112' 6-max (real money) Seat #3 is the button
Seat 1: POKPOKPK9 (16432)
Seat 2: P1xel7 (101462)
Seat 3: Wago7 (29045)
Seat 4: SheepLeader- (22995)
Seat 5: DUICEETDELOR (30746)
Seat 6: Dirty Bazaar (21991)
*** ANTE/BLINDS ***
SheepLeader- posts ante 100
DUICEETDELOR posts ante 100
POKPOKPK9 posts ante 100
P1xel7 posts ante 100
Wago7 posts ante 100
Dirty Bazaar posts ante 100
SheepLeader- posts small blind 400
DUICEETDELOR posts big blind 800
Dealt to P1xel7 [3h Ks]
*** PRE-FLOP *** 
Dirty Bazaar folds
POKPOKPK9 folds
P1xel7 folds
Wago7 raises 800 to 1600
SheepLeader- folds
DUICEETDELOR folds
Wago7 collected 3400 from pot
*** SUMMARY ***
Total pot 3400 | No rake
Seat 3: Wago7 (button) won 3400


Winamax Poker - Tournament "X-MAS FEVER 5 € - DAY 1" buyIn: 4.50€ + 0.50€ level: 9 - HandId: #3150633295033663601-154-1703367482 - Holdem no limit (100/400/800) - 2023/12/23 21:38:02 UTC
Table: 'X-MAS FEVER 5 € - DAY 1(733563978)#0112' 6-max (real money) Seat #4 is the button
Seat 1: POKPOKPK9 (16332)
Seat 2: P1xel7 (101362)
Seat 3: Wago7 (30745)
Seat 4: SheepLeader- (22495)
Seat 5: DUICEETDELOR (29846)
Seat 6: Dirty Bazaar (21891)
*** ANTE/BLINDS ***
DUICEETDELOR posts ante 100
Dirty Bazaar posts ante 100
POKPOKPK9 posts ante 100
P1xel7 posts ante 100
Wago7 posts ante 100
SheepLeader- posts ante 100
DUICEETDELOR posts small blind 400
Dirty Bazaar posts big blind 800
Dealt to P1xel7 [9h Tc]
*** PRE-FLOP *** 
POKPOKPK9 folds
P1xel7 folds
Wago7 folds
SheepLeader- raises 800 to 1600
DUICEETDELOR folds
Dirty Bazaar folds
SheepLeader- collected 3400 from pot
*** SUMMARY ***
Total pot 3400 | No rake
Seat 4: SheepLeader- (button) won 3400


Winamax Poker - Tournament "X-MAS FEVER 5 € - DAY 1" buyIn: 4.50€ + 0.50€ level: 9 - HandId: #3150633295033663601-155-1703367532 - Holdem no limit (100/400/800) - 2023/12/23 21:38:52 UTC
Table: 'X-MAS FEVER 5 € - DAY 1(733563978)#0112' 6-max (real money) Seat #5 is the button
Seat 1: POKPOKPK9 (16232)
Seat 2: P1xel7 (101262)
Seat 3: Wago7 (30645)
Seat 4: SheepLeader- (24195)
Seat 5: DUICEETDELOR (29346)
Seat 6: Dirty Bazaar (20991)
*** ANTE/BLINDS ***
Dirty Bazaar posts ante 100
POKPOKPK9 posts ante 100
P1xel7 posts ante 100
Wago7 posts ante 100
SheepLeader- posts ante 100
DUICEETDELOR posts ante 100
Dirty Bazaar posts small blind 400
POKPOKPK9 posts big blind 800
Dealt to P1xel7 [Js 8c]
*** PRE-FLOP *** 
P1xel7 folds
Wago7 folds
SheepLeader- folds
DUICEETDELOR folds
Dirty Bazaar raises 1000 to 1800
POKPOKPK9 calls 1000
*** FLOP *** [5d 8s 6s]
Dirty Bazaar checks
POKPOKPK9 checks
*** TURN *** [5d 8s 6s][2d]
Dirty Bazaar checks
POKPOKPK9 checks
*** RIVER *** [5d 8s 6s 2d][Kc]
Dirty Bazaar bets 2100
POKPOKPK9 folds
Dirty Bazaar collected 6300 from pot
*** SUMMARY ***
Total pot 6300 | No rake
Board: [5d 8s 6s 2d Kc]
Seat 6: Dirty Bazaar (small blind) won 6300


Winamax Poker - Tournament "X-MAS FEVER 5 € - DAY 1" buyIn: 4.50€ + 0.50€ level: 9 - HandId: #3150633295033663601-156-1703367590 - Holdem no limit (100/400/800) - 2023/12/23 21:39:50 UTC
Table: 'X-MAS FEVER 5 € - DAY 1(733563978)#0112' 6-max (real money) Seat #6 is the button
Seat 1: POKPOKPK9 (14332)
Seat 2: P1xel7 (101162)
Seat 3: Wago7 (30545)
Seat 4: SheepLeader- (24095)
Seat 5: DUICEETDELOR (29246)
Seat 6: Dirty Bazaar (23291)
*** ANTE/BLINDS ***
POKPOKPK9 posts ante 100
P1xel7 posts ante 100
Wago7 posts ante 100
SheepLeader- posts ante 100
DUICEETDELOR posts ante 100
Dirty Bazaar posts ante 100
POKPOKPK9 posts small blind 400
P1xel7 posts big blind 800
Dealt to P1xel7 [Jh 9s]
*** PRE-FLOP *** 
Wago7 folds
SheepLeader- raises 800 to 1600
DUICEETDELOR folds
Dirty Bazaar folds
POKPOKPK9 raises 12632 to 14232 and is all-in
P1xel7 folds
SheepLeader- folds
POKPOKPK9 collected 17232 from pot
*** SUMMARY ***
Total pot 17232 | No rake
Seat 1: POKPOKPK9 (small blind) won 17232


Winamax Poker - Tournament "X-MAS FEVER 5 € - DAY 1" buyIn: 4.50€ + 0.50€ level: 10 - HandId: #3150633295033663601-157-1703367640 - Holdem no limit (120/500/1000) - 2023/12/23 21:40:40 UTC
Table: 'X-MAS FEVER 5 € - DAY 1(733563978)#0112' 6-max (real money) Seat #1 is the button
Seat 1: POKPOKPK9 (17232)
Seat 2: P1xel7 (100262)
Seat 3: Wago7 (30445)
Seat 4: SheepLeader- (22395)
Seat 5: DUICEETDELOR (29146)
Seat 6: Dirty Bazaar (23191)
*** ANTE/BLINDS ***
P1xel7 posts ante 120
Wago7 posts ante 120
POKPOKPK9 posts ante 120
SheepLeader- posts ante 120
DUICEETDELOR posts ante 120
Dirty Bazaar posts ante 120
P1xel7 posts small blind 500
Wago7 posts big blind 1000
Dealt to P1xel7 [2s 4c]
*** PRE-FLOP *** 
SheepLeader- folds
DUICEETDELOR folds
Dirty Bazaar folds
POKPOKPK9 raises 16112 to 17112 and is all-in
P1xel7 folds
Wago7 folds
POKPOKPK9 collected 19332 from pot
*** SUMMARY ***
Total pot 19332 | No rake
Seat 1: POKPOKPK9 (button) won 19332


Winamax Poker - Tournament "X-MAS FEVER 5 € - DAY 1" buyIn: 4.50€ + 0.50€ level: 10 - HandId: #3150633295033663601-158-1703367661 - Holdem no limit (120/500/1000) - 2023/12/23 21:41:01 UTC
Table: 'X-MAS FEVER 5 € - DAY 1(733563978)#0112' 6-max (real money) Seat #2 is the button
Seat 1: POKPOKPK9 (19332)
Seat 2: P1xel7 (99642)
Seat 3: Wago7 (29325)
Seat 4: SheepLeader- (22275)
Seat 5: DUICEETDELOR (29026)
Seat 6: Dirty Bazaar (23071)
*** ANTE/BLINDS ***
Wago7 posts ante 120
SheepLeader- posts ante 120
POKPOKPK9 posts ante 120
P1xel7 posts ante 120
DUICEETDELOR posts ante 120
Dirty Bazaar posts ante 120
Wago7 posts small blind 500
SheepLeader- posts big blind 1000
Dealt to P1xel7 [As Ks]
*** PRE-FLOP *** 
DUICEETDELOR folds
Dirty Bazaar folds
POKPOKPK9 raises 18212 to 19212 and is all-in
P1xel7 calls 19212
Wago7 folds
SheepLeader- folds
*** FLOP *** [9h 6h 7d]
*** TURN *** [9h 6h 7d][7s]
*** RIVER *** [9h 6h 7d 7s][9s]
*** SHOW DOWN ***
P1xel7 shows [As Ks] (Two pairs : 9 and 7)
POKPOKPK9 shows [6s 6d] (Full of 6 and 9)
POKPOKPK9 collected 40644 from pot
*** SUMMARY ***
Total pot 40644 | No rake
Board: [9h 6h 7d 7s 9s]
Seat 1: POKPOKPK9 showed [6s 6d] and won 40644 with Full of 6 and 9
Seat 2: P1xel7 (button) showed [As Ks] and lost with Two pairs : 9 and 7


Winamax Poker - Tournament "X-MAS FEVER 5 € - DAY 1" buyIn: 4.50€ + 0.50€ level: 10 - HandId: #3150633295033663601-159-1703367688 - Holdem no limit (120/500/1000) - 2023/12/23 21:41:28 UTC
Table: 'X-MAS FEVER 5 € - DAY 1(733563978)#0112' 6-max (real money) Seat #3 is the button
Seat 1: POKPOKPK9 (40644)
Seat 2: P1xel7 (80310)
Seat 3: Wago7 (28705)
Seat 4: SheepLeader- (21155)
Seat 5: DUICEETDELOR (28906)
Seat 6: Dirty Bazaar (22951)
*** ANTE/BLINDS ***
SheepLeader- posts ante 120
DUICEETDELOR posts ante 120
POKPOKPK9 posts ante 120
P1xel7 posts ante 120
Wago7 posts ante 120
Dirty Bazaar posts ante 120
SheepLeader- posts small blind 500
DUICEETDELOR posts big blind 1000
Dealt to P1xel7 [4d Qs]
*** PRE-FLOP *** 
Dirty Bazaar folds
POKPOKPK9 calls 1000
P1xel7 folds
Wago7 raises 2500 to 3500
SheepLeader- folds
DUICEETDELOR folds
POKPOKPK9 raises 6125 to 9625
Wago7 folds
POKPOKPK9 collected 15345 from pot
*** SUMMARY ***
Total pot 15345 | No rake
Seat 1: POKPOKPK9 won 15345


Winamax Poker - Tournament "X-MAS FEVER 5 € - DAY 1" buyIn: 4.50€ + 0.50€ level: 10 - HandId: #3150633295033663601-160-1703367750 - Holdem no limit (120/500/1000) - 2023/12/23 21:42:30 UTC
Table: 'X-MAS FEVER 5 € - DAY 1(733563978)#0112' 6-max (real money) Seat #4 is the button
Seat 1: POKPOKPK9 (46244)
Seat 2: P1xel7 (80190)
Seat 3: Wago7 (25085)
Seat 4: SheepLeader- (20535)
Seat 5: DUICEETDELOR (27786)
Seat 6: Dirty Bazaar (22831)
*** ANTE/BLINDS ***
DUICEETDELOR posts ante 120
Dirty Bazaar posts ante 120
POKPOKPK9 posts ante 120
P1xel7 posts ante 120
Wago7 posts ante 120
SheepLeader- posts ante 120
DUICEETDELOR posts small blind 500
Dirty Bazaar posts big blind 1000
Dealt to P1xel7 [Js 9c]
*** PRE-FLOP *** 
POKPOKPK9 folds
P1xel7 folds
Wago7 folds
SheepLeader- raises 1000 to 2000
DUICEETDELOR folds
Dirty Bazaar folds
SheepLeader- collected 4220 from pot
*** SUMMARY ***
Total pot 4220 | No rake
Seat 4: SheepLeader- (button) won 4220


Winamax Poker - Tournament "X-MAS FEVER 5 € - DAY 1" buyIn: 4.50€ + 0.50€ level: 10 - HandId: #3150633295033663601-161-1703367784 - Holdem no limit (120/500/1000) - 2023/12/23 21:43:04 UTC
Table: 'X-MAS FEVER 5 € - DAY 1(733563978)#0112' 6-max (real money) Seat #5 is the button
Seat 1: POKPOKPK9 (46124)
Seat 2: P1xel7 (80070)
Seat 3: Wago7 (24965)
Seat 4: SheepLeader- (22635)
Seat 5: DUICEETDELOR (27166)
Seat 6: Dirty Bazaar (21711)
*** ANTE/BLINDS ***
Dirty Bazaar posts ante 120
POKPOKPK9 posts ante 120
P1xel7 posts ante 120
Wago7 posts ante 120
SheepLeader- posts ante 120
DUICEETDELOR posts ante 120
Dirty Bazaar posts small blind 500
POKPOKPK9 posts big blind 1000
Dealt to P1xel7 [4c Kd]
*** PRE-FLOP *** 
P1xel7 folds
Wago7 folds
SheepLeader- folds
DUICEETDELOR raises 1000 to 2000
Dirty Bazaar folds
POKPOKPK9 calls 1000
*** FLOP *** [Qh Ah 4s]
POKPOKPK9 checks
DUICEETDELOR checks
*** TURN *** [Qh Ah 4s][6c]
POKPOKPK9 checks
DUICEETDELOR bets 2500
POKPOKPK9 folds
DUICEETDELOR collected 7720 from pot
*** SUMMARY ***
Total pot 7720 | No rake
Board: [Qh Ah 4s 6c]
Seat 5: DUICEETDELOR (button) won 7720


Winamax Poker - Tournament "X-MAS FEVER 5 € - DAY 1" buyIn: 4.50€ + 0.50€ level: 10 - HandId: #3150633295033663601-162-1703367844 - Holdem no limit (120/500/1000) - 2023/12/23 21:44:04 UTC
Table: 'X-MAS FEVER 5 € - DAY 1(733563978)#0112' 6-max (real money) Seat #6 is the button
Seat 1: POKPOKPK9 (44004)
Seat 2: P1xel7 (79950)
Seat 3: Wago7 (24845)
Seat 4: SheepLeader- (22515)
Seat 5: DUICEETDELOR (30266)
Seat 6: Dirty Bazaar (21091)
*** ANTE/BLINDS ***
POKPOKPK9 posts ante 120
P1xel7 posts ante 120
Wago7 posts ante 120
SheepLeader- posts ante 120
DUICEETDELOR posts ante 120
Dirty Bazaar posts ante 120
POKPOKPK9 posts small blind 500
P1xel7 posts big blind 1000
Dealt to P1xel7 [9d 8d]
*** PRE-FLOP *** 
Wago7 raises 1000 to 2000
SheepLeader- folds
DUICEETDELOR folds
Dirty Bazaar folds
POKPOKPK9 calls 1500
P1xel7 calls 1000
*** FLOP *** [4d Jh 6c]
POKPOKPK9 checks
P1xel7 checks
Wago7 bets 2352
POKPOKPK9 folds
P1xel7 calls 2352
*** TURN *** [4d Jh 6c][Jd]
P1xel7 checks
Wago7 checks
*** RIVER *** [4d Jh 6c Jd][Kh]
P1xel7 bets 7426
Wago7 folds
P1xel7 collected 18850 from pot
*** SUMMARY ***
Total pot 18850 | No rake
Board: [4d Jh 6c Jd Kh]
Seat 2: P1xel7 (big blind) won 18850


Winamax Poker - Tournament "X-MAS FEVER 5 € - DAY 1" buyIn: 4.50€ + 0.50€ level: 10 - HandId: #3150633295033663601-163-1703367907 - Holdem no limit (120/500/1000) - 2023/12/23 21:45:07 UTC
Table: 'X-MAS FEVER 5 € - DAY 1(733563978)#0112' 6-max (real money) Seat #1 is the button
Seat 1: POKPOKPK9 (41884)
Seat 2: P1xel7 (86902)
Seat 3: Wago7 (20373)
Seat 4: SheepLeader- (22395)
Seat 5: DUICEETDELOR (30146)
Seat 6: Dirty Bazaar (20971)
*** ANTE/BLINDS ***
P1xel7 posts ante 120
Wago7 posts ante 120
POKPOKPK9 posts ante 120
SheepLeader- posts ante 120
DUICEETDELOR posts ante 120
Dirty Bazaar posts ante 120
P1xel7 posts small blind 500
Wago7 posts big blind 1000
Dealt to P1xel7 [4s As]
*** PRE-FLOP *** 
SheepLeader- raises 1000 to 2000
DUICEETDELOR raises 5500 to 7500
Dirty Bazaar folds
POKPOKPK9 folds
P1xel7 folds
Wago7 folds
SheepLeader- folds
DUICEETDELOR collected 11720 from pot
*** SUMMARY ***
Total pot 11720 | No rake
Seat 5: DUICEETDELOR won 11720


Winamax Poker - Tournament "X-MAS FEVER 5 € - DAY 1" buyIn: 4.50€ + 0.50€ level: 10 - HandId: #3150633295033663601-164-1703367932 - Holdem no limit (120/500/1000) - 2023/12/23 21:45:32 UTC
Table: 'X-MAS FEVER 5 € - DAY 1(733563978)#0112' 6-max (real money) Seat #2 is the button
Seat 1: POKPOKPK9 (41764)
Seat 2: P1xel7 (86282)
Seat 3: Wago7 (19253)
Seat 4: SheepLeader- (20275)
Seat 5: DUICEETDELOR (34246)
Seat 6: Dirty Bazaar (20851)
*** ANTE/BLINDS ***
Wago7 posts ante 120
SheepLeader- posts ante 120
POKPOKPK9 posts ante 120
P1xel7 posts ante 120
DUICEETDELOR posts ante 120
Dirty Bazaar posts ante 120
Wago7 posts small blind 500
SheepLeader- posts big blind 1000
Dealt to P1xel7 [7h 6c]
*** PRE-FLOP *** 
DUICEETDELOR folds
Dirty Bazaar folds
POKPOKPK9 raises 1000 to 2000
P1xel7 folds
Wago7 raises 17133 to 19133 and is all-in
SheepLeader- folds
POKPOKPK9 folds
Wago7 collected 22853 from pot
*** SUMMARY ***
Total pot 22853 | No rake
Seat 3: Wago7 (small blind) won 22853


Winamax Poker - Tournament "X-MAS FEVER 5 € - DAY 1" buyIn: 4.50€ + 0.50€ level: 10 - HandId: #3150633295033663601-165-1703367979 - Holdem no limit (120/500/1000) - 2023/12/23 21:46:19 UTC
Table: 'X-MAS FEVER 5 € - DAY 1(733563978)#0112' 6-max (real money) Seat #3 is the button
Seat 1: POKPOKPK9 (39644)
Seat 2: P1xel7 (86162)
Seat 3: Wago7 (22853)
Seat 4: SheepLeader- (19155)
Seat 5: DUICEETDELOR (34126)
Seat 6: Dirty Bazaar (20731)
*** ANTE/BLINDS ***
SheepLeader- posts ante 120
DUICEETDELOR posts ante 120
POKPOKPK9 posts ante 120
P1xel7 posts ante 120
Wago7 posts ante 120
Dirty Bazaar posts ante 120
SheepLeader- posts small blind 500
DUICEETDELOR posts big blind 1000
Dealt to P1xel7 [5s 4d]
*** PRE-FLOP *** 
Dirty Bazaar raises 1500 to 2500
POKPOKPK9 calls 2500
P1xel7 folds
Wago7 folds
SheepLeader- folds
DUICEETDELOR calls 1500
*** FLOP *** [Jh 2h 7d]
DUICEETDELOR checks
Dirty Bazaar bets 3052
POKPOKPK9 calls 3052
DUICEETDELOR calls 3052
*** TURN *** [Jh 2h 7d][Td]
DUICEETDELOR checks
Dirty Bazaar bets 15059 and is all-in
POKPOKPK9 raises 18913 to 33972 and is all-in
DUICEETDELOR folds
*** RIVER *** [Jh 2h 7d Td][9s]
*** SHOW DOWN ***
POKPOKPK9 shows [Js As] (One pair : Jacks)
Dirty Bazaar shows [Kc Kd] (One pair : Kings)
Dirty Bazaar collected 47994 from main pot
POKPOKPK9 collected 18913 from side pot 1
*** SUMMARY ***
Total pot 66907 | No rake
Board: [Jh 2h 7d Td 9s]
Seat 1: POKPOKPK9 showed [Js As] and won 18913 with One pair : Jacks
Seat 6: Dirty Bazaar showed [Kc Kd] and won 47994 with One pair : Kings


Winamax Poker - Tournament "X-MAS FEVER 5 € - DAY 1" buyIn: 4.50€ + 0.50€ level: 10 - HandId: #3150633295033663601-166-1703368040 - Holdem no limit (120/500/1000) - 2023/12/23 21:47:20 UTC
Table: 'X-MAS FEVER 5 € - DAY 1(733563978)#0112' 6-max (real money) Seat #4 is the button
Seat 1: POKPOKPK9 (18913)
Seat 2: P1xel7 (86042)
Seat 3: Wago7 (22733)
Seat 4: SheepLeader- (18535)
Seat 5: DUICEETDELOR (28454)
Seat 6: Dirty Bazaar (47994)
*** ANTE/BLINDS ***
DUICEETDELOR posts ante 120
Dirty Bazaar posts ante 120
POKPOKPK9 posts ante 120
P1xel7 posts ante 120
Wago7 posts ante 120
SheepLeader- posts ante 120
DUICEETDELOR posts small blind 500
Dirty Bazaar posts big blind 1000
Dealt to P1xel7 [8c 9d]
*** PRE-FLOP *** 
POKPOKPK9 raises 17793 to 18793 and is all-in
P1xel7 folds
Wago7 folds
SheepLeader- folds
DUICEETDELOR folds
Dirty Bazaar folds
POKPOKPK9 collected 21013 from pot
*** SUMMARY ***
Total pot 21013 | No rake
Seat 1: POKPOKPK9 won 21013


Winamax Poker - Tournament "X-MAS FEVER 5 € - DAY 1" buyIn: 4.50€ + 0.50€ level: 10 - HandId: #3150633295033663601-167-1703368059 - Holdem no limit (120/500/1000) - 2023/12/23 21:47:39 UTC
Table: 'X-MAS FEVER 5 € - DAY 1(733563978)#0112' 6-max (real money) Seat #5 is the button
Seat 1: POKPOKPK9 (21013)
Seat 2: P1xel7 (85922)
Seat 3: Wago7 (22613)
Seat 4: SheepLeader- (18415)
Seat 5: DUICEETDELOR (27834)
Seat 6: Dirty Bazaar (46874)
*** ANTE/BLINDS ***
Dirty Bazaar posts ante 120
POKPOKPK9 posts ante 120
P1xel7 posts ante 120
Wago7 posts ante 120
SheepLeader- posts ante 120
DUICEETDELOR posts ante 120
Dirty Bazaar posts small blind 500
POKPOKPK9 posts big blind 1000
Dealt to P1xel7 [8d Qs]
*** PRE-FLOP *** 
P1xel7 folds
Wago7 folds
SheepLeader- folds
DUICEETDELOR raises 1000 to 2000
Dirty Bazaar folds
POKPOKPK9 calls 1000
*** FLOP *** [Jd 2d 6d]
POKPOKPK9 checks
DUICEETDELOR bets 2000
POKPOKPK9 folds
DUICEETDELOR collected 7220 from pot
*** SUMMARY ***
Total pot 7220 | No rake
Board: [Jd 2d 6d]
Seat 5: DUICEETDELOR (button) won 7220


Winamax Poker - Tournament "X-MAS FEVER 5 € - DAY 1" buyIn: 4.50€ + 0.50€ level: 10 - HandId: #3150633295033663601-168-1703368097 - Holdem no limit (120/500/1000) - 2023/12/23 21:48:17 UTC
Table: 'X-MAS FEVER 5 € - DAY 1(733563978)#0112' 6-max (real money) Seat #6 is the button
Seat 1: POKPOKPK9 (18893)
Seat 2: P1xel7 (85802)
Seat 3: Wago7 (22493)
Seat 4: SheepLeader- (18295)
Seat 5: DUICEETDELOR (30934)
Seat 6: Dirty Bazaar (46254)
*** ANTE/BLINDS ***
POKPOKPK9 posts ante 120
P1xel7 posts ante 120
Wago7 posts ante 120
SheepLeader- posts ante 120
DUICEETDELOR posts ante 120
Dirty Bazaar posts ante 120
POKPOKPK9 posts small blind 500
P1xel7 posts big blind 1000
Dealt to P1xel7 [Ad Kc]
*** PRE-FLOP *** 
Wago7 folds
SheepLeader- folds
DUICEETDELOR raises 1000 to 2000
Dirty Bazaar folds
POKPOKPK9 raises 16773 to 18773 and is all-in
P1xel7 raises 16773 to 35546
DUICEETDELOR folds
*** FLOP *** [8d 2h 5s]
*** TURN *** [8d 2h 5s][Qs]
*** RIVER *** [8d 2h 5s Qs][7h]
*** SHOW DOWN ***
POKPOKPK9 shows [Qh Jc] (One pair : Queens)
P1xel7 shows [Ad Kc] (High card : Ace)
P1xel7 collected 16773 from side pot 1
POKPOKPK9 collected 40266 from main pot
*** SUMMARY ***
Total pot 57039 | No rake
Board: [8d 2h 5s Qs 7h]
Seat 1: POKPOKPK9 (small blind) showed [Qh Jc] and won 40266 with One pair : Queens
Seat 2: P1xel7 (big blind) showed [Ad Kc] and won 16773 with High card : Ace


Winamax Poker - Tournament "X-MAS FEVER 5 € - DAY 1" buyIn: 4.50€ + 0.50€ level: 10 - HandId: #3150633295033663601-169-1703368125 - Holdem no limit (120/500/1000) - 2023/12/23 21:48:45 UTC
Table: 'X-MAS FEVER 5 € - DAY 1(733563978)#0112' 6-max (real money) Seat #1 is the button
Seat 1: POKPOKPK9 (40266)
Seat 2: P1xel7 (66909)
Seat 3: Wago7 (22373)
Seat 4: SheepLeader- (18175)
Seat 5: DUICEETDELOR (28814)
Seat 6: Dirty Bazaar (46134)
*** ANTE/BLINDS ***
P1xel7 posts ante 120
Wago7 posts ante 120
POKPOKPK9 posts ante 120
SheepLeader- posts ante 120
DUICEETDELOR posts ante 120
Dirty Bazaar posts ante 120
P1xel7 posts small blind 500
Wago7 posts big blind 1000
Dealt to P1xel7 [5h Ac]
*** PRE-FLOP *** 
SheepLeader- folds
DUICEETDELOR folds
Dirty Bazaar folds
POKPOKPK9 folds
P1xel7 raises 1200 to 2200
Wago7 calls 1200
*** FLOP *** [5d Kd Kc]
P1xel7 bets 1792
Wago7 folds
P1xel7 collected 6912 from pot
*** SUMMARY ***
Total pot 6912 | No rake
Board: [5d Kd Kc]
Seat 2: P1xel7 (small blind) won 6912


Winamax Poker - Tournament "X-MAS FEVER 5 € - DAY 1" buyIn: 4.50€ + 0.50€ level: 10 - HandId: #3150633295033663601-170-1703368160 - Holdem no limit (120/500/1000) - 2023/12/23 21:49:20 UTC
Table: 'X-MAS FEVER 5 € - DAY 1(733563978)#0112' 6-max (real money) Seat #2 is the button
Seat 1: POKPOKPK9 (40146)
Seat 2: P1xel7 (69709)
Seat 3: Wago7 (20053)
Seat 4: SheepLeader- (18055)
Seat 5: DUICEETDELOR (28694)
Seat 6: Dirty Bazaar (46014)
*** ANTE/BLINDS ***
Wago7 posts ante 120
SheepLeader- posts ante 120
POKPOKPK9 posts ante 120
P1xel7 posts ante 120
DUICEETDELOR posts ante 120
Dirty Bazaar posts ante 120
Wago7 posts small blind 500
SheepLeader- posts big blind 1000
Dealt to P1xel7 [6c Ks]
*** PRE-FLOP *** 
DUICEETDELOR folds
Dirty Bazaar folds
POKPOKPK9 raises 1000 to 2000
P1xel7 folds
Wago7 folds
SheepLeader- calls 1000
*** FLOP *** [Js 7d Qh]
SheepLeader- checks
POKPOKPK9 bets 1827
SheepLeader- folds
POKPOKPK9 collected 7047 from pot
*** SUMMARY ***
Total pot 7047 | No rake
Board: [Js 7d Qh]
Seat 1: POKPOKPK9 won 7047


Winamax Poker - Tournament "X-MAS FEVER 5 € - DAY 1" buyIn: 4.50€ + 0.50€ level: 10 - HandId: #3150633295033663601-171-1703368218 - Holdem no limit (120/500/1000) - 2023/12/23 21:50:18 UTC
Table: 'X-MAS FEVER 5 € - DAY 1(733563978)#0112' 6-max (real money) Seat #3 is the button
Seat 1: POKPOKPK9 (43246)
Seat 2: P1xel7 (69589)
Seat 3: Wago7 (19433)
Seat 4: SheepLeader- (15935)
Seat 5: DUICEETDELOR (28574)
Seat 6: Dirty Bazaar (45894)
*** ANTE/BLINDS ***
SheepLeader- posts ante 120
DUICEETDELOR posts ante 120
POKPOKPK9 posts ante 120
P1xel7 posts ante 120
Wago7 posts ante 120
Dirty Bazaar posts ante 120
SheepLeader- posts small blind 500
DUICEETDELOR posts big blind 1000
Dealt to P1xel7 [8s 5s]
*** PRE-FLOP *** 
Dirty Bazaar folds
POKPOKPK9 calls 1000
P1xel7 folds
Wago7 raises 18313 to 19313 and is all-in
SheepLeader- folds
DUICEETDELOR folds
POKPOKPK9 folds
Wago7 collected 22533 from pot
*** SUMMARY ***
Total pot 22533 | No rake
Seat 3: Wago7 (button) won 22533


Winamax Poker - Tournament "X-MAS FEVER 5 € - DAY 1" buyIn: 4.50€ + 0.50€ level: 11 - HandId: #3150633295033663601-172-1703368286 - Holdem no limit (140/600/1200) - 2023/12/23 21:51:26 UTC
Table: 'X-MAS FEVER 5 € - DAY 1(733563978)#0112' 6-max (real money) Seat #4 is the button
Seat 1: POKPOKPK9 (42126)
Seat 2: P1xel7 (69469)
Seat 3: Wago7 (22533)
Seat 4: SheepLeader- (15315)
Seat 5: DUICEETDELOR (27454)
Seat 6: Dirty Bazaar (45774)
*** ANTE/BLINDS ***
DUICEETDELOR posts ante 140
Dirty Bazaar posts ante 140
POKPOKPK9 posts ante 140
P1xel7 posts ante 140
Wago7 posts ante 140
SheepLeader- posts ante 140
DUICEETDELOR posts small blind 600
Dirty Bazaar posts big blind 1200
Dealt to P1xel7 [Qc 9h]
*** PRE-FLOP *** 
POKPOKPK9 folds
P1xel7 folds
Wago7 raises 1200 to 2400
SheepLeader- folds
DUICEETDELOR calls 1800
Dirty Bazaar folds
*** FLOP *** [Kc 9d 4s]
DUICEETDELOR checks
Wago7 bets 2394
DUICEETDELOR calls 2394
*** TURN *** [Kc 9d 4s][Qh]
DUICEETDELOR checks
Wago7 bets 4070
DUICEETDELOR raises 18450 to 22520 and is all-in
Wago7 calls 13529 and is all-in
*** RIVER *** [Kc 9d 4s Qh][3d]
*** SHOW DOWN ***
Wago7 shows [Ad Ks] (One pair : Kings)
DUICEETDELOR shows [Kd Js] (One pair : Kings)
DUICEETDELOR collected 4921 from side pot 1
Wago7 collected 46826 from main pot
*** SUMMARY ***
Total pot 51747 | No rake
Board: [Kc 9d 4s Qh 3d]
Seat 3: Wago7 showed [Ad Ks] and won 46826 with One pair : Kings
Seat 5: DUICEETDELOR (small blind) showed [Kd Js] and won 4921 with One pair : Kings


Winamax Poker - Tournament "X-MAS FEVER 5 € - DAY 1" buyIn: 4.50€ + 0.50€ level: 11 - HandId: #3150633295033663601-173-1703368371 - Holdem no limit (140/600/1200) - 2023/12/23 21:52:51 UTC
Table: 'X-MAS FEVER 5 € - DAY 1(733563978)#0112' 6-max (real money) Seat #5 is the button
Seat 1: POKPOKPK9 (41986)
Seat 2: P1xel7 (69329)
Seat 3: Wago7 (46826)
Seat 4: SheepLeader- (15175)
Seat 5: DUICEETDELOR (4921)
Seat 6: Dirty Bazaar (44434)
*** ANTE/BLINDS ***
Dirty Bazaar posts ante 140
POKPOKPK9 posts ante 140
P1xel7 posts ante 140
Wago7 posts ante 140
SheepLeader- posts ante 140
DUICEETDELOR posts ante 140
Dirty Bazaar posts small blind 600
POKPOKPK9 posts big blind 1200
Dealt to P1xel7 [9s 5s]
*** PRE-FLOP *** 
P1xel7 folds
Wago7 raises 1200 to 2400
SheepLeader- folds
DUICEETDELOR folds
Dirty Bazaar folds
POKPOKPK9 calls 1200
*** FLOP *** [2d Kc 8s]
POKPOKPK9 checks
Wago7 bets 2184
POKPOKPK9 folds
Wago7 collected 8424 from pot
*** SUMMARY ***
Total pot 8424 | No rake
Board: [2d Kc 8s]
Seat 3: Wago7 won 8424


Winamax Poker - Tournament "X-MAS FEVER 5 € - DAY 1" buyIn: 4.50€ + 0.50€ level: 11 - HandId: #3150633295033663601-174-1703368421 - Holdem no limit (140/600/1200) - 2023/12/23 21:53:41 UTC
Table: 'X-MAS FEVER 5 € - DAY 1(733563978)#0112' 6-max (real money) Seat #6 is the button
Seat 1: POKPOKPK9 (39446)
Seat 2: P1xel7 (69189)
Seat 3: Wago7 (50526)
Seat 4: SheepLeader- (15035)
Seat 5: DUICEETDELOR (4781)
Seat 6: Dirty Bazaar (43694)
*** ANTE/BLINDS ***
POKPOKPK9 posts ante 140
P1xel7 posts ante 140
Wago7 posts ante 140
SheepLeader- posts ante 140
DUICEETDELOR posts ante 140
Dirty Bazaar posts ante 140
POKPOKPK9 posts small blind 600
P1xel7 posts big blind 1200
Dealt to P1xel7 [6h Qs]
*** PRE-FLOP *** 
Wago7 raises 1200 to 2400
SheepLeader- raises 12495 to 14895 and is all-in
DUICEETDELOR calls 4641 and is all-in
Dirty Bazaar folds
POKPOKPK9 folds
P1xel7 folds
Wago7 folds
*** FLOP *** [Td 4s Kd]
*** TURN *** [Td 4s Kd][3c]
*** RIVER *** [Td 4s Kd 3c][3h]
*** SHOW DOWN ***
DUICEETDELOR shows [As 6d] (One pair : 3)
SheepLeader- shows [9d 9h] (Two pairs : 9 and 3)
SheepLeader- collected 24576 from pot
*** SUMMARY ***
Total pot 24576 | No rake
Board: [Td 4s Kd 3c 3h]
Seat 4: SheepLeader- showed [9d 9h] and won 24576 with Two pairs : 9 and 3
Seat 5: DUICEETDELOR showed [As 6d] and lost with One pair : 3


Winamax Poker - Tournament "X-MAS FEVER 5 € - DAY 1" buyIn: 4.50€ + 0.50€ level: 11 - HandId: #3150633295033663601-175-1703368470 - Holdem no limit (140/600/1200) - 2023/12/23 21:54:30 UTC
Table: 'X-MAS FEVER 5 € - DAY 1(733563978)#0112' 6-max (real money) Seat #1 is the button
Seat 1: POKPOKPK9 (38706)
Seat 2: P1xel7 (67849)
Seat 3: Wago7 (47986)
Seat 4: SheepLeader- (24576)
Seat 6: Dirty Bazaar (43554)
*** ANTE/BLINDS ***
P1xel7 posts ante 140
Wago7 posts ante 140
POKPOKPK9 posts ante 140
SheepLeader- posts ante 140
Dirty Bazaar posts ante 140
P1xel7 posts small blind 600
Wago7 posts big blind 1200
Dealt to P1xel7 [6d 9h]
*** PRE-FLOP *** 
SheepLeader- folds
Dirty Bazaar folds
POKPOKPK9 raises 1800 to 3000
P1xel7 folds
Wago7 folds
POKPOKPK9 shows [Ac Ks] (High card : Ace)
POKPOKPK9 collected 5500 from pot
*** SUMMARY ***
Total pot 5500 | No rake
Seat 1: POKPOKPK9 (button) showed [Ac Ks] and won 5500 with High card : Ace


Winamax Poker - Tournament "X-MAS FEVER 5 € - DAY 1" buyIn: 4.50€ + 0.50€ level: 11 - HandId: #3150633295033663601-176-1703368861 - Holdem no limit (140/600/1200) - 2023/12/23 22:01:01 UTC
Table: 'X-MAS FEVER 5 € - DAY 1(733563978)#0112' 6-max (real money) Seat #2 is the button
Seat 1: POKPOKPK9 (41066)
Seat 2: P1xel7 (67109)
Seat 3: Wago7 (46646)
Seat 4: SheepLeader- (24436)
Seat 5: GarvielLoken (60317)
Seat 6: Dirty Bazaar (43414)
*** ANTE/BLINDS ***
Wago7 posts ante 140
SheepLeader- posts ante 140
POKPOKPK9 posts ante 140
P1xel7 posts ante 140
GarvielLoken posts ante 140
Dirty Bazaar posts ante 140
Wago7 posts small blind 600
SheepLeader- posts big blind 1200
Dealt to P1xel7 [3h 9c]
*** PRE-FLOP *** 
GarvielLoken folds
Dirty Bazaar folds
POKPOKPK9 folds
P1xel7 folds
Wago7 folds
SheepLeader- collected 2640 from pot
*** SUMMARY ***
Total pot 2640 | No rake
Seat 4: SheepLeader- (big blind) won 2640


Winamax Poker - Tournament "X-MAS FEVER 5 € - DAY 1" buyIn: 4.50€ + 0.50€ level: 11 - HandId: #3150633295033663601-177-1703368931 - Holdem no limit (140/600/1200) - 2023/12/23 22:02:11 UTC
Table: 'X-MAS FEVER 5 € - DAY 1(733563978)#0112' 6-max (real money) Seat #3 is the button
Seat 1: POKPOKPK9 (40926)
Seat 2: P1xel7 (66969)
Seat 3: Wago7 (45906)
Seat 4: SheepLeader- (25736)
Seat 5: GarvielLoken (60177)
Seat 6: Dirty Bazaar (43274)
*** ANTE/BLINDS ***
SheepLeader- posts ante 140
GarvielLoken posts ante 140
POKPOKPK9 posts ante 140
P1xel7 posts ante 140
Wago7 posts ante 140
Dirty Bazaar posts ante 140
SheepLeader- posts small blind 600
GarvielLoken posts big blind 1200
Dealt to P1xel7 [5d 7d]
*** PRE-FLOP *** 
Dirty Bazaar folds
POKPOKPK9 folds
P1xel7 folds
Wago7 folds
SheepLeader- raises 2400 to 3600
GarvielLoken folds
SheepLeader- collected 5640 from pot
*** SUMMARY ***
Total pot 5640 | No rake
Seat 4: SheepLeader- (small blind) won 5640


Winamax Poker - Tournament "X-MAS FEVER 5 € - DAY 1" buyIn: 4.50€ + 0.50€ level: 11 - HandId: #3150633295033663601-178-1703368952 - Holdem no limit (140/600/1200) - 2023/12/23 22:02:32 UTC
Table: 'X-MAS FEVER 5 € - DAY 1(733563978)#0112' 6-max (real money) Seat #4 is the button
Seat 1: POKPOKPK9 (40786)
Seat 2: P1xel7 (66829)
Seat 3: Wago7 (45766)
Seat 4: SheepLeader- (27636)
Seat 5: GarvielLoken (58837)
Seat 6: Dirty Bazaar (43134)
*** ANTE/BLINDS ***
GarvielLoken posts ante 140
Dirty Bazaar posts ante 140
POKPOKPK9 posts ante 140
P1xel7 posts ante 140
Wago7 posts ante 140
SheepLeader- posts ante 140
GarvielLoken posts small blind 600
Dirty Bazaar posts big blind 1200
Dealt to P1xel7 [9s 3c]
*** PRE-FLOP *** 
POKPOKPK9 folds
P1xel7 folds
Wago7 folds
SheepLeader- folds
GarvielLoken calls 600
Dirty Bazaar checks
*** FLOP *** [Kh 8h 8s]
GarvielLoken checks
Dirty Bazaar checks
*** TURN *** [Kh 8h 8s][6d]
GarvielLoken checks
Dirty Bazaar checks
*** RIVER *** [Kh 8h 8s 6d][5c]
GarvielLoken checks
Dirty Bazaar bets 2592
GarvielLoken folds
Dirty Bazaar collected 5832 from pot
*** SUMMARY ***
Total pot 5832 | No rake
Board: [Kh 8h 8s 6d 5c]
Seat 6: Dirty Bazaar (big blind) won 5832


Winamax Poker - Tournament "X-MAS FEVER 5 € - DAY 1" buyIn: 4.50€ + 0.50€ level: 11 - HandId: #3150633295033663601-179-1703368984 - Holdem no limit (140/600/1200) - 2023/12/23 22:03:04 UTC
Table: 'X-MAS FEVER 5 € - DAY 1(733563978)#0112' 6-max (real money) Seat #5 is the button
Seat 1: POKPOKPK9 (40646)
Seat 2: P1xel7 (66689)
Seat 3: Wago7 (45626)
Seat 4: SheepLeader- (27496)
Seat 5: GarvielLoken (57497)
Seat 6: Dirty Bazaar (45034)
*** ANTE/BLINDS ***
Dirty Bazaar posts ante 140
POKPOKPK9 posts ante 140
P1xel7 posts ante 140
Wago7 posts ante 140
SheepLeader- posts ante 140
GarvielLoken posts ante 140
Dirty Bazaar posts small blind 600
POKPOKPK9 posts big blind 1200
Dealt to P1xel7 [Tc Qc]
*** PRE-FLOP *** 
P1xel7 raises 1440 to 2640
Wago7 folds
SheepLeader- folds
GarvielLoken folds
Dirty Bazaar folds
POKPOKPK9 folds
P1xel7 collected 5280 from pot
*** SUMMARY ***
Total pot 5280 | No rake
Seat 2: P1xel7 won 5280


Winamax Poker - Tournament "X-MAS FEVER 5 € - DAY 1" buyIn: 4.50€ + 0.50€ level: 11 - HandId: #3150633295033663601-180-1703369019 - Holdem no limit (140/600/1200) - 2023/12/23 22:03:39 UTC
Table: 'X-MAS FEVER 5 € - DAY 1(733563978)#0112' 6-max (real money) Seat #6 is the button
Seat 1: POKPOKPK9 (39306)
Seat 2: P1xel7 (69189)
Seat 3: Wago7 (45486)
Seat 4: SheepLeader- (27356)
Seat 5: GarvielLoken (57357)
Seat 6: Dirty Bazaar (44294)
*** ANTE/BLINDS ***
POKPOKPK9 posts ante 140
P1xel7 posts ante 140
Wago7 posts ante 140
SheepLeader- posts ante 140
GarvielLoken posts ante 140
Dirty Bazaar posts ante 140
POKPOKPK9 posts small blind 600
P1xel7 posts big blind 1200
Dealt to P1xel7 [Tc 7c]
*** PRE-FLOP *** 
Wago7 folds
SheepLeader- folds
GarvielLoken folds
Dirty Bazaar folds
POKPOKPK9 folds
P1xel7 collected 2640 from pot
*** SUMMARY ***
Total pot 2640 | No rake
Seat 2: P1xel7 (big blind) won 2640


Winamax Poker - Tournament "X-MAS FEVER 5 € - DAY 1" buyIn: 4.50€ + 0.50€ level: 11 - HandId: #3150633295033663601-181-1703369037 - Holdem no limit (140/600/1200) - 2023/12/23 22:03:57 UTC
Table: 'X-MAS FEVER 5 € - DAY 1(733563978)#0112' 6-max (real money) Seat #1 is the button
Seat 1: POKPOKPK9 (38566)
Seat 2: P1xel7 (70489)
Seat 3: Wago7 (45346)
Seat 4: SheepLeader- (27216)
Seat 5: GarvielLoken (57217)
Seat 6: Dirty Bazaar (44154)
*** ANTE/BLINDS ***
P1xel7 posts ante 140
Wago7 posts ante 140
POKPOKPK9 posts ante 140
SheepLeader- posts ante 140
GarvielLoken posts ante 140
Dirty Bazaar posts ante 140
P1xel7 posts small blind 600
Wago7 posts big blind 1200
Dealt to P1xel7 [Kh 3c]
*** PRE-FLOP *** 
SheepLeader- folds
GarvielLoken folds
Dirty Bazaar raises 1500 to 2700
POKPOKPK9 folds
P1xel7 folds
Wago7 calls 1500
*** FLOP *** [Qd 7c As]
Wago7 checks
Dirty Bazaar bets 3420
Wago7 calls 3420
*** TURN *** [Qd 7c As][Jd]
Wago7 checks
Dirty Bazaar checks
*** RIVER *** [Qd 7c As Jd][7d]
Wago7 checks
Dirty Bazaar checks
*** SHOW DOWN ***
Wago7 shows [Js Qs] (Two pairs : Queens and Jacks)
Dirty Bazaar shows [Ad 4s] (Two pairs : Aces and 7)
Dirty Bazaar collected 13680 from pot
*** SUMMARY ***
Total pot 13680 | No rake
Board: [Qd 7c As Jd 7d]
Seat 3: Wago7 (big blind) showed [Js Qs] and lost with Two pairs : Queens and Jacks
Seat 6: Dirty Bazaar showed [Ad 4s] and won 13680 with Two pairs : Aces and 7


Winamax Poker - Tournament "X-MAS FEVER 5 € - DAY 1" buyIn: 4.50€ + 0.50€ level: 11 - HandId: #3150633295033663601-182-1703369091 - Holdem no limit (140/600/1200) - 2023/12/23 22:04:51 UTC
Table: 'X-MAS FEVER 5 € - DAY 1(733563978)#0112' 6-max (real money) Seat #2 is the button
Seat 1: POKPOKPK9 (38426)
Seat 2: P1xel7 (69749)
Seat 3: Wago7 (39086)
Seat 4: SheepLeader- (27076)
Seat 5: GarvielLoken (57077)
Seat 6: Dirty Bazaar (51574)
*** ANTE/BLINDS ***
Wago7 posts ante 140
SheepLeader- posts ante 140
POKPOKPK9 posts ante 140
P1xel7 posts ante 140
GarvielLoken posts ante 140
Dirty Bazaar posts ante 140
Wago7 posts small blind 600
SheepLeader- posts big blind 1200
Dealt to P1xel7 [3s Ac]
*** PRE-FLOP *** 
GarvielLoken folds
Dirty Bazaar folds
POKPOKPK9 folds
P1xel7 folds
Wago7 calls 600
SheepLeader- checks
*** FLOP *** [7h 5c 8c]
Wago7 checks
SheepLeader- bets 1782
Wago7 calls 1782
*** TURN *** [7h 5c 8c][6c]
Wago7 checks
SheepLeader- bets 4491
Wago7 calls 4491
*** RIVER *** [7h 5c 8c 6c][7d]
Wago7 checks
SheepLeader- bets 5209
Wago7 folds
SheepLeader- collected 20995 from pot
*** SUMMARY ***
Total pot 20995 | No rake
Board: [7h 5c 8c 6c 7d]
Seat 4: SheepLeader- (big blind) won 20995


Winamax Poker - Tournament "X-MAS FEVER 5 € - DAY 1" buyIn: 4.50€ + 0.50€ level: 11 - HandId: #3150633295033663601-183-1703369196 - Holdem no limit (140/600/1200) - 2023/12/23 22:06:36 UTC
Table: 'X-MAS FEVER 5 € - DAY 1(733563978)#0112' 6-max (real money) Seat #3 is the button
Seat 1: POKPOKPK9 (38286)
Seat 2: P1xel7 (69609)
Seat 3: Wago7 (31473)
Seat 4: SheepLeader- (35249)
Seat 5: GarvielLoken (56937)
Seat 6: Dirty Bazaar (51434)
*** ANTE/BLINDS ***
SheepLeader- posts ante 140
GarvielLoken posts ante 140
POKPOKPK9 posts ante 140
P1xel7 posts ante 140
Wago7 posts ante 140
Dirty Bazaar posts ante 140
SheepLeader- posts small blind 600
GarvielLoken posts big blind 1200
Dealt to P1xel7 [Qc Th]
*** PRE-FLOP *** 
Dirty Bazaar folds
POKPOKPK9 folds
P1xel7 raises 1800 to 3000
Wago7 folds
SheepLeader- folds
GarvielLoken folds
P1xel7 collected 5640 from pot
*** SUMMARY ***
Total pot 5640 | No rake
Seat 2: P1xel7 won 5640


Winamax Poker - Tournament "X-MAS FEVER 5 € - DAY 1" buyIn: 4.50€ + 0.50€ level: 11 - HandId: #3150633295033663601-184-1703369216 - Holdem no limit (140/600/1200) - 2023/12/23 22:06:56 UTC
Table: 'X-MAS FEVER 5 € - DAY 1(733563978)#0112' 6-max (real money) Seat #4 is the button
Seat 1: POKPOKPK9 (38146)
Seat 2: P1xel7 (72109)
Seat 3: Wago7 (31333)
Seat 4: SheepLeader- (34509)
Seat 5: GarvielLoken (55597)
Seat 6: Dirty Bazaar (51294)
*** ANTE/BLINDS ***
GarvielLoken posts ante 140
Dirty Bazaar posts ante 140
POKPOKPK9 posts ante 140
P1xel7 posts ante 140
Wago7 posts ante 140
SheepLeader- posts ante 140
GarvielLoken posts small blind 600
Dirty Bazaar posts big blind 1200
Dealt to P1xel7 [4c 8s]
*** PRE-FLOP *** 
POKPOKPK9 folds
P1xel7 folds
Wago7 folds
SheepLeader- folds
GarvielLoken folds
Dirty Bazaar collected 2640 from pot
*** SUMMARY ***
Total pot 2640 | No rake
Seat 6: Dirty Bazaar (big blind) won 2640


Winamax Poker - Tournament "X-MAS FEVER 5 € - DAY 1" buyIn: 4.50€ + 0.50€ level: 11 - HandId: #3150633295033663601-185-1703369232 - Holdem no limit (140/600/1200) - 2023/12/23 22:07:12 UTC
Table: 'X-MAS FEVER 5 € - DAY 1(733563978)#0112' 6-max (real money) Seat #5 is the button
Seat 1: POKPOKPK9 (38006)
Seat 2: P1xel7 (71969)
Seat 3: Wago7 (31193)
Seat 4: SheepLeader- (34369)
Seat 5: GarvielLoken (54857)
Seat 6: Dirty Bazaar (52594)
*** ANTE/BLINDS ***
Dirty Bazaar posts ante 140
POKPOKPK9 posts ante 140
P1xel7 posts ante 140
Wago7 posts ante 140
SheepLeader- posts ante 140
GarvielLoken posts ante 140
Dirty Bazaar posts small blind 600
POKPOKPK9 posts big blind 1200
Dealt to P1xel7 [2s Jd]
*** PRE-FLOP *** 
P1xel7 folds
Wago7 raises 1200 to 2400
SheepLeader- folds
GarvielLoken folds
Dirty Bazaar folds
POKPOKPK9 folds
Wago7 collected 5040 from pot
*** SUMMARY ***
Total pot 5040 | No rake
Seat 3: Wago7 won 5040


Winamax Poker - Tournament "X-MAS FEVER 5 € - DAY 1" buyIn: 4.50€ + 0.50€ level: 11 - HandId: #3150633295033663601-186-1703369265 - Holdem no limit (140/600/1200) - 2023/12/23 22:07:45 UTC
Table: 'X-MAS FEVER 5 € - DAY 1(733563978)#0112' 6-max (real money) Seat #6 is the button
Seat 1: POKPOKPK9 (36666)
Seat 2: P1xel7 (71829)
Seat 3: Wago7 (33693)
Seat 4: SheepLeader- (34229)
Seat 5: GarvielLoken (54717)
Seat 6: Dirty Bazaar (51854)
*** ANTE/BLINDS ***
POKPOKPK9 posts ante 140
P1xel7 posts ante 140
Wago7 posts ante 140
SheepLeader- posts ante 140
GarvielLoken posts ante 140
Dirty Bazaar posts ante 140
POKPOKPK9 posts small blind 600
P1xel7 posts big blind 1200
Dealt to P1xel7 [Kh Kd]
*** PRE-FLOP *** 
Wago7 raises 1200 to 2400
SheepLeader- folds
GarvielLoken raises 4800 to 7200
Dirty Bazaar folds
POKPOKPK9 folds
P1xel7 raises 64489 to 71689 and is all-in
Wago7 folds
GarvielLoken folds
P1xel7 collected 82729 from pot
*** SUMMARY ***
Total pot 82729 | No rake
Seat 2: P1xel7 (big blind) won 82729


Winamax Poker - Tournament "X-MAS FEVER 5 € - DAY 1" buyIn: 4.50€ + 0.50€ level: 12 - HandId: #3150633295033663601-187-1703369307 - Holdem no limit (160/700/1400) - 2023/12/23 22:08:27 UTC
Table: 'X-MAS FEVER 5 € - DAY 1(733563978)#0112' 6-max (real money) Seat #1 is the button
Seat 1: POKPOKPK9 (35926)
Seat 2: P1xel7 (82729)
Seat 3: Wago7 (31153)
Seat 4: SheepLeader- (34089)
Seat 5: GarvielLoken (47377)
Seat 6: Dirty Bazaar (51714)
*** ANTE/BLINDS ***
P1xel7 posts ante 160
Wago7 posts ante 160
POKPOKPK9 posts ante 160
SheepLeader- posts ante 160
GarvielLoken posts ante 160
Dirty Bazaar posts ante 160
P1xel7 posts small blind 700
Wago7 posts big blind 1400
Dealt to P1xel7 [5h Ac]
*** PRE-FLOP *** 
SheepLeader- raises 1400 to 2800
GarvielLoken folds
Dirty Bazaar folds
POKPOKPK9 folds
P1xel7 folds
Wago7 folds
SheepLeader- collected 5860 from pot
*** SUMMARY ***
Total pot 5860 | No rake
Seat 4: SheepLeader- won 5860


Winamax Poker - Tournament "X-MAS FEVER 5 € - DAY 1" buyIn: 4.50€ + 0.50€ level: 12 - HandId: #3150633295033663601-188-1703369323 - Holdem no limit (160/700/1400) - 2023/12/23 22:08:43 UTC
Table: 'X-MAS FEVER 5 € - DAY 1(733563978)#0112' 6-max (real money) Seat #2 is the button
Seat 1: POKPOKPK9 (35766)
Seat 2: P1xel7 (81869)
Seat 3: Wago7 (29593)
Seat 4: SheepLeader- (36989)
Seat 5: GarvielLoken (47217)
Seat 6: Dirty Bazaar (51554)
*** ANTE/BLINDS ***
Wago7 posts ante 160
SheepLeader- posts ante 160
POKPOKPK9 posts ante 160
P1xel7 posts ante 160
GarvielLoken posts ante 160
Dirty Bazaar posts ante 160
Wago7 posts small blind 700
SheepLeader- posts big blind 1400
Dealt to P1xel7 [Jc Ks]
*** PRE-FLOP *** 
GarvielLoken folds
Dirty Bazaar raises 2100 to 3500
POKPOKPK9 folds
P1xel7 calls 3500
Wago7 folds
SheepLeader- folds
*** FLOP *** [2s 4h 8s]
Dirty Bazaar checks
P1xel7 checks
*** TURN *** [2s 4h 8s][Ad]
Dirty Bazaar bets 5030
P1xel7 folds
Dirty Bazaar collected 15090 from pot
*** SUMMARY ***
Total pot 15090 | No rake
Board: [2s 4h 8s Ad]
Seat 6: Dirty Bazaar won 15090


Winamax Poker - Tournament "X-MAS FEVER 5 € - DAY 1" buyIn: 4.50€ + 0.50€ level: 12 - HandId: #3150633295033663601-189-1703369365 - Holdem no limit (160/700/1400) - 2023/12/23 22:09:25 UTC
Table: 'X-MAS FEVER 5 € - DAY 1(733563978)#0112' 6-max (real money) Seat #3 is the button
Seat 1: POKPOKPK9 (35606)
Seat 2: P1xel7 (78209)
Seat 3: Wago7 (28733)
Seat 4: SheepLeader- (35429)
Seat 5: GarvielLoken (47057)
Seat 6: Dirty Bazaar (57954)
*** ANTE/BLINDS ***
SheepLeader- posts ante 160
GarvielLoken posts ante 160
POKPOKPK9 posts ante 160
P1xel7 posts ante 160
Wago7 posts ante 160
Dirty Bazaar posts ante 160
SheepLeader- posts small blind 700
GarvielLoken posts big blind 1400
Dealt to P1xel7 [3s Ts]
*** PRE-FLOP *** 
Dirty Bazaar raises 1750 to 3150
POKPOKPK9 folds
P1xel7 folds
Wago7 folds
SheepLeader- folds
GarvielLoken folds
Dirty Bazaar collected 6210 from pot
*** SUMMARY ***
Total pot 6210 | No rake
Seat 6: Dirty Bazaar won 6210


Winamax Poker - Tournament "X-MAS FEVER 5 € - DAY 1" buyIn: 4.50€ + 0.50€ level: 12 - HandId: #3150633295033663601-190-1703369384 - Holdem no limit (160/700/1400) - 2023/12/23 22:09:44 UTC
Table: 'X-MAS FEVER 5 € - DAY 1(733563978)#0112' 6-max (real money) Seat #4 is the button
Seat 1: POKPOKPK9 (35446)
Seat 2: P1xel7 (78049)
Seat 3: Wago7 (28573)
Seat 4: SheepLeader- (34569)
Seat 5: GarvielLoken (45497)
Seat 6: Dirty Bazaar (60854)
*** ANTE/BLINDS ***
GarvielLoken posts ante 160
Dirty Bazaar posts ante 160
POKPOKPK9 posts ante 160
P1xel7 posts ante 160
Wago7 posts ante 160
SheepLeader- posts ante 160
GarvielLoken posts small blind 700
Dirty Bazaar posts big blind 1400
Dealt to P1xel7 [9d 3d]
*** PRE-FLOP *** 
POKPOKPK9 folds
P1xel7 folds
Wago7 raises 1400 to 2800
SheepLeader- raises 4200 to 7000
GarvielLoken folds
Dirty Bazaar folds
Wago7 folds
SheepLeader- collected 12860 from pot
*** SUMMARY ***
Total pot 12860 | No rake
Seat 4: SheepLeader- (button) won 12860


Winamax Poker - Tournament "X-MAS FEVER 5 € - DAY 1" buyIn: 4.50€ + 0.50€ level: 12 - HandId: #3150633295033663601-191-1703369406 - Holdem no limit (160/700/1400) - 2023/12/23 22:10:06 UTC
Table: 'X-MAS FEVER 5 € - DAY 1(733563978)#0112' 6-max (real money) Seat #5 is the button
Seat 1: POKPOKPK9 (35286)
Seat 2: P1xel7 (77889)
Seat 3: Wago7 (25613)
Seat 4: SheepLeader- (40269)
Seat 5: GarvielLoken (44637)
Seat 6: Dirty Bazaar (59294)
*** ANTE/BLINDS ***
Dirty Bazaar posts ante 160
POKPOKPK9 posts ante 160
P1xel7 posts ante 160
Wago7 posts ante 160
SheepLeader- posts ante 160
GarvielLoken posts ante 160
Dirty Bazaar posts small blind 700
POKPOKPK9 posts big blind 1400
Dealt to P1xel7 [As Ad]
*** PRE-FLOP *** 
P1xel7 raises 1680 to 3080
Wago7 folds
SheepLeader- folds
GarvielLoken folds
Dirty Bazaar folds
POKPOKPK9 folds
P1xel7 collected 6140 from pot
*** SUMMARY ***
Total pot 6140 | No rake
Seat 2: P1xel7 won 6140


Winamax Poker - Tournament "X-MAS FEVER 5 € - DAY 1" buyIn: 4.50€ + 0.50€ level: 12 - HandId: #3150633295033663601-192-1703369416 - Holdem no limit (160/700/1400) - 2023/12/23 22:10:16 UTC
Table: 'X-MAS FEVER 5 € - DAY 1(733563978)#0112' 6-max (real money) Seat #6 is the button
Seat 1: POKPOKPK9 (33726)
Seat 2: P1xel7 (80789)
Seat 3: Wago7 (25453)
Seat 4: SheepLeader- (40109)
Seat 5: GarvielLoken (44477)
Seat 6: Dirty Bazaar (58434)
*** ANTE/BLINDS ***
POKPOKPK9 posts ante 160
P1xel7 posts ante 160
Wago7 posts ante 160
SheepLeader- posts ante 160
GarvielLoken posts ante 160
Dirty Bazaar posts ante 160
POKPOKPK9 posts small blind 700
P1xel7 posts big blind 1400
Dealt to P1xel7 [5h 2s]
*** PRE-FLOP *** 
Wago7 folds
SheepLeader- folds
GarvielLoken folds
Dirty Bazaar folds
POKPOKPK9 folds
P1xel7 collected 3060 from pot
*** SUMMARY ***
Total pot 3060 | No rake
Seat 2: P1xel7 (big blind) won 3060


Winamax Poker - Tournament "X-MAS FEVER 5 € - DAY 1" buyIn: 4.50€ + 0.50€ level: 12 - HandId: #3150633295033663601-193-1703369426 - Holdem no limit (160/700/1400) - 2023/12/23 22:10:26 UTC
Table: 'X-MAS FEVER 5 € - DAY 1(733563978)#0112' 6-max (real money) Seat #1 is the button
Seat 1: POKPOKPK9 (32866)
Seat 2: P1xel7 (82289)
Seat 3: Wago7 (25293)
Seat 4: SheepLeader- (39949)
Seat 5: GarvielLoken (44317)
Seat 6: Dirty Bazaar (58274)
*** ANTE/BLINDS ***
P1xel7 posts ante 160
Wago7 posts ante 160
POKPOKPK9 posts ante 160
SheepLeader- posts ante 160
GarvielLoken posts ante 160
Dirty Bazaar posts ante 160
P1xel7 posts small blind 700
Wago7 posts big blind 1400
Dealt to P1xel7 [2h 2c]
*** PRE-FLOP *** 
SheepLeader- folds
GarvielLoken folds
Dirty Bazaar folds
POKPOKPK9 folds
P1xel7 raises 80729 to 82129 and is all-in
Wago7 calls 23733 and is all-in
*** FLOP *** [6c Kc 7c]
*** TURN *** [6c Kc 7c][Qh]
*** RIVER *** [6c Kc 7c Qh][9d]
*** SHOW DOWN ***
Wago7 shows [5h Ac] (High card : Ace)
P1xel7 shows [2h 2c] (One pair : 2)
P1xel7 collected 108222 from pot
*** SUMMARY ***
Total pot 108222 | No rake
Board: [6c Kc 7c Qh 9d]
Seat 2: P1xel7 (small blind) showed [2h 2c] and won 108222 with One pair : 2
Seat 3: Wago7 (big blind) showed [5h Ac] and lost with High card : Ace


Winamax Poker - Tournament "X-MAS FEVER 5 € - DAY 1" buyIn: 4.50€ + 0.50€ level: 12 - HandId: #3150633295033663601-194-1703369462 - Holdem no limit (160/700/1400) - 2023/12/23 22:11:02 UTC
Table: 'X-MAS FEVER 5 € - DAY 1(733563978)#0112' 6-max (real money) Seat #2 is the button
Seat 1: POKPOKPK9 (32706)
Seat 2: P1xel7 (108222)
Seat 4: SheepLeader- (39789)
Seat 5: GarvielLoken (44157)
Seat 6: Dirty Bazaar (58114)
*** ANTE/BLINDS ***
SheepLeader- posts ante 160
POKPOKPK9 posts ante 160
P1xel7 posts ante 160
GarvielLoken posts ante 160
Dirty Bazaar posts ante 160
SheepLeader- posts big blind 1400
Dealt to P1xel7 [7c 2d]
*** PRE-FLOP *** 
GarvielLoken folds
Dirty Bazaar folds
POKPOKPK9 folds
P1xel7 folds
SheepLeader- collected 2200 from pot
*** SUMMARY ***
Total pot 2200 | No rake
Seat 4: SheepLeader- (big blind) won 2200


Winamax Poker - Tournament "X-MAS FEVER 5 € - DAY 1" buyIn: 4.50€ + 0.50€ level: 12 - HandId: #3150633295033663601-195-1703369472 - Holdem no limit (160/700/1400) - 2023/12/23 22:11:12 UTC
Table: 'X-MAS FEVER 5 € - DAY 1(733563978)#0112' 6-max (real money) Seat #3 is the button
Seat 1: POKPOKPK9 (32546)
Seat 2: P1xel7 (108062)
Seat 4: SheepLeader- (40429)
Seat 5: GarvielLoken (43997)
Seat 6: Dirty Bazaar (57954)
*** ANTE/BLINDS ***
SheepLeader- posts ante 160
GarvielLoken posts ante 160
POKPOKPK9 posts ante 160
P1xel7 posts ante 160
Dirty Bazaar posts ante 160
SheepLeader- posts small blind 700
GarvielLoken posts big blind 1400
Dealt to P1xel7 [7s 9c]
*** PRE-FLOP *** 
Dirty Bazaar folds
POKPOKPK9 folds
P1xel7 folds
SheepLeader- calls 700
GarvielLoken raises 3500 to 4900
SheepLeader- folds
GarvielLoken collected 7100 from pot
*** SUMMARY ***
Total pot 7100 | No rake
Seat 5: GarvielLoken (big blind) won 7100


Winamax Poker - Tournament "X-MAS FEVER 5 € - DAY 1" buyIn: 4.50€ + 0.50€ level: 12 - HandId: #3150633295033663601-196-1703369491 - Holdem no limit (160/700/1400) - 2023/12/23 22:11:31 UTC
Table: 'X-MAS FEVER 5 € - DAY 1(733563978)#0112' 6-max (real money) Seat #4 is the button
Seat 1: POKPOKPK9 (32386)
Seat 2: P1xel7 (107902)
Seat 3: Julesc01 (117164)
Seat 4: SheepLeader- (38869)
Seat 5: GarvielLoken (46037)
Seat 6: Dirty Bazaar (57794)
*** ANTE/BLINDS ***
GarvielLoken posts ante 160
Dirty Bazaar posts ante 160
POKPOKPK9 posts ante 160
P1xel7 posts ante 160
Julesc01 posts ante 160
SheepLeader- posts ante 160
GarvielLoken posts small blind 700
Dirty Bazaar posts big blind 1400
Dealt to P1xel7 [Qs 4h]
*** PRE-FLOP *** 
POKPOKPK9 folds
P1xel7 folds
Julesc01 raises 1680 to 3080
SheepLeader- folds
GarvielLoken folds
Dirty Bazaar folds
Julesc01 collected 6140 from pot
*** SUMMARY ***
Total pot 6140 | No rake
Seat 3: Julesc01 won 6140


Winamax Poker - Tournament "X-MAS FEVER 5 € - DAY 1" buyIn: 4.50€ + 0.50€ level: 12 - HandId: #3150633295033663601-197-1703369517 - Holdem no limit (160/700/1400) - 2023/12/23 22:11:57 UTC
Table: 'X-MAS FEVER 5 € - DAY 1(733563978)#0112' 6-max (real money) Seat #5 is the button
Seat 1: POKPOKPK9 (32226)
Seat 2: P1xel7 (107742)
Seat 3: Julesc01 (120064)
Seat 4: SheepLeader- (38709)
Seat 5: GarvielLoken (45177)
Seat 6: Dirty Bazaar (56234)
*** ANTE/BLINDS ***
Dirty Bazaar posts ante 160
POKPOKPK9 posts ante 160
P1xel7 posts ante 160
Julesc01 posts ante 160
SheepLeader- posts ante 160
GarvielLoken posts ante 160
Dirty Bazaar posts small blind 700
POKPOKPK9 posts big blind 1400
Dealt to P1xel7 [3s 5d]
*** PRE-FLOP *** 
P1xel7 folds
Julesc01 raises 1680 to 3080
SheepLeader- folds
GarvielLoken folds
Dirty Bazaar folds
POKPOKPK9 folds
Julesc01 collected 6140 from pot
*** SUMMARY ***
Total pot 6140 | No rake
Seat 3: Julesc01 won 6140


Winamax Poker - Tournament "X-MAS FEVER 5 € - DAY 1" buyIn: 4.50€ + 0.50€ level: 12 - HandId: #3150633295033663601-198-1703369533 - Holdem no limit (160/700/1400) - 2023/12/23 22:12:13 UTC
Table: 'X-MAS FEVER 5 € - DAY 1(733563978)#0112' 6-max (real money) Seat #6 is the button
Seat 1: POKPOKPK9 (30666)
Seat 2: P1xel7 (107582)
Seat 3: Julesc01 (122964)
Seat 4: SheepLeader- (38549)
Seat 5: GarvielLoken (45017)
Seat 6: Dirty Bazaar (55374)
*** ANTE/BLINDS ***
POKPOKPK9 posts ante 160
P1xel7 posts ante 160
Julesc01 posts ante 160
SheepLeader- posts ante 160
GarvielLoken posts ante 160
Dirty Bazaar posts ante 160
POKPOKPK9 posts small blind 700
P1xel7 posts big blind 1400
Dealt to P1xel7 [Js 4s]
*** PRE-FLOP *** 
Julesc01 folds
SheepLeader- folds
GarvielLoken raises 1540 to 2940
Dirty Bazaar folds
POKPOKPK9 folds
P1xel7 calls 1540
*** FLOP *** [Ac Qs 3d]
P1xel7 checks
GarvielLoken bets 2639
P1xel7 folds
GarvielLoken collected 10179 from pot
*** SUMMARY ***
Total pot 10179 | No rake
Board: [Ac Qs 3d]
Seat 5: GarvielLoken won 10179


Winamax Poker - Tournament "X-MAS FEVER 5 € - DAY 1" buyIn: 4.50€ + 0.50€ level: 12 - HandId: #3150633295033663601-199-1703369571 - Holdem no limit (160/700/1400) - 2023/12/23 22:12:51 UTC
Table: 'X-MAS FEVER 5 € - DAY 1(733563978)#0112' 6-max (real money) Seat #1 is the button
Seat 1: POKPOKPK9 (29806)
Seat 2: P1xel7 (104482)
Seat 3: Julesc01 (122804)
Seat 4: SheepLeader- (38389)
Seat 5: GarvielLoken (49457)
Seat 6: Dirty Bazaar (55214)
*** ANTE/BLINDS ***
P1xel7 posts ante 160
Julesc01 posts ante 160
POKPOKPK9 posts ante 160
SheepLeader- posts ante 160
GarvielLoken posts ante 160
Dirty Bazaar posts ante 160
P1xel7 posts small blind 700
Julesc01 posts big blind 1400
Dealt to P1xel7 [Kc 3h]
*** PRE-FLOP *** 
SheepLeader- folds
GarvielLoken folds
Dirty Bazaar raises 1750 to 3150
POKPOKPK9 folds
P1xel7 folds
Julesc01 calls 1750
*** FLOP *** [Js 7c Jc]
Julesc01 checks
Dirty Bazaar bets 3980
Julesc01 folds
Dirty Bazaar collected 11940 from pot
*** SUMMARY ***
Total pot 11940 | No rake
Board: [Js 7c Jc]
Seat 6: Dirty Bazaar won 11940


Winamax Poker - Tournament "X-MAS FEVER 5 € - DAY 1" buyIn: 4.50€ + 0.50€ level: 12 - HandId: #3150633295033663601-200-1703369604 - Holdem no limit (160/700/1400) - 2023/12/23 22:13:24 UTC
Table: 'X-MAS FEVER 5 € - DAY 1(733563978)#0112' 6-max (real money) Seat #2 is the button
Seat 1: POKPOKPK9 (29646)
Seat 2: P1xel7 (103622)
Seat 3: Julesc01 (119494)
Seat 4: SheepLeader- (38229)
Seat 5: GarvielLoken (49297)
Seat 6: Dirty Bazaar (59864)
*** ANTE/BLINDS ***
Julesc01 posts ante 160
SheepLeader- posts ante 160
POKPOKPK9 posts ante 160
P1xel7 posts ante 160
GarvielLoken posts ante 160
Dirty Bazaar posts ante 160
Julesc01 posts small blind 700
SheepLeader- posts big blind 1400
Dealt to P1xel7 [Js Th]
*** PRE-FLOP *** 
GarvielLoken raises 1540 to 2940
Dirty Bazaar folds
POKPOKPK9 folds
P1xel7 folds
Julesc01 folds
SheepLeader- calls 1540
*** FLOP *** [8c Qh 6c]
SheepLeader- checks
GarvielLoken bets 2639
SheepLeader- calls 2639
*** TURN *** [8c Qh 6c][7d]
SheepLeader- checks
GarvielLoken bets 8332
SheepLeader- folds
GarvielLoken collected 21150 from pot
*** SUMMARY ***
Total pot 21150 | No rake
Board: [8c Qh 6c 7d]
Seat 5: GarvielLoken won 21150


Winamax Poker - Tournament "X-MAS FEVER 5 € - DAY 1" buyIn: 4.50€ + 0.50€ level: 12 - HandId: #3150633295033663601-201-1703369644 - Holdem no limit (160/700/1400) - 2023/12/23 22:14:04 UTC
Table: 'X-MAS FEVER 5 € - DAY 1(733563978)#0112' 6-max (real money) Seat #3 is the button
Seat 1: POKPOKPK9 (29486)
Seat 2: P1xel7 (103462)
Seat 3: Julesc01 (118634)
Seat 4: SheepLeader- (32490)
Seat 5: GarvielLoken (56376)
Seat 6: Dirty Bazaar (59704)
*** ANTE/BLINDS ***
SheepLeader- posts ante 160
GarvielLoken posts ante 160
POKPOKPK9 posts ante 160
P1xel7 posts ante 160
Julesc01 posts ante 160
Dirty Bazaar posts ante 160
SheepLeader- posts small blind 700
GarvielLoken posts big blind 1400
Dealt to P1xel7 [8d Jc]
*** PRE-FLOP *** 
Dirty Bazaar folds
POKPOKPK9 folds
P1xel7 folds
Julesc01 raises 1680 to 3080
SheepLeader- folds
GarvielLoken calls 1680
*** FLOP *** [Kd Ac Ah]
GarvielLoken checks
Julesc01 bets 2581
GarvielLoken folds
Julesc01 collected 10401 from pot
*** SUMMARY ***
Total pot 10401 | No rake
Board: [Kd Ac Ah]
Seat 3: Julesc01 (button) won 10401


Winamax Poker - Tournament "X-MAS FEVER 5 € - DAY 1" buyIn: 4.50€ + 0.50€ level: 12 - HandId: #3150633295033663601-202-1703369680 - Holdem no limit (160/700/1400) - 2023/12/23 22:14:40 UTC
Table: 'X-MAS FEVER 5 € - DAY 1(733563978)#0112' 6-max (real money) Seat #4 is the button
Seat 1: POKPOKPK9 (29326)
Seat 2: P1xel7 (103302)
Seat 3: Julesc01 (123214)
Seat 4: SheepLeader- (31630)
Seat 5: GarvielLoken (53136)
Seat 6: Dirty Bazaar (59544)
*** ANTE/BLINDS ***
GarvielLoken posts ante 160
Dirty Bazaar posts ante 160
POKPOKPK9 posts ante 160
P1xel7 posts ante 160
Julesc01 posts ante 160
SheepLeader- posts ante 160
GarvielLoken posts small blind 700
Dirty Bazaar posts big blind 1400
Dealt to P1xel7 [Qh Qs]
*** PRE-FLOP *** 
POKPOKPK9 folds
P1xel7 raises 2100 to 3500
Julesc01 folds
SheepLeader- folds
GarvielLoken folds
Dirty Bazaar folds
P1xel7 collected 6560 from pot
*** SUMMARY ***
Total pot 6560 | No rake
Seat 2: P1xel7 won 6560


Winamax Poker - Tournament "X-MAS FEVER 5 € - DAY 1" buyIn: 4.50€ + 0.50€ level: 12 - HandId: #3150633295033663601-203-1703369697 - Holdem no limit (160/700/1400) - 2023/12/23 22:14:57 UTC
Table: 'X-MAS FEVER 5 € - DAY 1(733563978)#0112' 6-max (real money) Seat #5 is the button
Seat 1: POKPOKPK9 (29166)
Seat 2: P1xel7 (106202)
Seat 3: Julesc01 (123054)
Seat 4: SheepLeader- (31470)
Seat 5: GarvielLoken (52276)
Seat 6: Dirty Bazaar (57984)
*** ANTE/BLINDS ***
Dirty Bazaar posts ante 160
POKPOKPK9 posts ante 160
P1xel7 posts ante 160
Julesc01 posts ante 160
SheepLeader- posts ante 160
GarvielLoken posts ante 160
Dirty Bazaar posts small blind 700
POKPOKPK9 posts big blind 1400
Dealt to P1xel7 [Th 8h]
*** PRE-FLOP *** 
P1xel7 folds
Julesc01 folds
SheepLeader- raises 1400 to 2800
GarvielLoken calls 2800
Dirty Bazaar calls 2100
POKPOKPK9 folds
*** FLOP *** [7h 2d Jc]
Dirty Bazaar checks
SheepLeader- checks
GarvielLoken bets 2690
Dirty Bazaar calls 2690
SheepLeader- folds
*** TURN *** [7h 2d Jc][5c]
Dirty Bazaar checks
GarvielLoken bets 8070
Dirty Bazaar calls 8070
*** RIVER *** [7h 2d Jc 5c][2s]
Dirty Bazaar checks
GarvielLoken checks
*** SHOW DOWN ***
GarvielLoken shows [9c Kc] (One pair : 2)
Dirty Bazaar shows [Kd Js] (Two pairs : Jacks and 2)
Dirty Bazaar collected 32280 from pot
*** SUMMARY ***
Total pot 32280 | No rake
Board: [7h 2d Jc 5c 2s]
Seat 5: GarvielLoken (button) showed [9c Kc] and lost with One pair : 2
Seat 6: Dirty Bazaar (small blind) showed [Kd Js] and won 32280 with Two pairs : Jacks and 2


Winamax Poker - Tournament "X-MAS FEVER 5 € - DAY 1" buyIn: 4.50€ + 0.50€ level: 12 - HandId: #3150633295033663601-204-1703369757 - Holdem no limit (160/700/1400) - 2023/12/23 22:15:57 UTC
Table: 'X-MAS FEVER 5 € - DAY 1(733563978)#0112' 6-max (real money) Seat #6 is the button
Seat 1: POKPOKPK9 (27606)
Seat 2: P1xel7 (106042)
Seat 3: Julesc01 (122894)
Seat 4: SheepLeader- (28510)
Seat 5: GarvielLoken (38556)
Seat 6: Dirty Bazaar (76544)
*** ANTE/BLINDS ***
POKPOKPK9 posts ante 160
P1xel7 posts ante 160
Julesc01 posts ante 160
SheepLeader- posts ante 160
GarvielLoken posts ante 160
Dirty Bazaar posts ante 160
POKPOKPK9 posts small blind 700
P1xel7 posts big blind 1400
Dealt to P1xel7 [Kc 4s]
*** PRE-FLOP *** 
Julesc01 folds
SheepLeader- raises 1400 to 2800
GarvielLoken folds
Dirty Bazaar folds
POKPOKPK9 folds
P1xel7 calls 1400
*** FLOP *** [Ac 4d 5s]
P1xel7 checks
SheepLeader- bets 4792
P1xel7 calls 4792
*** TURN *** [Ac 4d 5s][7d]
P1xel7 checks
SheepLeader- bets 9264
P1xel7 folds
SheepLeader- collected 26108 from pot
*** SUMMARY ***
Total pot 26108 | No rake
Board: [Ac 4d 5s 7d]
Seat 4: SheepLeader- won 26108


Winamax Poker - Tournament "X-MAS FEVER 5 € - DAY 1" buyIn: 4.50€ + 0.50€ level: 12 - HandId: #3150633295033663502-269-1703369879 - Holdem no limit (160/700/1400) - 2023/12/23 22:17:59 UTC
Table: 'X-MAS FEVER 5 € - DAY 1(733563978)#0013' 6-max (real money) Seat #3 is the button
Seat 1: pi-ratt-R2d2 (190696)
Seat 2: P1xel7 (98290)
Seat 3: bulleri5 (45157)
Seat 4: Dimix68 (87182)
Seat 5: novocio2929 (96990)
Seat 6: FreedomDrums (74647)
*** ANTE/BLINDS ***
Dimix68 posts ante 160
novocio2929 posts ante 160
pi-ratt-R2d2 posts ante 160
P1xel7 posts ante 160
bulleri5 posts ante 160
FreedomDrums posts ante 160
Dimix68 posts small blind 700
novocio2929 posts big blind 1400
Dealt to P1xel7 [5c 9s]
*** PRE-FLOP *** 
FreedomDrums raises 1400 to 2800
pi-ratt-R2d2 folds
P1xel7 folds
bulleri5 folds
Dimix68 folds
novocio2929 folds
FreedomDrums collected 5860 from pot
*** SUMMARY ***
Total pot 5860 | No rake
Seat 6: FreedomDrums won 5860


Winamax Poker - Tournament "X-MAS FEVER 5 € - DAY 1" buyIn: 4.50€ + 0.50€ level: 12 - HandId: #3150633295033663502-270-1703369898 - Holdem no limit (160/700/1400) - 2023/12/23 22:18:18 UTC
Table: 'X-MAS FEVER 5 € - DAY 1(733563978)#0013' 6-max (real money) Seat #4 is the button
Seat 1: pi-ratt-R2d2 (190536)
Seat 2: P1xel7 (98130)
Seat 3: bulleri5 (44997)
Seat 4: Dimix68 (86322)
Seat 5: novocio2929 (95430)
Seat 6: FreedomDrums (77547)
*** ANTE/BLINDS ***
novocio2929 posts ante 160
FreedomDrums posts ante 160
pi-ratt-R2d2 posts ante 160
P1xel7 posts ante 160
bulleri5 posts ante 160
Dimix68 posts ante 160
novocio2929 posts small blind 700
FreedomDrums posts big blind 1400
Dealt to P1xel7 [5h Ac]
*** PRE-FLOP *** 
pi-ratt-R2d2 folds
P1xel7 folds
bulleri5 folds
Dimix68 raises 2100 to 3500
novocio2929 calls 2800
FreedomDrums calls 2100
*** FLOP *** [6d Td 7d]
novocio2929 checks
FreedomDrums checks
Dimix68 bets 7449
novocio2929 calls 7449
FreedomDrums folds
*** TURN *** [6d Td 7d][3h]
novocio2929 checks
Dimix68 checks
*** RIVER *** [6d Td 7d 3h][7h]
novocio2929 bets 11770
Dimix68 raises 37564 to 49334
novocio2929 folds
Dimix68 shows [Kd 2d] (Flush King high)
Dimix68 collected 87462 from pot
*** SUMMARY ***
Total pot 87462 | No rake
Board: [6d Td 7d 3h 7h]
Seat 4: Dimix68 (button) showed [Kd 2d] and won 87462 with Flush King high


Winamax Poker - Tournament "X-MAS FEVER 5 € - DAY 1" buyIn: 4.50€ + 0.50€ level: 13 - HandId: #3150633295033663502-271-1703370028 - Holdem no limit (200/800/1600) - 2023/12/23 22:20:28 UTC
Table: 'X-MAS FEVER 5 € - DAY 1(733563978)#0013' 6-max (real money) Seat #5 is the button
Seat 1: pi-ratt-R2d2 (190376)
Seat 2: P1xel7 (97970)
Seat 3: bulleri5 (44837)
Seat 4: Dimix68 (113341)
Seat 5: novocio2929 (72551)
Seat 6: FreedomDrums (73887)
*** ANTE/BLINDS ***
FreedomDrums posts ante 200
pi-ratt-R2d2 posts ante 200
P1xel7 posts ante 200
bulleri5 posts ante 200
Dimix68 posts ante 200
novocio2929 posts ante 200
FreedomDrums posts small blind 800
pi-ratt-R2d2 posts big blind 1600
Dealt to P1xel7 [Tc 8h]
*** PRE-FLOP *** 
P1xel7 folds
bulleri5 raises 2400 to 4000
Dimix68 folds
novocio2929 folds
FreedomDrums folds
pi-ratt-R2d2 calls 2400
*** FLOP *** [Jd Kc 4s]
pi-ratt-R2d2 checks
bulleri5 bets 3500
pi-ratt-R2d2 folds
bulleri5 collected 13500 from pot
*** SUMMARY ***
Total pot 13500 | No rake
Board: [Jd Kc 4s]
Seat 3: bulleri5 won 13500


Winamax Poker - Tournament "X-MAS FEVER 5 € - DAY 1" buyIn: 4.50€ + 0.50€ level: 13 - HandId: #3150633295033663502-272-1703370048 - Holdem no limit (200/800/1600) - 2023/12/23 22:20:48 UTC
Table: 'X-MAS FEVER 5 € - DAY 1(733563978)#0013' 6-max (real money) Seat #6 is the button
Seat 1: pi-ratt-R2d2 (186176)
Seat 2: P1xel7 (97770)
Seat 3: bulleri5 (50637)
Seat 4: Dimix68 (113141)
Seat 5: novocio2929 (72351)
Seat 6: FreedomDrums (72887)
*** ANTE/BLINDS ***
pi-ratt-R2d2 posts ante 200
P1xel7 posts ante 200
bulleri5 posts ante 200
Dimix68 posts ante 200
novocio2929 posts ante 200
FreedomDrums posts ante 200
pi-ratt-R2d2 posts small blind 800
P1xel7 posts big blind 1600
Dealt to P1xel7 [Qh 8c]
*** PRE-FLOP *** 
bulleri5 folds
Dimix68 folds
novocio2929 folds
FreedomDrums folds
pi-ratt-R2d2 folds
P1xel7 collected 3600 from pot
*** SUMMARY ***
Total pot 3600 | No rake
Seat 2: P1xel7 (big blind) won 3600


Winamax Poker - Tournament "X-MAS FEVER 5 € - DAY 1" buyIn: 4.50€ + 0.50€ level: 13 - HandId: #3150633295033663502-273-1703370056 - Holdem no limit (200/800/1600) - 2023/12/23 22:20:56 UTC
Table: 'X-MAS FEVER 5 € - DAY 1(733563978)#0013' 6-max (real money) Seat #1 is the button
Seat 1: pi-ratt-R2d2 (185176)
Seat 2: P1xel7 (99570)
Seat 3: bulleri5 (50437)
Seat 4: Dimix68 (112941)
Seat 5: novocio2929 (72151)
Seat 6: FreedomDrums (72687)
*** ANTE/BLINDS ***
P1xel7 posts ante 200
bulleri5 posts ante 200
pi-ratt-R2d2 posts ante 200
Dimix68 posts ante 200
novocio2929 posts ante 200
FreedomDrums posts ante 200
P1xel7 posts small blind 800
bulleri5 posts big blind 1600
Dealt to P1xel7 [Qh 5c]
*** PRE-FLOP *** 
Dimix68 raises 1600 to 3200
novocio2929 calls 3200
FreedomDrums folds
pi-ratt-R2d2 folds
P1xel7 folds
bulleri5 folds
*** FLOP *** [Tc Ah Jd]
Dimix68 bets 5000
novocio2929 calls 5000
*** TURN *** [Tc Ah Jd][3s]
Dimix68 bets 10000
novocio2929 folds
Dimix68 collected 30000 from pot
*** SUMMARY ***
Total pot 30000 | No rake
Board: [Tc Ah Jd 3s]
Seat 4: Dimix68 won 30000


Winamax Poker - Tournament "X-MAS FEVER 5 € - DAY 1" buyIn: 4.50€ + 0.50€ level: 13 - HandId: #3150633295033663502-274-1703370125 - Holdem no limit (200/800/1600) - 2023/12/23 22:22:05 UTC
Table: 'X-MAS FEVER 5 € - DAY 1(733563978)#0013' 6-max (real money) Seat #2 is the button
Seat 1: pi-ratt-R2d2 (184976)
Seat 2: P1xel7 (98570)
Seat 3: bulleri5 (48637)
Seat 4: Dimix68 (124541)
Seat 5: novocio2929 (63751)
Seat 6: FreedomDrums (72487)
*** ANTE/BLINDS ***
bulleri5 posts ante 200
Dimix68 posts ante 200
pi-ratt-R2d2 posts ante 200
P1xel7 posts ante 200
novocio2929 posts ante 200
FreedomDrums posts ante 200
bulleri5 posts small blind 800
Dimix68 posts big blind 1600
Dealt to P1xel7 [Ah 7d]
*** PRE-FLOP *** 
novocio2929 folds
FreedomDrums folds
pi-ratt-R2d2 calls 1600
P1xel7 folds
bulleri5 calls 800
Dimix68 checks
*** FLOP *** [3s 7s 9c]
bulleri5 checks
Dimix68 bets 1600
pi-ratt-R2d2 calls 1600
bulleri5 folds
*** TURN *** [3s 7s 9c][8h]
Dimix68 bets 1600
pi-ratt-R2d2 calls 1600
*** RIVER *** [3s 7s 9c 8h][Jh]
Dimix68 bets 1600
pi-ratt-R2d2 raises 15600 to 17200
Dimix68 calls 15600
*** SHOW DOWN ***
pi-ratt-R2d2 shows [4c 4h] (One pair : 4)
Dimix68 shows [9h Td] (Straight Jack high)
Dimix68 collected 46800 from pot
*** SUMMARY ***
Total pot 46800 | No rake
Board: [3s 7s 9c 8h Jh]
Seat 1: pi-ratt-R2d2 showed [4c 4h] and lost with One pair : 4
Seat 4: Dimix68 (big blind) showed [9h Td] and won 46800 with Straight Jack high


Winamax Poker - Tournament "X-MAS FEVER 5 € - DAY 1" buyIn: 4.50€ + 0.50€ level: 13 - HandId: #3150633295033663502-275-1703370167 - Holdem no limit (200/800/1600) - 2023/12/23 22:22:47 UTC
Table: 'X-MAS FEVER 5 € - DAY 1(733563978)#0013' 6-max (real money) Seat #3 is the button
Seat 1: pi-ratt-R2d2 (162776)
Seat 2: P1xel7 (98370)
Seat 3: bulleri5 (46837)
Seat 4: Dimix68 (149141)
Seat 5: novocio2929 (63551)
Seat 6: FreedomDrums (72287)
*** ANTE/BLINDS ***
Dimix68 posts ante 200
novocio2929 posts ante 200
pi-ratt-R2d2 posts ante 200
P1xel7 posts ante 200
bulleri5 posts ante 200
FreedomDrums posts ante 200
Dimix68 posts small blind 800
novocio2929 posts big blind 1600
Dealt to P1xel7 [Ks Kc]
*** PRE-FLOP *** 
FreedomDrums folds
pi-ratt-R2d2 raises 3200 to 4800
P1xel7 raises 14400 to 19200
bulleri5 folds
Dimix68 folds
novocio2929 folds
pi-ratt-R2d2 calls 14400
*** FLOP *** [9s Ah 8c]
pi-ratt-R2d2 checks
P1xel7 bets 21000
pi-ratt-R2d2 calls 21000
*** TURN *** [9s Ah 8c][5h]
pi-ratt-R2d2 checks
P1xel7 checks
*** RIVER *** [9s Ah 8c 5h][3h]
pi-ratt-R2d2 bets 29400
P1xel7 calls 29400
*** SHOW DOWN ***
P1xel7 shows [Ks Kc] (One pair : Kings)
pi-ratt-R2d2 shows [Qc Ac] (One pair : Aces)
pi-ratt-R2d2 collected 142800 from pot
*** SUMMARY ***
Total pot 142800 | No rake
Board: [9s Ah 8c 5h 3h]
Seat 1: pi-ratt-R2d2 showed [Qc Ac] and won 142800 with One pair : Aces
Seat 2: P1xel7 showed [Ks Kc] and lost with One pair : Kings


Winamax Poker - Tournament "X-MAS FEVER 5 € - DAY 1" buyIn: 4.50€ + 0.50€ level: 13 - HandId: #3150633295033663502-276-1703370269 - Holdem no limit (200/800/1600) - 2023/12/23 22:24:29 UTC
Table: 'X-MAS FEVER 5 € - DAY 1(733563978)#0013' 6-max (real money) Seat #4 is the button
Seat 1: pi-ratt-R2d2 (235776)
Seat 2: P1xel7 (28570)
Seat 3: bulleri5 (46637)
Seat 4: Dimix68 (148141)
Seat 5: novocio2929 (61751)
Seat 6: FreedomDrums (72087)
*** ANTE/BLINDS ***
novocio2929 posts ante 200
FreedomDrums posts ante 200
pi-ratt-R2d2 posts ante 200
P1xel7 posts ante 200
bulleri5 posts ante 200
Dimix68 posts ante 200
novocio2929 posts small blind 800
FreedomDrums posts big blind 1600
Dealt to P1xel7 [Jc 8c]
*** PRE-FLOP *** 
pi-ratt-R2d2 folds
P1xel7 folds
bulleri5 folds
Dimix68 folds
novocio2929 folds
FreedomDrums collected 3600 from pot
*** SUMMARY ***
Total pot 3600 | No rake
Seat 6: FreedomDrums (big blind) won 3600


Winamax Poker - Tournament "X-MAS FEVER 5 € - DAY 1" buyIn: 4.50€ + 0.50€ level: 13 - HandId: #3150633295033663502-277-1703370286 - Holdem no limit (200/800/1600) - 2023/12/23 22:24:46 UTC
Table: 'X-MAS FEVER 5 € - DAY 1(733563978)#0013' 6-max (real money) Seat #5 is the button
Seat 1: pi-ratt-R2d2 (235576)
Seat 2: P1xel7 (28370)
Seat 3: bulleri5 (46437)
Seat 4: Dimix68 (147941)
Seat 5: novocio2929 (60751)
Seat 6: FreedomDrums (73887)
*** ANTE/BLINDS ***
FreedomDrums posts ante 200
pi-ratt-R2d2 posts ante 200
P1xel7 posts ante 200
bulleri5 posts ante 200
Dimix68 posts ante 200
novocio2929 posts ante 200
FreedomDrums posts small blind 800
pi-ratt-R2d2 posts big blind 1600
Dealt to P1xel7 [6s Th]
*** PRE-FLOP *** 
P1xel7 folds
bulleri5 raises 2400 to 4000
Dimix68 folds
novocio2929 folds
FreedomDrums folds
pi-ratt-R2d2 folds
bulleri5 collected 7600 from pot
*** SUMMARY ***
Total pot 7600 | No rake
Seat 3: bulleri5 won 7600


Winamax Poker - Tournament "X-MAS FEVER 5 € - DAY 1" buyIn: 4.50€ + 0.50€ level: 13 - HandId: #3150633295033663502-278-1703370302 - Holdem no limit (200/800/1600) - 2023/12/23 22:25:02 UTC
Table: 'X-MAS FEVER 5 € - DAY 1(733563978)#0013' 6-max (real money) Seat #6 is the button
Seat 1: pi-ratt-R2d2 (233776)
Seat 2: P1xel7 (28170)
Seat 3: bulleri5 (49837)
Seat 4: Dimix68 (147741)
Seat 5: novocio2929 (60551)
Seat 6: FreedomDrums (72887)
*** ANTE/BLINDS ***
pi-ratt-R2d2 posts ante 200
P1xel7 posts ante 200
bulleri5 posts ante 200
Dimix68 posts ante 200
novocio2929 posts ante 200
FreedomDrums posts ante 200
pi-ratt-R2d2 posts small blind 800
P1xel7 posts big blind 1600
Dealt to P1xel7 [6h Ac]
*** PRE-FLOP *** 
bulleri5 folds
Dimix68 folds
novocio2929 folds
FreedomDrums raises 1600 to 3200
pi-ratt-R2d2 folds
P1xel7 raises 24770 to 27970 and is all-in
FreedomDrums folds
P1xel7 collected 33170 from pot
*** SUMMARY ***
Total pot 33170 | No rake
Seat 2: P1xel7 (big blind) won 33170


Winamax Poker - Tournament "X-MAS FEVER 5 € - DAY 1" buyIn: 4.50€ + 0.50€ level: 13 - HandId: #3150633295033663502-279-1703370330 - Holdem no limit (200/800/1600) - 2023/12/23 22:25:30 UTC
Table: 'X-MAS FEVER 5 € - DAY 1(733563978)#0013' 6-max (real money) Seat #1 is the button
Seat 1: pi-ratt-R2d2 (232776)
Seat 2: P1xel7 (33170)
Seat 3: bulleri5 (49637)
Seat 4: Dimix68 (147541)
Seat 5: novocio2929 (60351)
Seat 6: FreedomDrums (69487)
*** ANTE/BLINDS ***
P1xel7 posts ante 200
bulleri5 posts ante 200
pi-ratt-R2d2 posts ante 200
Dimix68 posts ante 200
novocio2929 posts ante 200
FreedomDrums posts ante 200
P1xel7 posts small blind 800
bulleri5 posts big blind 1600
Dealt to P1xel7 [6c Ks]
*** PRE-FLOP *** 
Dimix68 folds
novocio2929 raises 1960 to 3560
FreedomDrums folds
pi-ratt-R2d2 raises 10720 to 14280
P1xel7 folds
bulleri5 folds
novocio2929 calls 10720
*** FLOP *** [9h 9c Kd]
novocio2929 checks
pi-ratt-R2d2 bets 20904
novocio2929 folds
pi-ratt-R2d2 collected 53064 from pot
*** SUMMARY ***
Total pot 53064 | No rake
Board: [9h 9c Kd]
Seat 1: pi-ratt-R2d2 (button) won 53064


Winamax Poker - Tournament "X-MAS FEVER 5 € - DAY 1" buyIn: 4.50€ + 0.50€ level: 13 - HandId: #3150633295033663502-280-1703370379 - Holdem no limit (200/800/1600) - 2023/12/23 22:26:19 UTC
Table: 'X-MAS FEVER 5 € - DAY 1(733563978)#0013' 6-max (real money) Seat #2 is the button
Seat 1: pi-ratt-R2d2 (250456)
Seat 2: P1xel7 (32170)
Seat 3: bulleri5 (47837)
Seat 4: Dimix68 (147341)
Seat 5: novocio2929 (45871)
Seat 6: FreedomDrums (69287)
*** ANTE/BLINDS ***
bulleri5 posts ante 200
Dimix68 posts ante 200
pi-ratt-R2d2 posts ante 200
P1xel7 posts ante 200
novocio2929 posts ante 200
FreedomDrums posts ante 200
bulleri5 posts small blind 800
Dimix68 posts big blind 1600
Dealt to P1xel7 [5d Ks]
*** PRE-FLOP *** 
novocio2929 folds
FreedomDrums folds
pi-ratt-R2d2 folds
P1xel7 folds
bulleri5 calls 800
Dimix68 checks
*** FLOP *** [2h Ac Js]
bulleri5 checks
Dimix68 bets 1600
bulleri5 folds
Dimix68 collected 6000 from pot
*** SUMMARY ***
Total pot 6000 | No rake
Board: [2h Ac Js]
Seat 4: Dimix68 (big blind) won 6000


Winamax Poker - Tournament "X-MAS FEVER 5 € - DAY 1" buyIn: 4.50€ + 0.50€ level: 13 - HandId: #3150633295033663502-281-1703370402 - Holdem no limit (200/800/1600) - 2023/12/23 22:26:42 UTC
Table: 'X-MAS FEVER 5 € - DAY 1(733563978)#0013' 6-max (real money) Seat #3 is the button
Seat 1: pi-ratt-R2d2 (250256)
Seat 2: P1xel7 (31970)
Seat 3: bulleri5 (46037)
Seat 4: Dimix68 (149941)
Seat 5: novocio2929 (45671)
Seat 6: FreedomDrums (69087)
*** ANTE/BLINDS ***
Dimix68 posts ante 200
novocio2929 posts ante 200
pi-ratt-R2d2 posts ante 200
P1xel7 posts ante 200
bulleri5 posts ante 200
FreedomDrums posts ante 200
Dimix68 posts small blind 800
novocio2929 posts big blind 1600
Dealt to P1xel7 [Js 5s]
*** PRE-FLOP *** 
FreedomDrums folds
pi-ratt-R2d2 folds
P1xel7 folds
bulleri5 raises 2400 to 4000
Dimix68 folds
novocio2929 calls 2400
*** FLOP *** [2c Ah 3s]
novocio2929 checks
bulleri5 bets 6500
novocio2929 folds
bulleri5 collected 16500 from pot
*** SUMMARY ***
Total pot 16500 | No rake
Board: [2c Ah 3s]
Seat 3: bulleri5 (button) won 16500


Winamax Poker - Tournament "X-MAS FEVER 5 € - DAY 1" buyIn: 4.50€ + 0.50€ level: 13 - HandId: #3150633295033663502-282-1703370432 - Holdem no limit (200/800/1600) - 2023/12/23 22:27:12 UTC
Table: 'X-MAS FEVER 5 € - DAY 1(733563978)#0013' 6-max (real money) Seat #4 is the button
Seat 1: pi-ratt-R2d2 (250056)
Seat 2: P1xel7 (31770)
Seat 3: bulleri5 (51837)
Seat 4: Dimix68 (148941)
Seat 5: novocio2929 (41471)
Seat 6: FreedomDrums (68887)
*** ANTE/BLINDS ***
novocio2929 posts ante 200
FreedomDrums posts ante 200
pi-ratt-R2d2 posts ante 200
P1xel7 posts ante 200
bulleri5 posts ante 200
Dimix68 posts ante 200
novocio2929 posts small blind 800
FreedomDrums posts big blind 1600
Dealt to P1xel7 [Qs 8s]
*** PRE-FLOP *** 
pi-ratt-R2d2 folds
P1xel7 folds
bulleri5 folds
Dimix68 raises 2400 to 4000
novocio2929 folds
FreedomDrums calls 2400
*** FLOP *** [5s Jh 6d]
FreedomDrums checks
Dimix68 bets 5000
FreedomDrums calls 5000
*** TURN *** [5s Jh 6d][9d]
FreedomDrums checks
Dimix68 bets 10000
FreedomDrums calls 10000
*** RIVER *** [5s Jh 6d 9d][7h]
FreedomDrums bets 4000
Dimix68 raises 48000 to 52000
FreedomDrums calls 45687 and is all-in
*** SHOW DOWN ***
Dimix68 shows [8d Qd] (Straight 9 high)
FreedomDrums shows [7s 8h] (Straight 9 high)
FreedomDrums collected 69687 from main pot
Dimix68 collected 72000 from side pot 1
*** SUMMARY ***
Total pot 141687 | No rake
Board: [5s Jh 6d 9d 7h]
Seat 4: Dimix68 (button) showed [8d Qd] and won 72000 with Straight 9 high
Seat 6: FreedomDrums (big blind) showed [7s 8h] and won 69687 with Straight 9 high


Winamax Poker - Tournament "X-MAS FEVER 5 € - DAY 1" buyIn: 4.50€ + 0.50€ level: 13 - HandId: #3150633295033663502-283-1703370495 - Holdem no limit (200/800/1600) - 2023/12/23 22:28:15 UTC
Table: 'X-MAS FEVER 5 € - DAY 1(733563978)#0013' 6-max (real money) Seat #5 is the button
Seat 1: pi-ratt-R2d2 (249856)
Seat 2: P1xel7 (31570)
Seat 3: bulleri5 (51637)
Seat 4: Dimix68 (149741)
Seat 5: novocio2929 (40471)
Seat 6: FreedomDrums (69687)
*** ANTE/BLINDS ***
FreedomDrums posts ante 200
pi-ratt-R2d2 posts ante 200
P1xel7 posts ante 200
bulleri5 posts ante 200
Dimix68 posts ante 200
novocio2929 posts ante 200
FreedomDrums posts small blind 800
pi-ratt-R2d2 posts big blind 1600
Dealt to P1xel7 [8d Qd]
*** PRE-FLOP *** 
P1xel7 folds
bulleri5 raises 2400 to 4000
Dimix68 calls 4000
novocio2929 folds
FreedomDrums raises 65487 to 69487 and is all-in
pi-ratt-R2d2 folds
bulleri5 folds
Dimix68 folds
FreedomDrums collected 80287 from pot
*** SUMMARY ***
Total pot 80287 | No rake
Seat 6: FreedomDrums (small blind) won 80287


Winamax Poker - Tournament "X-MAS FEVER 5 € - DAY 1" buyIn: 4.50€ + 0.50€ level: 13 - HandId: #3150633295033663502-284-1703370525 - Holdem no limit (200/800/1600) - 2023/12/23 22:28:45 UTC
Table: 'X-MAS FEVER 5 € - DAY 1(733563978)#0013' 6-max (real money) Seat #6 is the button
Seat 1: pi-ratt-R2d2 (248056)
Seat 2: P1xel7 (31370)
Seat 3: bulleri5 (47437)
Seat 4: Dimix68 (145541)
Seat 5: novocio2929 (40271)
Seat 6: FreedomDrums (80287)
*** ANTE/BLINDS ***
pi-ratt-R2d2 posts ante 200
P1xel7 posts ante 200
bulleri5 posts ante 200
Dimix68 posts ante 200
novocio2929 posts ante 200
FreedomDrums posts ante 200
pi-ratt-R2d2 posts small blind 800
P1xel7 posts big blind 1600
Dealt to P1xel7 [2s 4c]
*** PRE-FLOP *** 
bulleri5 folds
Dimix68 folds
novocio2929 folds
FreedomDrums raises 1600 to 3200
pi-ratt-R2d2 folds
P1xel7 folds
FreedomDrums collected 6800 from pot
*** SUMMARY ***
Total pot 6800 | No rake
Seat 6: FreedomDrums (button) won 6800


Winamax Poker - Tournament "X-MAS FEVER 5 € - DAY 1" buyIn: 4.50€ + 0.50€ level: 13 - HandId: #3150633295033663502-285-1703370551 - Holdem no limit (200/800/1600) - 2023/12/23 22:29:11 UTC
Table: 'X-MAS FEVER 5 € - DAY 1(733563978)#0013' 6-max (real money) Seat #1 is the button
Seat 1: pi-ratt-R2d2 (247056)
Seat 2: P1xel7 (29570)
Seat 3: bulleri5 (47237)
Seat 4: Dimix68 (145341)
Seat 5: novocio2929 (40071)
Seat 6: FreedomDrums (83687)
*** ANTE/BLINDS ***
P1xel7 posts ante 200
bulleri5 posts ante 200
pi-ratt-R2d2 posts ante 200
Dimix68 posts ante 200
novocio2929 posts ante 200
FreedomDrums posts ante 200
P1xel7 posts small blind 800
bulleri5 posts big blind 1600
Dealt to P1xel7 [Kh 9d]
*** PRE-FLOP *** 
Dimix68 folds
novocio2929 folds
FreedomDrums raises 1600 to 3200
pi-ratt-R2d2 folds
P1xel7 calls 2400
bulleri5 folds
*** FLOP *** [2d 5h 5s]
P1xel7 checks
FreedomDrums bets 1600
P1xel7 calls 1600
*** TURN *** [2d 5h 5s][4d]
P1xel7 checks
FreedomDrums bets 6200
P1xel7 folds
FreedomDrums collected 18600 from pot
*** SUMMARY ***
Total pot 18600 | No rake
Board: [2d 5h 5s 4d]
Seat 6: FreedomDrums won 18600


Winamax Poker - Tournament "X-MAS FEVER 5 € - DAY 1" buyIn: 4.50€ + 0.50€ level: 14 - HandId: #3150633295033663502-286-1703370609 - Holdem no limit (250/1000/2000) - 2023/12/23 22:30:09 UTC
Table: 'X-MAS FEVER 5 € - DAY 1(733563978)#0013' 6-max (real money) Seat #2 is the button
Seat 1: pi-ratt-R2d2 (246856)
Seat 2: P1xel7 (24570)
Seat 3: bulleri5 (45437)
Seat 4: Dimix68 (145141)
Seat 5: novocio2929 (39871)
Seat 6: FreedomDrums (91087)
*** ANTE/BLINDS ***
bulleri5 posts ante 250
Dimix68 posts ante 250
pi-ratt-R2d2 posts ante 250
P1xel7 posts ante 250
novocio2929 posts ante 250
FreedomDrums posts ante 250
bulleri5 posts small blind 1000
Dimix68 posts big blind 2000
Dealt to P1xel7 [Ah Td]
*** PRE-FLOP *** 
novocio2929 folds
FreedomDrums folds
pi-ratt-R2d2 folds
P1xel7 raises 22320 to 24320 and is all-in
bulleri5 folds
Dimix68 calls 22320
*** FLOP *** [Qs 6d 6s]
*** TURN *** [Qs 6d 6s][Kd]
*** RIVER *** [Qs 6d 6s Kd][Th]
*** SHOW DOWN ***
Dimix68 shows [As 5s] (One pair : 6)
P1xel7 shows [Ah Td] (Two pairs : Tens and 6)
P1xel7 collected 51140 from pot
*** SUMMARY ***
Total pot 51140 | No rake
Board: [Qs 6d 6s Kd Th]
Seat 2: P1xel7 (button) showed [Ah Td] and won 51140 with Two pairs : Tens and 6
Seat 4: Dimix68 (big blind) showed [As 5s] and lost with One pair : 6


Winamax Poker - Tournament "X-MAS FEVER 5 € - DAY 1" buyIn: 4.50€ + 0.50€ level: 14 - HandId: #3150633295033663502-287-1703370634 - Holdem no limit (250/1000/2000) - 2023/12/23 22:30:34 UTC
Table: 'X-MAS FEVER 5 € - DAY 1(733563978)#0013' 6-max (real money) Seat #3 is the button
Seat 1: pi-ratt-R2d2 (246606)
Seat 2: P1xel7 (51140)
Seat 3: bulleri5 (44187)
Seat 4: Dimix68 (120571)
Seat 5: novocio2929 (39621)
Seat 6: FreedomDrums (90837)
*** ANTE/BLINDS ***
Dimix68 posts ante 250
novocio2929 posts ante 250
pi-ratt-R2d2 posts ante 250
P1xel7 posts ante 250
bulleri5 posts ante 250
FreedomDrums posts ante 250
Dimix68 posts small blind 1000
novocio2929 posts big blind 2000
Dealt to P1xel7 [Th Ah]
*** PRE-FLOP *** 
FreedomDrums folds
pi-ratt-R2d2 folds
P1xel7 raises 2000 to 4000
bulleri5 folds
Dimix68 calls 3000
novocio2929 calls 2000
*** FLOP *** [Qs Qc 7c]
Dimix68 checks
novocio2929 checks
P1xel7 bets 4725
Dimix68 raises 17415 to 22140
novocio2929 folds
P1xel7 folds
Dimix68 collected 40365 from pot
*** SUMMARY ***
Total pot 40365 | No rake
Board: [Qs Qc 7c]
Seat 4: Dimix68 (small blind) won 40365


Winamax Poker - Tournament "X-MAS FEVER 5 € - DAY 1" buyIn: 4.50€ + 0.50€ level: 14 - HandId: #3150633295033663502-288-1703370677 - Holdem no limit (250/1000/2000) - 2023/12/23 22:31:17 UTC
Table: 'X-MAS FEVER 5 € - DAY 1(733563978)#0013' 6-max (real money) Seat #4 is the button
Seat 1: pi-ratt-R2d2 (246356)
Seat 2: P1xel7 (42165)
Seat 3: bulleri5 (43937)
Seat 4: Dimix68 (134546)
Seat 5: novocio2929 (35371)
Seat 6: FreedomDrums (90587)
*** ANTE/BLINDS ***
novocio2929 posts ante 250
FreedomDrums posts ante 250
pi-ratt-R2d2 posts ante 250
P1xel7 posts ante 250
bulleri5 posts ante 250
Dimix68 posts ante 250
novocio2929 posts small blind 1000
FreedomDrums posts big blind 2000
Dealt to P1xel7 [Jd Kh]
*** PRE-FLOP *** 
pi-ratt-R2d2 calls 2000
P1xel7 raises 6000 to 8000
bulleri5 folds
Dimix68 folds
novocio2929 folds
FreedomDrums folds
pi-ratt-R2d2 calls 6000
*** FLOP *** [6d Kd 2s]
pi-ratt-R2d2 checks
P1xel7 bets 7175
pi-ratt-R2d2 calls 7175
*** TURN *** [6d Kd 2s][7h]
pi-ratt-R2d2 checks
P1xel7 bets 26740 and is all-in
pi-ratt-R2d2 calls 26740
*** RIVER *** [6d Kd 2s 7h][6h]
*** SHOW DOWN ***
pi-ratt-R2d2 shows [Kc Ts] (Two pairs : Kings and 6)
P1xel7 shows [Jd Kh] (Two pairs : Kings and 6)
P1xel7 collected 88330 from pot
*** SUMMARY ***
Total pot 88330 | No rake
Board: [6d Kd 2s 7h 6h]
Seat 1: pi-ratt-R2d2 showed [Kc Ts] and lost with Two pairs : Kings and 6
Seat 2: P1xel7 showed [Jd Kh] and won 88330 with Two pairs : Kings and 6


Winamax Poker - Tournament "X-MAS FEVER 5 € - DAY 1" buyIn: 4.50€ + 0.50€ level: 14 - HandId: #3150633295033663502-289-1703370712 - Holdem no limit (250/1000/2000) - 2023/12/23 22:31:52 UTC
Table: 'X-MAS FEVER 5 € - DAY 1(733563978)#0013' 6-max (real money) Seat #5 is the button
Seat 1: pi-ratt-R2d2 (204191)
Seat 2: P1xel7 (88330)
Seat 3: bulleri5 (43687)
Seat 4: Dimix68 (134296)
Seat 5: novocio2929 (34121)
Seat 6: FreedomDrums (88337)
*** ANTE/BLINDS ***
FreedomDrums posts ante 250
pi-ratt-R2d2 posts ante 250
P1xel7 posts ante 250
bulleri5 posts ante 250
Dimix68 posts ante 250
novocio2929 posts ante 250
FreedomDrums posts small blind 1000
pi-ratt-R2d2 posts big blind 2000
Dealt to P1xel7 [7s As]
*** PRE-FLOP *** 
P1xel7 folds
bulleri5 folds
Dimix68 folds
novocio2929 folds
FreedomDrums calls 1000
pi-ratt-R2d2 checks
*** FLOP *** [7h 6h Qs]
FreedomDrums bets 2000
pi-ratt-R2d2 calls 2000
*** TURN *** [7h 6h Qs][8h]
FreedomDrums bets 7125
pi-ratt-R2d2 calls 7125
*** RIVER *** [7h 6h Qs 8h][2h]
FreedomDrums bets 7838
pi-ratt-R2d2 calls 7838
*** SHOW DOWN ***
pi-ratt-R2d2 shows [8s 4h] (Flush 8 high)
FreedomDrums shows [Jh Qd] (Flush Jack high)
FreedomDrums collected 39426 from pot
*** SUMMARY ***
Total pot 39426 | No rake
Board: [7h 6h Qs 8h 2h]
Seat 1: pi-ratt-R2d2 (big blind) showed [8s 4h] and lost with Flush 8 high
Seat 6: FreedomDrums (small blind) showed [Jh Qd] and won 39426 with Flush Jack high


Winamax Poker - Tournament "X-MAS FEVER 5 € - DAY 1" buyIn: 4.50€ + 0.50€ level: 14 - HandId: #3150633295033663502-290-1703370756 - Holdem no limit (250/1000/2000) - 2023/12/23 22:32:36 UTC
Table: 'X-MAS FEVER 5 € - DAY 1(733563978)#0013' 6-max (real money) Seat #6 is the button
Seat 1: pi-ratt-R2d2 (184978)
Seat 2: P1xel7 (88080)
Seat 3: bulleri5 (43437)
Seat 4: Dimix68 (134046)
Seat 5: novocio2929 (33871)
Seat 6: FreedomDrums (108550)
*** ANTE/BLINDS ***
pi-ratt-R2d2 posts ante 250
P1xel7 posts ante 250
bulleri5 posts ante 250
Dimix68 posts ante 250
novocio2929 posts ante 250
FreedomDrums posts ante 250
pi-ratt-R2d2 posts small blind 1000
P1xel7 posts big blind 2000
Dealt to P1xel7 [6c 8s]
*** PRE-FLOP *** 
bulleri5 folds
Dimix68 folds
novocio2929 raises 2670 to 4670
FreedomDrums folds
pi-ratt-R2d2 folds
P1xel7 folds
novocio2929 collected 9170 from pot
*** SUMMARY ***
Total pot 9170 | No rake
Seat 5: novocio2929 won 9170


Winamax Poker - Tournament "X-MAS FEVER 5 € - DAY 1" buyIn: 4.50€ + 0.50€ level: 14 - HandId: #3150633295033663502-291-1703370771 - Holdem no limit (250/1000/2000) - 2023/12/23 22:32:51 UTC
Table: 'X-MAS FEVER 5 € - DAY 1(733563978)#0013' 6-max (real money) Seat #1 is the button
Seat 1: pi-ratt-R2d2 (183728)
Seat 2: P1xel7 (85830)
Seat 3: bulleri5 (43187)
Seat 4: Dimix68 (133796)
Seat 5: novocio2929 (38121)
Seat 6: FreedomDrums (108300)
*** ANTE/BLINDS ***
P1xel7 posts ante 250
bulleri5 posts ante 250
pi-ratt-R2d2 posts ante 250
Dimix68 posts ante 250
novocio2929 posts ante 250
FreedomDrums posts ante 250
P1xel7 posts small blind 1000
bulleri5 posts big blind 2000
Dealt to P1xel7 [Ts 9c]
*** PRE-FLOP *** 
Dimix68 raises 3000 to 5000
novocio2929 folds
FreedomDrums folds
pi-ratt-R2d2 folds
P1xel7 folds
bulleri5 raises 37937 to 42937 and is all-in
Dimix68 calls 37937
*** FLOP *** [Ks Kh 8s]
*** TURN *** [Ks Kh 8s][2s]
*** RIVER *** [Ks Kh 8s 2s][As]
*** SHOW DOWN ***
bulleri5 shows [9h Ad] (Two pairs : Aces and Kings)
Dimix68 shows [Ah Ac] (Full of Aces and Kings)
Dimix68 collected 88374 from pot
*** SUMMARY ***
Total pot 88374 | No rake
Board: [Ks Kh 8s 2s As]
Seat 3: bulleri5 (big blind) showed [9h Ad] and lost with Two pairs : Aces and Kings
Seat 4: Dimix68 showed [Ah Ac] and won 88374 with Full of Aces and Kings


Winamax Poker - Tournament "X-MAS FEVER 5 € - DAY 1" buyIn: 4.50€ + 0.50€ level: 14 - HandId: #3150633295033663502-292-1703370792 - Holdem no limit (250/1000/2000) - 2023/12/23 22:33:12 UTC
Table: 'X-MAS FEVER 5 € - DAY 1(733563978)#0013' 6-max (real money) Seat #2 is the button
Seat 1: pi-ratt-R2d2 (183478)
Seat 2: P1xel7 (84580)
Seat 4: Dimix68 (178983)
Seat 5: novocio2929 (37871)
Seat 6: FreedomDrums (108050)
*** ANTE/BLINDS ***
Dimix68 posts ante 250
pi-ratt-R2d2 posts ante 250
P1xel7 posts ante 250
novocio2929 posts ante 250
FreedomDrums posts ante 250
Dimix68 posts big blind 2000
Dealt to P1xel7 [8h Ks]
*** PRE-FLOP *** 
novocio2929 folds
FreedomDrums raises 2000 to 4000
pi-ratt-R2d2 folds
P1xel7 folds
Dimix68 calls 2000
*** FLOP *** [Jc Qd 9h]
Dimix68 checks
FreedomDrums bets 6938
Dimix68 calls 6938
*** TURN *** [Jc Qd 9h][9s]
Dimix68 checks
FreedomDrums checks
*** RIVER *** [Jc Qd 9h 9s][6s]
Dimix68 bets 11563
FreedomDrums folds
Dimix68 collected 34689 from pot
*** SUMMARY ***
Total pot 34689 | No rake
Board: [Jc Qd 9h 9s 6s]
Seat 4: Dimix68 (big blind) won 34689


Winamax Poker - Tournament "X-MAS FEVER 5 € - DAY 1" buyIn: 4.50€ + 0.50€ level: 14 - HandId: #3150633295033663502-293-1703370847 - Holdem no limit (250/1000/2000) - 2023/12/23 22:34:07 UTC
Table: 'X-MAS FEVER 5 € - DAY 1(733563978)#0013' 6-max (real money) Seat #3 is the button
Seat 1: pi-ratt-R2d2 (183228)
Seat 2: P1xel7 (84330)
Seat 3: RizdeCanard (331073)
Seat 4: Dimix68 (190921)
Seat 5: novocio2929 (37621)
Seat 6: FreedomDrums (96862)
*** ANTE/BLINDS ***
Dimix68 posts ante 250
novocio2929 posts ante 250
pi-ratt-R2d2 posts ante 250
P1xel7 posts ante 250
FreedomDrums posts ante 250
Dimix68 posts small blind 1000
novocio2929 posts big blind 2000
Dealt to P1xel7 [6d 9s]
*** PRE-FLOP *** 
FreedomDrums folds
pi-ratt-R2d2 folds
P1xel7 folds
Dimix68 folds
novocio2929 collected 4250 from pot
*** SUMMARY ***
Total pot 4250 | No rake
Seat 5: novocio2929 (big blind) won 4250


Winamax Poker - Tournament "X-MAS FEVER 5 € - DAY 1" buyIn: 4.50€ + 0.50€ level: 14 - HandId: #3150633295033663502-294-1703370857 - Holdem no limit (250/1000/2000) - 2023/12/23 22:34:17 UTC
Table: 'X-MAS FEVER 5 € - DAY 1(733563978)#0013' 6-max (real money) Seat #4 is the button
Seat 1: pi-ratt-R2d2 (182978)
Seat 2: P1xel7 (84080)
Seat 3: RizdeCanard (331073)
Seat 4: Dimix68 (189671)
Seat 5: novocio2929 (39621)
Seat 6: FreedomDrums (96612)
*** ANTE/BLINDS ***
novocio2929 posts ante 250
FreedomDrums posts ante 250
pi-ratt-R2d2 posts ante 250
P1xel7 posts ante 250
RizdeCanard posts ante 250
Dimix68 posts ante 250
novocio2929 posts small blind 1000
FreedomDrums posts big blind 2000
Dealt to P1xel7 [2s 3d]
*** PRE-FLOP *** 
pi-ratt-R2d2 folds
P1xel7 folds
RizdeCanard folds
Dimix68 folds
novocio2929 raises 37371 to 39371 and is all-in
FreedomDrums calls 37371
*** FLOP *** [4d Ah Tc]
*** TURN *** [4d Ah Tc][Qc]
*** RIVER *** [4d Ah Tc Qc][Qs]
*** SHOW DOWN ***
novocio2929 shows [6h Kh] (One pair : Queens)
FreedomDrums shows [6d Ac] (Two pairs : Aces and Queens)
FreedomDrums collected 80242 from pot
*** SUMMARY ***
Total pot 80242 | No rake
Board: [4d Ah Tc Qc Qs]
Seat 5: novocio2929 (small blind) showed [6h Kh] and lost with One pair : Queens
Seat 6: FreedomDrums (big blind) showed [6d Ac] and won 80242 with Two pairs : Aces and Queens


Winamax Poker - Tournament "X-MAS FEVER 5 € - DAY 1" buyIn: 4.50€ + 0.50€ level: 14 - HandId: #3150633295033663502-295-1703370906 - Holdem no limit (250/1000/2000) - 2023/12/23 22:35:06 UTC
Table: 'X-MAS FEVER 5 € - DAY 1(733563978)#0013' 6-max (real money) Seat #5 is the button
Seat 1: pi-ratt-R2d2 (182728)
Seat 2: P1xel7 (83830)
Seat 3: RizdeCanard (330823)
Seat 4: Dimix68 (189421)
Seat 6: FreedomDrums (137233)
*** ANTE/BLINDS ***
FreedomDrums posts ante 250
pi-ratt-R2d2 posts ante 250
P1xel7 posts ante 250
RizdeCanard posts ante 250
Dimix68 posts ante 250
FreedomDrums posts small blind 1000
pi-ratt-R2d2 posts big blind 2000
Dealt to P1xel7 [Kc Td]
*** PRE-FLOP *** 
P1xel7 folds
RizdeCanard folds
Dimix68 folds
FreedomDrums calls 1000
pi-ratt-R2d2 checks
*** FLOP *** [5c 8c 2h]
FreedomDrums checks
pi-ratt-R2d2 bets 2000
FreedomDrums calls 2000
*** TURN *** [5c 8c 2h][Jd]
FreedomDrums checks
pi-ratt-R2d2 bets 3238
FreedomDrums calls 3238
*** RIVER *** [5c 8c 2h Jd][3d]
FreedomDrums checks
pi-ratt-R2d2 checks
*** SHOW DOWN ***
pi-ratt-R2d2 shows [9h 5d] (One pair : 5)
FreedomDrums shows [4s As] (Straight 5 high)
FreedomDrums collected 15726 from pot
*** SUMMARY ***
Total pot 15726 | No rake
Board: [5c 8c 2h Jd 3d]
Seat 1: pi-ratt-R2d2 (big blind) showed [9h 5d] and lost with One pair : 5
Seat 6: FreedomDrums (small blind) showed [4s As] and won 15726 with Straight 5 high


Winamax Poker - Tournament "X-MAS FEVER 5 € - DAY 1" buyIn: 4.50€ + 0.50€ level: 14 - HandId: #3150633295033663502-296-1703370952 - Holdem no limit (250/1000/2000) - 2023/12/23 22:35:52 UTC
Table: 'X-MAS FEVER 5 € - DAY 1(733563978)#0013' 6-max (real money) Seat #6 is the button
Seat 1: pi-ratt-R2d2 (175240)
Seat 2: P1xel7 (83580)
Seat 3: RizdeCanard (330573)
Seat 4: Dimix68 (189171)
Seat 5: O.PicsoU (64457)
Seat 6: FreedomDrums (145471)
*** ANTE/BLINDS ***
pi-ratt-R2d2 posts ante 250
P1xel7 posts ante 250
RizdeCanard posts ante 250
Dimix68 posts ante 250
O.PicsoU posts ante 250
FreedomDrums posts ante 250
pi-ratt-R2d2 posts small blind 1000
P1xel7 posts big blind 2000
Dealt to P1xel7 [7c 3h]
*** PRE-FLOP *** 
RizdeCanard folds
Dimix68 raises 2000 to 4000
O.PicsoU folds
FreedomDrums folds
pi-ratt-R2d2 folds
P1xel7 folds
Dimix68 collected 8500 from pot
*** SUMMARY ***
Total pot 8500 | No rake
Seat 4: Dimix68 won 8500


Winamax Poker - Tournament "X-MAS FEVER 5 € - DAY 1" buyIn: 4.50€ + 0.50€ level: 14 - HandId: #3150633295033663502-297-1703370972 - Holdem no limit (250/1000/2000) - 2023/12/23 22:36:12 UTC
Table: 'X-MAS FEVER 5 € - DAY 1(733563978)#0013' 6-max (real money) Seat #1 is the button
Seat 1: pi-ratt-R2d2 (173990)
Seat 2: P1xel7 (81330)
Seat 3: RizdeCanard (330323)
Seat 4: Dimix68 (193421)
Seat 5: O.PicsoU (64207)
Seat 6: FreedomDrums (145221)
*** ANTE/BLINDS ***
P1xel7 posts ante 250
RizdeCanard posts ante 250
pi-ratt-R2d2 posts ante 250
Dimix68 posts ante 250
O.PicsoU posts ante 250
FreedomDrums posts ante 250
P1xel7 posts small blind 1000
RizdeCanard posts big blind 2000
Dealt to P1xel7 [4c Tc]
*** PRE-FLOP *** 
Dimix68 folds
O.PicsoU folds
FreedomDrums raises 2000 to 4000
pi-ratt-R2d2 calls 4000
P1xel7 folds
RizdeCanard calls 2000
*** FLOP *** [Jd Th Qc]
RizdeCanard checks
FreedomDrums checks
pi-ratt-R2d2 checks
*** TURN *** [Jd Th Qc][Jc]
RizdeCanard checks
FreedomDrums bets 10875
pi-ratt-R2d2 folds
RizdeCanard folds
FreedomDrums collected 25375 from pot
*** SUMMARY ***
Total pot 25375 | No rake
Board: [Jd Th Qc Jc]
Seat 6: FreedomDrums won 25375


Winamax Poker - Tournament "X-MAS FEVER 5 € - DAY 1" buyIn: 4.50€ + 0.50€ level: 14 - HandId: #3150633295033663502-298-1703371015 - Holdem no limit (250/1000/2000) - 2023/12/23 22:36:55 UTC
Table: 'X-MAS FEVER 5 € - DAY 1(733563978)#0013' 6-max (real money) Seat #2 is the button
Seat 1: pi-ratt-R2d2 (169740)
Seat 2: P1xel7 (80080)
Seat 3: RizdeCanard (326073)
Seat 4: Dimix68 (193171)
Seat 5: O.PicsoU (63957)
Seat 6: FreedomDrums (155471)
*** ANTE/BLINDS ***
RizdeCanard posts ante 250
Dimix68 posts ante 250
pi-ratt-R2d2 posts ante 250
P1xel7 posts ante 250
O.PicsoU posts ante 250
FreedomDrums posts ante 250
RizdeCanard posts small blind 1000
Dimix68 posts big blind 2000
Dealt to P1xel7 [8d 2d]
*** PRE-FLOP *** 
O.PicsoU folds
FreedomDrums folds
pi-ratt-R2d2 folds
P1xel7 folds
RizdeCanard raises 5000 to 7000
Dimix68 folds
RizdeCanard collected 10500 from pot
*** SUMMARY ***
Total pot 10500 | No rake
Seat 3: RizdeCanard (small blind) won 10500


Winamax Poker - Tournament "X-MAS FEVER 5 € - DAY 1" buyIn: 4.50€ + 0.50€ level: 14 - HandId: #3150633295033663502-299-1703371090 - Holdem no limit (250/1000/2000) - 2023/12/23 22:38:10 UTC
Table: 'X-MAS FEVER 5 € - DAY 1(733563978)#0013' 6-max (real money) Seat #3 is the button
Seat 1: pi-ratt-R2d2 (169490)
Seat 2: P1xel7 (79830)
Seat 3: RizdeCanard (329323)
Seat 4: Dimix68 (190921)
Seat 5: O.PicsoU (63707)
Seat 6: FreedomDrums (155221)
*** ANTE/BLINDS ***
Dimix68 posts ante 250
O.PicsoU posts ante 250
pi-ratt-R2d2 posts ante 250
P1xel7 posts ante 250
RizdeCanard posts ante 250
FreedomDrums posts ante 250
Dimix68 posts small blind 1000
O.PicsoU posts big blind 2000
Dealt to P1xel7 [3s Jh]
*** PRE-FLOP *** 
FreedomDrums raises 2000 to 4000
pi-ratt-R2d2 calls 4000
P1xel7 folds
RizdeCanard raises 12000 to 16000
Dimix68 folds
O.PicsoU folds
FreedomDrums raises 138971 to 154971 and is all-in
pi-ratt-R2d2 folds
RizdeCanard folds
FreedomDrums collected 179471 from pot
*** SUMMARY ***
Total pot 179471 | No rake
Seat 6: FreedomDrums won 179471


Winamax Poker - Tournament "X-MAS FEVER 5 € - DAY 1" buyIn: 4.50€ + 0.50€ level: 14 - HandId: #3150633295033663502-300-1703371130 - Holdem no limit (250/1000/2000) - 2023/12/23 22:38:50 UTC
Table: 'X-MAS FEVER 5 € - DAY 1(733563978)#0013' 6-max (real money) Seat #4 is the button
Seat 1: pi-ratt-R2d2 (165240)
Seat 2: P1xel7 (79580)
Seat 3: RizdeCanard (313073)
Seat 4: Dimix68 (189671)
Seat 5: O.PicsoU (61457)
Seat 6: FreedomDrums (179471)
*** ANTE/BLINDS ***
O.PicsoU posts ante 250
FreedomDrums posts ante 250
pi-ratt-R2d2 posts ante 250
P1xel7 posts ante 250
RizdeCanard posts ante 250
Dimix68 posts ante 250
O.PicsoU posts small blind 1000
FreedomDrums posts big blind 2000
Dealt to P1xel7 [7h 5c]
*** PRE-FLOP *** 
pi-ratt-R2d2 folds
P1xel7 folds
RizdeCanard raises 2000 to 4000
Dimix68 folds
O.PicsoU calls 3000
FreedomDrums raises 16000 to 20000
RizdeCanard calls 16000
O.PicsoU folds
*** FLOP *** [9s Qs Kh]
FreedomDrums bets 15015
RizdeCanard raises 30258 to 45273
FreedomDrums folds
RizdeCanard collected 105788 from pot
*** SUMMARY ***
Total pot 105788 | No rake
Board: [9s Qs Kh]
Seat 3: RizdeCanard won 105788


Winamax Poker - Tournament "X-MAS FEVER 5 € - DAY 1" buyIn: 4.50€ + 0.50€ level: 14 - HandId: #3150633295033663502-301-1703371210 - Holdem no limit (250/1000/2000) - 2023/12/23 22:40:10 UTC
Table: 'X-MAS FEVER 5 € - DAY 1(733563978)#0013' 6-max (real money) Seat #5 is the button
Seat 1: pi-ratt-R2d2 (164990)
Seat 2: P1xel7 (79330)
Seat 3: RizdeCanard (353338)
Seat 4: Dimix68 (189421)
Seat 5: O.PicsoU (57207)
Seat 6: FreedomDrums (144206)
*** ANTE/BLINDS ***
FreedomDrums posts ante 250
pi-ratt-R2d2 posts ante 250
P1xel7 posts ante 250
RizdeCanard posts ante 250
Dimix68 posts ante 250
O.PicsoU posts ante 250
FreedomDrums posts small blind 1000
pi-ratt-R2d2 posts big blind 2000
Dealt to P1xel7 [8h 5s]
*** PRE-FLOP *** 
P1xel7 folds
RizdeCanard folds
Dimix68 folds
O.PicsoU raises 3000 to 5000
FreedomDrums raises 12500 to 17500
pi-ratt-R2d2 folds
O.PicsoU folds
FreedomDrums collected 26000 from pot
*** SUMMARY ***
Total pot 26000 | No rake
Seat 6: FreedomDrums (small blind) won 26000


Winamax Poker - Tournament "X-MAS FEVER 5 € - DAY 1" buyIn: 4.50€ + 0.50€ level: 14 - HandId: #3150633295033663502-302-1703371242 - Holdem no limit (250/1000/2000) - 2023/12/23 22:40:42 UTC
Table: 'X-MAS FEVER 5 € - DAY 1(733563978)#0013' 6-max (real money) Seat #6 is the button
Seat 1: pi-ratt-R2d2 (162740)
Seat 2: P1xel7 (79080)
Seat 3: RizdeCanard (353088)
Seat 4: Dimix68 (189171)
Seat 5: O.PicsoU (51957)
Seat 6: FreedomDrums (152456)
*** ANTE/BLINDS ***
pi-ratt-R2d2 posts ante 250
P1xel7 posts ante 250
RizdeCanard posts ante 250
Dimix68 posts ante 250
O.PicsoU posts ante 250
FreedomDrums posts ante 250
pi-ratt-R2d2 posts small blind 1000
P1xel7 posts big blind 2000
Dealt to P1xel7 [Qc 7h]
*** PRE-FLOP *** 
RizdeCanard raises 2000 to 4000
Dimix68 folds
O.PicsoU folds
FreedomDrums raises 8000 to 12000
pi-ratt-R2d2 folds
P1xel7 folds
RizdeCanard calls 8000
*** FLOP *** [2h 7s 6s]
RizdeCanard checks
FreedomDrums checks
*** TURN *** [2h 7s 6s][2c]
RizdeCanard bets 22800
FreedomDrums folds
RizdeCanard collected 51300 from pot
*** SUMMARY ***
Total pot 51300 | No rake
Board: [2h 7s 6s 2c]
Seat 3: RizdeCanard won 51300


Winamax Poker - Tournament "X-MAS FEVER 5 € - DAY 1" buyIn: 4.50€ + 0.50€ level: 15 - HandId: #3150633295033663502-303-1703371286 - Holdem no limit (300/1250/2500) - 2023/12/23 22:41:26 UTC
Table: 'X-MAS FEVER 5 € - DAY 1(733563978)#0013' 6-max (real money) Seat #1 is the button
Seat 1: pi-ratt-R2d2 (161490)
Seat 2: P1xel7 (76830)
Seat 3: RizdeCanard (369338)
Seat 4: Dimix68 (188921)
Seat 5: O.PicsoU (51707)
Seat 6: FreedomDrums (140206)
*** ANTE/BLINDS ***
P1xel7 posts ante 300
RizdeCanard posts ante 300
pi-ratt-R2d2 posts ante 300
Dimix68 posts ante 300
O.PicsoU posts ante 300
FreedomDrums posts ante 300
P1xel7 posts small blind 1250
RizdeCanard posts big blind 2500
Dealt to P1xel7 [Tc 3h]
*** PRE-FLOP *** 
Dimix68 folds
O.PicsoU folds
FreedomDrums raises 2500 to 5000
pi-ratt-R2d2 folds
P1xel7 folds
RizdeCanard calls 2500
*** FLOP *** [7s Ks Jh]
RizdeCanard checks
FreedomDrums bets 9788
RizdeCanard folds
FreedomDrums collected 22838 from pot
*** SUMMARY ***
Total pot 22838 | No rake
Board: [7s Ks Jh]
Seat 6: FreedomDrums won 22838


Winamax Poker - Tournament "X-MAS FEVER 5 € - DAY 1" buyIn: 4.50€ + 0.50€ level: 15 - HandId: #3150633295033663502-304-1703371335 - Holdem no limit (300/1250/2500) - 2023/12/23 22:42:15 UTC
Table: 'X-MAS FEVER 5 € - DAY 1(733563978)#0013' 6-max (real money) Seat #2 is the button
Seat 1: pi-ratt-R2d2 (161190)
Seat 2: P1xel7 (75280)
Seat 3: RizdeCanard (364038)
Seat 4: Dimix68 (188621)
Seat 5: O.PicsoU (51407)
Seat 6: FreedomDrums (147956)
*** ANTE/BLINDS ***
RizdeCanard posts ante 300
Dimix68 posts ante 300
pi-ratt-R2d2 posts ante 300
P1xel7 posts ante 300
O.PicsoU posts ante 300
FreedomDrums posts ante 300
RizdeCanard posts small blind 1250
Dimix68 posts big blind 2500
Dealt to P1xel7 [8d 5d]
*** PRE-FLOP *** 
O.PicsoU folds
FreedomDrums folds
pi-ratt-R2d2 folds
P1xel7 folds
RizdeCanard folds
Dimix68 collected 5550 from pot
*** SUMMARY ***
Total pot 5550 | No rake
Seat 4: Dimix68 (big blind) won 5550


Winamax Poker - Tournament "X-MAS FEVER 5 € - DAY 1" buyIn: 4.50€ + 0.50€ level: 15 - HandId: #3150633295033663502-305-1703371354 - Holdem no limit (300/1250/2500) - 2023/12/23 22:42:34 UTC
Table: 'X-MAS FEVER 5 € - DAY 1(733563978)#0013' 6-max (real money) Seat #3 is the button
Seat 1: pi-ratt-R2d2 (160890)
Seat 2: P1xel7 (74980)
Seat 3: RizdeCanard (362488)
Seat 4: Dimix68 (191371)
Seat 5: O.PicsoU (51107)
Seat 6: FreedomDrums (147656)
*** ANTE/BLINDS ***
Dimix68 posts ante 300
O.PicsoU posts ante 300
pi-ratt-R2d2 posts ante 300
P1xel7 posts ante 300
RizdeCanard posts ante 300
FreedomDrums posts ante 300
Dimix68 posts small blind 1250
O.PicsoU posts big blind 2500
Dealt to P1xel7 [Qh Jc]
*** PRE-FLOP *** 
FreedomDrums folds
pi-ratt-R2d2 calls 2500
P1xel7 raises 6250 to 8750
RizdeCanard folds
Dimix68 folds
O.PicsoU calls 6250
pi-ratt-R2d2 calls 6250
*** FLOP *** [3s Js 5h]
O.PicsoU checks
pi-ratt-R2d2 checks
P1xel7 bets 10255
O.PicsoU folds
pi-ratt-R2d2 calls 10255
*** TURN *** [3s Js 5h][Th]
pi-ratt-R2d2 checks
P1xel7 bets 17434
pi-ratt-R2d2 raises 84678 to 102112
P1xel7 calls 38241 and is all-in
*** RIVER *** [3s Js 5h Th][3h]
*** SHOW DOWN ***
pi-ratt-R2d2 shows [8s 8d] (Two pairs : 8 and 3)
P1xel7 shows [Qh Jc] (Two pairs : Jacks and 3)
P1xel7 collected 161160 from main pot
pi-ratt-R2d2 collected 46437 from side pot 1
*** SUMMARY ***
Total pot 207597 | No rake
Board: [3s Js 5h Th 3h]
Seat 1: pi-ratt-R2d2 showed [8s 8d] and won 46437 with Two pairs : 8 and 3
Seat 2: P1xel7 showed [Qh Jc] and won 161160 with Two pairs : Jacks and 3


Winamax Poker - Tournament "X-MAS FEVER 5 € - DAY 1" buyIn: 4.50€ + 0.50€ level: 15 - HandId: #3150633295033663502-306-1703371427 - Holdem no limit (300/1250/2500) - 2023/12/23 22:43:47 UTC
Table: 'X-MAS FEVER 5 € - DAY 1(733563978)#0013' 6-max (real money) Seat #4 is the button
Seat 1: pi-ratt-R2d2 (85910)
Seat 2: P1xel7 (161160)
Seat 3: RizdeCanard (362188)
Seat 4: Dimix68 (189821)
Seat 5: O.PicsoU (42057)
Seat 6: FreedomDrums (147356)
*** ANTE/BLINDS ***
O.PicsoU posts ante 300
FreedomDrums posts ante 300
pi-ratt-R2d2 posts ante 300
P1xel7 posts ante 300
RizdeCanard posts ante 300
Dimix68 posts ante 300
O.PicsoU posts small blind 1250
FreedomDrums posts big blind 2500
Dealt to P1xel7 [9c 9s]
*** PRE-FLOP *** 
pi-ratt-R2d2 calls 2500
P1xel7 raises 6250 to 8750
RizdeCanard folds
Dimix68 folds
O.PicsoU folds
FreedomDrums folds
pi-ratt-R2d2 calls 6250
*** FLOP *** [Ks 5d 4h]
pi-ratt-R2d2 checks
P1xel7 bets 8068
pi-ratt-R2d2 calls 8068
*** TURN *** [Ks 5d 4h][3h]
pi-ratt-R2d2 checks
P1xel7 bets 13715
pi-ratt-R2d2 raises 55077 to 68792 and is all-in
P1xel7 folds
pi-ratt-R2d2 collected 121693 from pot
*** SUMMARY ***
Total pot 121693 | No rake
Board: [Ks 5d 4h 3h]
Seat 1: pi-ratt-R2d2 won 121693


Winamax Poker - Tournament "X-MAS FEVER 5 € - DAY 1" buyIn: 4.50€ + 0.50€ level: 15 - HandId: #3150633295033663502-307-1703371517 - Holdem no limit (300/1250/2500) - 2023/12/23 22:45:17 UTC
Table: 'X-MAS FEVER 5 € - DAY 1(733563978)#0013' 6-max (real money) Seat #5 is the button
Seat 1: pi-ratt-R2d2 (121693)
Seat 2: P1xel7 (130327)
Seat 3: RizdeCanard (361888)
Seat 4: Dimix68 (189521)
Seat 5: O.PicsoU (40507)
Seat 6: FreedomDrums (144556)
*** ANTE/BLINDS ***
FreedomDrums posts ante 300
pi-ratt-R2d2 posts ante 300
P1xel7 posts ante 300
RizdeCanard posts ante 300
Dimix68 posts ante 300
O.PicsoU posts ante 300
FreedomDrums posts small blind 1250
pi-ratt-R2d2 posts big blind 2500
Dealt to P1xel7 [Qs 6s]
*** PRE-FLOP *** 
P1xel7 folds
RizdeCanard folds
Dimix68 folds
O.PicsoU folds
FreedomDrums calls 1250
pi-ratt-R2d2 raises 5000 to 7500
FreedomDrums calls 5000
*** FLOP *** [6h 7d 9h]
FreedomDrums checks
pi-ratt-R2d2 bets 10920
FreedomDrums calls 10920
*** TURN *** [6h 7d 9h][8d]
FreedomDrums checks
pi-ratt-R2d2 checks
*** RIVER *** [6h 7d 9h 8d][7s]
FreedomDrums bets 25116
pi-ratt-R2d2 calls 25116
*** SHOW DOWN ***
FreedomDrums shows [3s Ts] (Straight Ten high)
pi-ratt-R2d2 shows [Jh Tc] (Straight Jack high)
pi-ratt-R2d2 collected 88872 from pot
*** SUMMARY ***
Total pot 88872 | No rake
Board: [6h 7d 9h 8d 7s]
Seat 1: pi-ratt-R2d2 (big blind) showed [Jh Tc] and won 88872 with Straight Jack high
Seat 6: FreedomDrums (small blind) showed [3s Ts] and lost with Straight Ten high


Winamax Poker - Tournament "X-MAS FEVER 5 € - DAY 1" buyIn: 4.50€ + 0.50€ level: 15 - HandId: #3150633295033663502-308-1703371589 - Holdem no limit (300/1250/2500) - 2023/12/23 22:46:29 UTC
Table: 'X-MAS FEVER 5 € - DAY 1(733563978)#0013' 6-max (real money) Seat #6 is the button
Seat 1: pi-ratt-R2d2 (166729)
Seat 2: P1xel7 (130027)
Seat 3: RizdeCanard (361588)
Seat 4: Dimix68 (189221)
Seat 5: O.PicsoU (40207)
Seat 6: FreedomDrums (100720)
*** ANTE/BLINDS ***
pi-ratt-R2d2 posts ante 300
P1xel7 posts ante 300
RizdeCanard posts ante 300
Dimix68 posts ante 300
O.PicsoU posts ante 300
FreedomDrums posts ante 300
pi-ratt-R2d2 posts small blind 1250
P1xel7 posts big blind 2500
Dealt to P1xel7 [As Kc]
*** PRE-FLOP *** 
RizdeCanard folds
Dimix68 folds
O.PicsoU folds
FreedomDrums raises 2500 to 5000
pi-ratt-R2d2 folds
P1xel7 calls 2500
*** FLOP *** [6h Ks Ad]
P1xel7 checks
FreedomDrums bets 3263
P1xel7 calls 3263
*** TURN *** [6h Ks Ad][7c]
P1xel7 checks
FreedomDrums bets 15000
P1xel7 raises 22500 to 37500
FreedomDrums raises 54657 to 92157 and is all-in
P1xel7 calls 54657
*** RIVER *** [6h Ks Ad 7c][Jd]
*** SHOW DOWN ***
FreedomDrums shows [Ac 6c] (Two pairs : Aces and 6)
P1xel7 shows [As Kc] (Two pairs : Aces and Kings)
P1xel7 collected 203890 from pot
*** SUMMARY ***
Total pot 203890 | No rake
Board: [6h Ks Ad 7c Jd]
Seat 2: P1xel7 (big blind) showed [As Kc] and won 203890 with Two pairs : Aces and Kings
Seat 6: FreedomDrums (button) showed [Ac 6c] and lost with Two pairs : Aces and 6


Winamax Poker - Tournament "X-MAS FEVER 5 € - DAY 1" buyIn: 4.50€ + 0.50€ level: 15 - HandId: #3150633295033663502-309-1703371693 - Holdem no limit (300/1250/2500) - 2023/12/23 22:48:13 UTC
Table: 'X-MAS FEVER 5 € - DAY 1(733563978)#0013' 6-max (real money) Seat #1 is the button
Seat 1: pi-ratt-R2d2 (165179)
Seat 2: P1xel7 (233197)
Seat 3: RizdeCanard (361288)
Seat 4: Dimix68 (188921)
Seat 5: O.PicsoU (39907)
*** ANTE/BLINDS ***
P1xel7 posts ante 300
RizdeCanard posts ante 300
pi-ratt-R2d2 posts ante 300
Dimix68 posts ante 300
O.PicsoU posts ante 300
P1xel7 posts small blind 1250
RizdeCanard posts big blind 2500
Dealt to P1xel7 [6d Qc]
*** PRE-FLOP *** 
Dimix68 folds
O.PicsoU calls 2500
pi-ratt-R2d2 folds
P1xel7 folds
RizdeCanard checks
*** FLOP *** [5s Ts Ac]
RizdeCanard checks
O.PicsoU checks
*** TURN *** [5s Ts Ac][2s]
RizdeCanard checks
O.PicsoU checks
*** RIVER *** [5s Ts Ac 2s][7c]
RizdeCanard checks
O.PicsoU checks
*** SHOW DOWN ***
O.PicsoU shows [8h Qh] (High card : Ace)
RizdeCanard shows [Qs 5c] (One pair : 5)
RizdeCanard collected 7750 from pot
*** SUMMARY ***
Total pot 7750 | No rake
Board: [5s Ts Ac 2s 7c]
Seat 3: RizdeCanard (big blind) showed [Qs 5c] and won 7750 with One pair : 5
Seat 5: O.PicsoU showed [8h Qh] and lost with High card : Ace


Winamax Poker - Tournament "X-MAS FEVER 5 € - DAY 1" buyIn: 4.50€ + 0.50€ level: 15 - HandId: #3150633295033663502-310-1703371726 - Holdem no limit (300/1250/2500) - 2023/12/23 22:48:46 UTC
Table: 'X-MAS FEVER 5 € - DAY 1(733563978)#0013' 6-max (real money) Seat #2 is the button
Seat 1: pi-ratt-R2d2 (164879)
Seat 2: P1xel7 (231647)
Seat 3: RizdeCanard (366238)
Seat 4: Dimix68 (188621)
Seat 5: O.PicsoU (37107)
Seat 6: NonMaisFold (249688)
*** ANTE/BLINDS ***
RizdeCanard posts ante 300
Dimix68 posts ante 300
pi-ratt-R2d2 posts ante 300
P1xel7 posts ante 300
O.PicsoU posts ante 300
NonMaisFold posts ante 300
RizdeCanard posts small blind 1250
Dimix68 posts big blind 2500
Dealt to P1xel7 [Ts 9s]
*** PRE-FLOP *** 
O.PicsoU folds
NonMaisFold raises 3750 to 6250
pi-ratt-R2d2 folds
P1xel7 folds
RizdeCanard folds
Dimix68 folds
NonMaisFold collected 11800 from pot
*** SUMMARY ***
Total pot 11800 | No rake
Seat 6: NonMaisFold won 11800


Winamax Poker - Tournament "X-MAS FEVER 5 € - DAY 1" buyIn: 4.50€ + 0.50€ level: 15 - HandId: #3150633295033663502-311-1703371756 - Holdem no limit (300/1250/2500) - 2023/12/23 22:49:16 UTC
Table: 'X-MAS FEVER 5 € - DAY 1(733563978)#0013' 6-max (real money) Seat #3 is the button
Seat 1: pi-ratt-R2d2 (164579)
Seat 2: P1xel7 (231347)
Seat 3: RizdeCanard (364688)
Seat 4: Dimix68 (185821)
Seat 5: O.PicsoU (36807)
Seat 6: NonMaisFold (254938)
*** ANTE/BLINDS ***
Dimix68 posts ante 300
O.PicsoU posts ante 300
pi-ratt-R2d2 posts ante 300
P1xel7 posts ante 300
RizdeCanard posts ante 300
NonMaisFold posts ante 300
Dimix68 posts small blind 1250
O.PicsoU posts big blind 2500
Dealt to P1xel7 [9s Qh]
*** PRE-FLOP *** 
NonMaisFold folds
pi-ratt-R2d2 calls 2500
P1xel7 folds
RizdeCanard folds
Dimix68 calls 1250
O.PicsoU checks
*** FLOP *** [4d 7c 4h]
Dimix68 bets 2500
O.PicsoU calls 2500
pi-ratt-R2d2 folds
*** TURN *** [4d 7c 4h][6d]
Dimix68 bets 5000
O.PicsoU folds
Dimix68 shows [3d 5c] (Straight 7 high)
Dimix68 collected 19300 from pot
*** SUMMARY ***
Total pot 19300 | No rake
Board: [4d 7c 4h 6d]
Seat 4: Dimix68 (small blind) showed [3d 5c] and won 19300 with Straight 7 high


Winamax Poker - Tournament "X-MAS FEVER 5 € - DAY 1" buyIn: 4.50€ + 0.50€ level: 15 - HandId: #3150633295033663502-312-1703371845 - Holdem no limit (300/1250/2500) - 2023/12/23 22:50:45 UTC
Table: 'X-MAS FEVER 5 € - DAY 1(733563978)#0013' 6-max (real money) Seat #4 is the button
Seat 1: pi-ratt-R2d2 (161779)
Seat 2: P1xel7 (231047)
Seat 3: RizdeCanard (364388)
Seat 4: Dimix68 (194821)
Seat 5: O.PicsoU (31507)
Seat 6: NonMaisFold (254638)
*** ANTE/BLINDS ***
O.PicsoU posts ante 300
NonMaisFold posts ante 300
pi-ratt-R2d2 posts ante 300
P1xel7 posts ante 300
RizdeCanard posts ante 300
Dimix68 posts ante 300
O.PicsoU posts small blind 1250
NonMaisFold posts big blind 2500
Dealt to P1xel7 [6d 4d]
*** PRE-FLOP *** 
pi-ratt-R2d2 folds
P1xel7 folds
RizdeCanard raises 2500 to 5000
Dimix68 folds
O.PicsoU folds
NonMaisFold calls 2500
*** FLOP *** [2h 3c 6c]
NonMaisFold checks
RizdeCanard bets 6525
NonMaisFold calls 6525
*** TURN *** [2h 3c 6c][7s]
NonMaisFold checks
RizdeCanard bets 20880
NonMaisFold calls 20880
*** RIVER *** [2h 3c 6c 7s][Qs]
NonMaisFold checks
RizdeCanard bets 62500
NonMaisFold calls 62500
*** SHOW DOWN ***
RizdeCanard shows [8h 9c] (High card : Queen)
NonMaisFold shows [7c 4s] (One pair : 7)
NonMaisFold collected 192860 from pot
*** SUMMARY ***
Total pot 192860 | No rake
Board: [2h 3c 6c 7s Qs]
Seat 3: RizdeCanard showed [8h 9c] and lost with High card : Queen
Seat 6: NonMaisFold (big blind) showed [7c 4s] and won 192860 with One pair : 7


Winamax Poker - Tournament "X-MAS FEVER 5 € - DAY 1" buyIn: 4.50€ + 0.50€ level: 16 - HandId: #3150633295033663502-313-1703371926 - Holdem no limit (350/1500/3000) - 2023/12/23 22:52:06 UTC
Table: 'X-MAS FEVER 5 € - DAY 1(733563978)#0013' 6-max (real money) Seat #5 is the button
Seat 1: pi-ratt-R2d2 (161479)
Seat 2: P1xel7 (230747)
Seat 3: RizdeCanard (269183)
Seat 4: Dimix68 (194521)
Seat 5: O.PicsoU (29957)
Seat 6: NonMaisFold (352293)
*** ANTE/BLINDS ***
NonMaisFold posts ante 350
pi-ratt-R2d2 posts ante 350
P1xel7 posts ante 350
RizdeCanard posts ante 350
Dimix68 posts ante 350
O.PicsoU posts ante 350
NonMaisFold posts small blind 1500
pi-ratt-R2d2 posts big blind 3000
Dealt to P1xel7 [Qh Ts]
*** PRE-FLOP *** 
P1xel7 folds
RizdeCanard raises 3000 to 6000
Dimix68 folds
O.PicsoU folds
NonMaisFold folds
pi-ratt-R2d2 calls 3000
*** FLOP *** [8s 4s Qd]
pi-ratt-R2d2 checks
RizdeCanard bets 5148
pi-ratt-R2d2 calls 5148
*** TURN *** [8s 4s Qd][5d]
pi-ratt-R2d2 checks
RizdeCanard checks
*** RIVER *** [8s 4s Qd 5d][Td]
pi-ratt-R2d2 bets 16832
RizdeCanard raises 28168 to 45000
pi-ratt-R2d2 folds
RizdeCanard collected 87728 from pot
*** SUMMARY ***
Total pot 87728 | No rake
Board: [8s 4s Qd 5d Td]
Seat 3: RizdeCanard won 87728


Winamax Poker - Tournament "X-MAS FEVER 5 € - DAY 1" buyIn: 4.50€ + 0.50€ level: 16 - HandId: #3150633295033663502-314-1703372009 - Holdem no limit (350/1500/3000) - 2023/12/23 22:53:29 UTC
Table: 'X-MAS FEVER 5 € - DAY 1(733563978)#0013' 6-max (real money) Seat #6 is the button
Seat 1: pi-ratt-R2d2 (133149)
Seat 2: P1xel7 (230397)
Seat 3: RizdeCanard (300413)
Seat 4: Dimix68 (194171)
Seat 5: O.PicsoU (29607)
Seat 6: NonMaisFold (350443)
*** ANTE/BLINDS ***
pi-ratt-R2d2 posts ante 350
P1xel7 posts ante 350
RizdeCanard posts ante 350
Dimix68 posts ante 350
O.PicsoU posts ante 350
NonMaisFold posts ante 350
pi-ratt-R2d2 posts small blind 1500
P1xel7 posts big blind 3000
Dealt to P1xel7 [6c 8d]
*** PRE-FLOP *** 
RizdeCanard folds
Dimix68 raises 4500 to 7500
O.PicsoU folds
NonMaisFold calls 7500
pi-ratt-R2d2 folds
P1xel7 folds
*** FLOP *** [6d 7c 4d]
Dimix68 bets 10800
NonMaisFold folds
Dimix68 collected 32400 from pot
*** SUMMARY ***
Total pot 32400 | No rake
Board: [6d 7c 4d]
Seat 4: Dimix68 won 32400


Winamax Poker - Tournament "X-MAS FEVER 5 € - DAY 1" buyIn: 4.50€ + 0.50€ level: 16 - HandId: #3150633295033663502-315-1703372052 - Holdem no limit (350/1500/3000) - 2023/12/23 22:54:12 UTC
Table: 'X-MAS FEVER 5 € - DAY 1(733563978)#0013' 6-max (real money) Seat #1 is the button
Seat 1: pi-ratt-R2d2 (131299)
Seat 2: P1xel7 (227047)
Seat 3: RizdeCanard (300063)
Seat 4: Dimix68 (207921)
Seat 5: O.PicsoU (29257)
Seat 6: NonMaisFold (342593)
*** ANTE/BLINDS ***
P1xel7 posts ante 350
RizdeCanard posts ante 350
pi-ratt-R2d2 posts ante 350
Dimix68 posts ante 350
O.PicsoU posts ante 350
NonMaisFold posts ante 350
P1xel7 posts small blind 1500
RizdeCanard posts big blind 3000
Dealt to P1xel7 [4s Qh]
*** PRE-FLOP *** 
Dimix68 folds
O.PicsoU folds
NonMaisFold raises 4500 to 7500
pi-ratt-R2d2 calls 7500
P1xel7 folds
RizdeCanard raises 22500 to 30000
NonMaisFold calls 22500
pi-ratt-R2d2 calls 22500
*** FLOP *** [2c 7h 5h]
RizdeCanard checks
NonMaisFold bets 28080
pi-ratt-R2d2 raises 72869 to 100949 and is all-in
RizdeCanard folds
NonMaisFold folds
pi-ratt-R2d2 collected 222629 from pot
*** SUMMARY ***
Total pot 222629 | No rake
Board: [2c 7h 5h]
Seat 1: pi-ratt-R2d2 (button) won 222629


Winamax Poker - Tournament "X-MAS FEVER 5 € - DAY 1" buyIn: 4.50€ + 0.50€ level: 16 - HandId: #3150633295033663502-316-1703372461 - Holdem no limit (350/1500/3000) - 2023/12/23 23:01:01 UTC
Table: 'X-MAS FEVER 5 € - DAY 1(733563978)#0013' 6-max (real money) Seat #2 is the button
Seat 1: pi-ratt-R2d2 (222629)
Seat 2: P1xel7 (225197)
Seat 3: RizdeCanard (269713)
Seat 4: Dimix68 (207571)
Seat 5: O.PicsoU (28907)
Seat 6: NonMaisFold (284163)
*** ANTE/BLINDS ***
RizdeCanard posts ante 350
Dimix68 posts ante 350
pi-ratt-R2d2 posts ante 350
P1xel7 posts ante 350
O.PicsoU posts ante 350
NonMaisFold posts ante 350
RizdeCanard posts small blind 1500
Dimix68 posts big blind 3000
Dealt to P1xel7 [Ad 8h]
*** PRE-FLOP *** 
O.PicsoU folds
NonMaisFold raises 3000 to 6000
pi-ratt-R2d2 folds
P1xel7 folds
RizdeCanard folds
Dimix68 folds
NonMaisFold collected 12600 from pot
*** SUMMARY ***
Total pot 12600 | No rake
Seat 6: NonMaisFold won 12600


Winamax Poker - Tournament "X-MAS FEVER 5 € - DAY 1" buyIn: 4.50€ + 0.50€ level: 16 - HandId: #3150633295033663502-317-1703372517 - Holdem no limit (350/1500/3000) - 2023/12/23 23:01:57 UTC
Table: 'X-MAS FEVER 5 € - DAY 1(733563978)#0013' 6-max (real money) Seat #3 is the button
Seat 1: pi-ratt-R2d2 (222279)
Seat 2: P1xel7 (224847)
Seat 3: RizdeCanard (267863)
Seat 4: Dimix68 (204221)
Seat 5: O.PicsoU (28557)
Seat 6: NonMaisFold (290413)
*** ANTE/BLINDS ***
Dimix68 posts ante 350
O.PicsoU posts ante 350
pi-ratt-R2d2 posts ante 350
P1xel7 posts ante 350
RizdeCanard posts ante 350
NonMaisFold posts ante 350
Dimix68 posts small blind 1500
O.PicsoU posts big blind 3000
Dealt to P1xel7 [3d As]
*** PRE-FLOP *** 
NonMaisFold folds
pi-ratt-R2d2 folds
P1xel7 folds
RizdeCanard folds
Dimix68 raises 6000 to 9000
O.PicsoU folds
Dimix68 collected 14100 from pot
*** SUMMARY ***
Total pot 14100 | No rake
Seat 4: Dimix68 (small blind) won 14100


Winamax Poker - Tournament "X-MAS FEVER 5 € - DAY 1" buyIn: 4.50€ + 0.50€ level: 16 - HandId: #3150633295033663502-318-1703372573 - Holdem no limit (350/1500/3000) - 2023/12/23 23:02:53 UTC
Table: 'X-MAS FEVER 5 € - DAY 1(733563978)#0013' 6-max (real money) Seat #4 is the button
Seat 1: pi-ratt-R2d2 (221929)
Seat 2: P1xel7 (224497)
Seat 3: RizdeCanard (267513)
Seat 4: Dimix68 (208971)
Seat 5: O.PicsoU (25207)
Seat 6: NonMaisFold (290063)
*** ANTE/BLINDS ***
O.PicsoU posts ante 350
NonMaisFold posts ante 350
pi-ratt-R2d2 posts ante 350
P1xel7 posts ante 350
RizdeCanard posts ante 350
Dimix68 posts ante 350
O.PicsoU posts small blind 1500
NonMaisFold posts big blind 3000
Dealt to P1xel7 [5d Qd]
*** PRE-FLOP *** 
pi-ratt-R2d2 folds
P1xel7 folds
RizdeCanard folds
Dimix68 folds
O.PicsoU folds
NonMaisFold collected 6600 from pot
*** SUMMARY ***
Total pot 6600 | No rake
Seat 6: NonMaisFold (big blind) won 6600


Winamax Poker - Tournament "X-MAS FEVER 5 € - DAY 1" buyIn: 4.50€ + 0.50€ level: 16 - HandId: #3150633295033663502-319-1703372707 - Holdem no limit (350/1500/3000) - 2023/12/23 23:05:07 UTC
Table: 'X-MAS FEVER 5 € - DAY 1(733563978)#0013' 6-max (real money) Seat #5 is the button
Seat 1: pi-ratt-R2d2 (221579)
Seat 2: P1xel7 (224147)
Seat 3: RizdeCanard (267163)
Seat 4: Dimix68 (208621)
Seat 5: O.PicsoU (23357)
Seat 6: NonMaisFold (293313)
*** ANTE/BLINDS ***
NonMaisFold posts ante 350
pi-ratt-R2d2 posts ante 350
P1xel7 posts ante 350
RizdeCanard posts ante 350
Dimix68 posts ante 350
O.PicsoU posts ante 350
NonMaisFold posts small blind 1500
pi-ratt-R2d2 posts big blind 3000
Dealt to P1xel7 [5d Jh]
*** PRE-FLOP *** 
P1xel7 folds
RizdeCanard folds
Dimix68 folds
O.PicsoU raises 20007 to 23007 and is all-in
NonMaisFold folds
pi-ratt-R2d2 folds
O.PicsoU collected 29607 from pot
*** SUMMARY ***
Total pot 29607 | No rake
Seat 5: O.PicsoU (button) won 29607


Winamax Poker - Tournament "X-MAS FEVER 5 € - DAY 1" buyIn: 4.50€ + 0.50€ level: 16 - HandId: #3150633295033663502-320-1703372726 - Holdem no limit (350/1500/3000) - 2023/12/23 23:05:26 UTC
Table: 'X-MAS FEVER 5 € - DAY 1(733563978)#0013' 6-max (real money) Seat #6 is the button
Seat 1: pi-ratt-R2d2 (218229)
Seat 2: P1xel7 (223797)
Seat 3: RizdeCanard (266813)
Seat 4: Dimix68 (208271)
Seat 5: O.PicsoU (29607)
Seat 6: NonMaisFold (291463)
*** ANTE/BLINDS ***
pi-ratt-R2d2 posts ante 350
P1xel7 posts ante 350
RizdeCanard posts ante 350
Dimix68 posts ante 350
O.PicsoU posts ante 350
NonMaisFold posts ante 350
pi-ratt-R2d2 posts small blind 1500
P1xel7 posts big blind 3000
Dealt to P1xel7 [Jc 7s]
*** PRE-FLOP *** 
RizdeCanard folds
Dimix68 folds
O.PicsoU folds
NonMaisFold folds
pi-ratt-R2d2 folds
P1xel7 collected 6600 from pot
*** SUMMARY ***
Total pot 6600 | No rake
Seat 2: P1xel7 (big blind) won 6600


Winamax Poker - Tournament "X-MAS FEVER 5 € - DAY 1" buyIn: 4.50€ + 0.50€ level: 16 - HandId: #3150633295033663502-321-1703372742 - Holdem no limit (350/1500/3000) - 2023/12/23 23:05:42 UTC
Table: 'X-MAS FEVER 5 € - DAY 1(733563978)#0013' 6-max (real money) Seat #1 is the button
Seat 1: pi-ratt-R2d2 (216379)
Seat 2: P1xel7 (227047)
Seat 3: RizdeCanard (266463)
Seat 4: Dimix68 (207921)
Seat 5: O.PicsoU (29257)
Seat 6: NonMaisFold (291113)
*** ANTE/BLINDS ***
P1xel7 posts ante 350
RizdeCanard posts ante 350
pi-ratt-R2d2 posts ante 350
Dimix68 posts ante 350
O.PicsoU posts ante 350
NonMaisFold posts ante 350
P1xel7 posts small blind 1500
RizdeCanard posts big blind 3000
Dealt to P1xel7 [4c Ks]
*** PRE-FLOP *** 
Dimix68 folds
O.PicsoU folds
NonMaisFold folds
pi-ratt-R2d2 folds
P1xel7 folds
RizdeCanard collected 6600 from pot
*** SUMMARY ***
Total pot 6600 | No rake
Seat 3: RizdeCanard (big blind) won 6600


Winamax Poker - Tournament "X-MAS FEVER 5 € - DAY 1" buyIn: 4.50€ + 0.50€ level: 16 - HandId: #3150633295033663502-322-1703372766 - Holdem no limit (350/1500/3000) - 2023/12/23 23:06:06 UTC
Table: 'X-MAS FEVER 5 € - DAY 1(733563978)#0013' 6-max (real money) Seat #2 is the button
Seat 1: pi-ratt-R2d2 (216029)
Seat 2: P1xel7 (225197)
Seat 3: RizdeCanard (269713)
Seat 4: Dimix68 (207571)
Seat 5: O.PicsoU (28907)
Seat 6: NonMaisFold (290763)
*** ANTE/BLINDS ***
RizdeCanard posts ante 350
Dimix68 posts ante 350
pi-ratt-R2d2 posts ante 350
P1xel7 posts ante 350
O.PicsoU posts ante 350
NonMaisFold posts ante 350
RizdeCanard posts small blind 1500
Dimix68 posts big blind 3000
Dealt to P1xel7 [4s 7c]
*** PRE-FLOP *** 
O.PicsoU folds
NonMaisFold folds
pi-ratt-R2d2 folds
P1xel7 folds
RizdeCanard folds
Dimix68 collected 6600 from pot
*** SUMMARY ***
Total pot 6600 | No rake
Seat 4: Dimix68 (big blind) won 6600


Winamax Poker - Tournament "X-MAS FEVER 5 € - DAY 1" buyIn: 4.50€ + 0.50€ level: 16 - HandId: #3150633295033663502-323-1703372782 - Holdem no limit (350/1500/3000) - 2023/12/23 23:06:22 UTC
Table: 'X-MAS FEVER 5 € - DAY 1(733563978)#0013' 6-max (real money) Seat #3 is the button
Seat 1: pi-ratt-R2d2 (215679)
Seat 2: P1xel7 (224847)
Seat 3: RizdeCanard (267863)
Seat 4: Dimix68 (210821)
Seat 5: O.PicsoU (28557)
Seat 6: NonMaisFold (290413)
*** ANTE/BLINDS ***
Dimix68 posts ante 350
O.PicsoU posts ante 350
pi-ratt-R2d2 posts ante 350
P1xel7 posts ante 350
RizdeCanard posts ante 350
NonMaisFold posts ante 350
Dimix68 posts small blind 1500
O.PicsoU posts big blind 3000
Dealt to P1xel7 [6d 4d]
*** PRE-FLOP *** 
NonMaisFold raises 3000 to 6000
pi-ratt-R2d2 calls 6000
P1xel7 folds
RizdeCanard folds
Dimix68 folds
O.PicsoU folds
*** FLOP *** [2s 2d 6c]
NonMaisFold bets 11532
pi-ratt-R2d2 calls 11532
*** TURN *** [2s 2d 6c][8d]
NonMaisFold bets 20832
pi-ratt-R2d2 calls 20832
*** RIVER *** [2s 2d 6c 8d][Qs]
NonMaisFold checks
pi-ratt-R2d2 bets 29165
NonMaisFold folds
pi-ratt-R2d2 collected 112493 from pot
*** SUMMARY ***
Total pot 112493 | No rake
Board: [2s 2d 6c 8d Qs]
Seat 1: pi-ratt-R2d2 won 112493


Winamax Poker - Tournament "X-MAS FEVER 5 € - DAY 1" buyIn: 4.50€ + 0.50€ level: 16 - HandId: #3150633295033663502-324-1703372847 - Holdem no limit (350/1500/3000) - 2023/12/23 23:07:27 UTC
Table: 'X-MAS FEVER 5 € - DAY 1(733563978)#0013' 6-max (real money) Seat #4 is the button
Seat 1: pi-ratt-R2d2 (260293)
Seat 2: P1xel7 (224497)
Seat 3: RizdeCanard (267513)
Seat 4: Dimix68 (208971)
Seat 5: O.PicsoU (25207)
Seat 6: NonMaisFold (251699)
*** ANTE/BLINDS ***
O.PicsoU posts ante 350
NonMaisFold posts ante 350
pi-ratt-R2d2 posts ante 350
P1xel7 posts ante 350
RizdeCanard posts ante 350
Dimix68 posts ante 350
O.PicsoU posts small blind 1500
NonMaisFold posts big blind 3000
Dealt to P1xel7 [Th Td]
*** PRE-FLOP *** 
pi-ratt-R2d2 calls 3000
P1xel7 raises 9000 to 12000
RizdeCanard folds
Dimix68 folds
O.PicsoU folds
NonMaisFold folds
pi-ratt-R2d2 calls 9000
*** FLOP *** [6s 7s 5h]
pi-ratt-R2d2 checks
P1xel7 bets 19890
pi-ratt-R2d2 folds
P1xel7 collected 50490 from pot
*** SUMMARY ***
Total pot 50490 | No rake
Board: [6s 7s 5h]
Seat 2: P1xel7 won 50490


Winamax Poker - Tournament "X-MAS FEVER 5 € - DAY 1" buyIn: 4.50€ + 0.50€ level: 16 - HandId: #3150633295033663502-325-1703372890 - Holdem no limit (350/1500/3000) - 2023/12/23 23:08:10 UTC
Table: 'X-MAS FEVER 5 € - DAY 1(733563978)#0013' 6-max (real money) Seat #5 is the button
Seat 1: pi-ratt-R2d2 (247943)
Seat 2: P1xel7 (242747)
Seat 3: RizdeCanard (267163)
Seat 4: Dimix68 (208621)
Seat 5: O.PicsoU (23357)
Seat 6: NonMaisFold (248349)
*** ANTE/BLINDS ***
NonMaisFold posts ante 350
pi-ratt-R2d2 posts ante 350
P1xel7 posts ante 350
RizdeCanard posts ante 350
Dimix68 posts ante 350
O.PicsoU posts ante 350
NonMaisFold posts small blind 1500
pi-ratt-R2d2 posts big blind 3000
Dealt to P1xel7 [Kh 9s]
*** PRE-FLOP *** 
P1xel7 folds
RizdeCanard folds
Dimix68 raises 3000 to 6000
O.PicsoU folds
NonMaisFold folds
pi-ratt-R2d2 calls 3000
*** FLOP *** [2d 4s 7d]
pi-ratt-R2d2 checks
Dimix68 bets 6000
pi-ratt-R2d2 calls 6000
*** TURN *** [2d 4s 7d][Ah]
pi-ratt-R2d2 checks
Dimix68 bets 17940
pi-ratt-R2d2 calls 17940
*** RIVER *** [2d 4s 7d Ah][4c]
pi-ratt-R2d2 checks
Dimix68 checks
*** SHOW DOWN ***
Dimix68 shows [Qd Tc] (One pair : 4)
pi-ratt-R2d2 shows [Ac Jc] (Two pairs : Aces and 4)
pi-ratt-R2d2 collected 63480 from pot
*** SUMMARY ***
Total pot 63480 | No rake
Board: [2d 4s 7d Ah 4c]
Seat 1: pi-ratt-R2d2 (big blind) showed [Ac Jc] and won 63480 with Two pairs : Aces and 4
Seat 4: Dimix68 showed [Qd Tc] and lost with One pair : 4


Winamax Poker - Tournament "X-MAS FEVER 5 € - DAY 1" buyIn: 4.50€ + 0.50€ level: 16 - HandId: #3150633295033663502-326-1703372923 - Holdem no limit (350/1500/3000) - 2023/12/23 23:08:43 UTC
Table: 'X-MAS FEVER 5 € - DAY 1(733563978)#0013' 6-max (real money) Seat #6 is the button
Seat 1: pi-ratt-R2d2 (281133)
Seat 2: P1xel7 (242397)
Seat 3: RizdeCanard (266813)
Seat 4: Dimix68 (178331)
Seat 5: O.PicsoU (23007)
Seat 6: NonMaisFold (246499)
*** ANTE/BLINDS ***
pi-ratt-R2d2 posts ante 350
P1xel7 posts ante 350
RizdeCanard posts ante 350
Dimix68 posts ante 350
O.PicsoU posts ante 350
NonMaisFold posts ante 350
pi-ratt-R2d2 posts small blind 1500
P1xel7 posts big blind 3000
Dealt to P1xel7 [Ts 7d]
*** PRE-FLOP *** 
RizdeCanard folds
Dimix68 folds
O.PicsoU folds
NonMaisFold raises 4500 to 7500
pi-ratt-R2d2 calls 6000
P1xel7 folds
*** FLOP *** [3d 9d 5d]
pi-ratt-R2d2 checks
NonMaisFold bets 6030
pi-ratt-R2d2 raises 18794 to 24824
NonMaisFold calls 18794
*** TURN *** [3d 9d 5d][Js]
pi-ratt-R2d2 bets 248459 and is all-in
NonMaisFold folds
pi-ratt-R2d2 collected 318207 from pot
*** SUMMARY ***
Total pot 318207 | No rake
Board: [3d 9d 5d Js]
Seat 1: pi-ratt-R2d2 (small blind) won 318207


Winamax Poker - Tournament "X-MAS FEVER 5 € - DAY 1" buyIn: 4.50€ + 0.50€ level: 17 - HandId: #3150633295033663502-327-1703372965 - Holdem no limit (400/1750/3500) - 2023/12/23 23:09:25 UTC
Table: 'X-MAS FEVER 5 € - DAY 1(733563978)#0013' 6-max (real money) Seat #1 is the button
Seat 1: pi-ratt-R2d2 (318207)
Seat 2: P1xel7 (239047)
Seat 3: RizdeCanard (266463)
Seat 4: Dimix68 (177981)
Seat 5: O.PicsoU (22657)
Seat 6: NonMaisFold (213825)
*** ANTE/BLINDS ***
P1xel7 posts ante 400
RizdeCanard posts ante 400
pi-ratt-R2d2 posts ante 400
Dimix68 posts ante 400
O.PicsoU posts ante 400
NonMaisFold posts ante 400
P1xel7 posts small blind 1750
RizdeCanard posts big blind 3500
Dealt to P1xel7 [4s 6h]
*** PRE-FLOP *** 
Dimix68 folds
O.PicsoU raises 18757 to 22257 and is all-in
NonMaisFold folds
pi-ratt-R2d2 folds
P1xel7 folds
RizdeCanard folds
O.PicsoU collected 29907 from pot
*** SUMMARY ***
Total pot 29907 | No rake
Seat 5: O.PicsoU won 29907


Winamax Poker - Tournament "X-MAS FEVER 5 € - DAY 1" buyIn: 4.50€ + 0.50€ level: 17 - HandId: #3150633295033663502-328-1703372986 - Holdem no limit (400/1750/3500) - 2023/12/23 23:09:46 UTC
Table: 'X-MAS FEVER 5 € - DAY 1(733563978)#0013' 6-max (real money) Seat #2 is the button
Seat 1: pi-ratt-R2d2 (317807)
Seat 2: P1xel7 (236897)
Seat 3: RizdeCanard (262563)
Seat 4: Dimix68 (177581)
Seat 5: O.PicsoU (29907)
Seat 6: NonMaisFold (213425)
*** ANTE/BLINDS ***
RizdeCanard posts ante 400
Dimix68 posts ante 400
pi-ratt-R2d2 posts ante 400
P1xel7 posts ante 400
O.PicsoU posts ante 400
NonMaisFold posts ante 400
RizdeCanard posts small blind 1750
Dimix68 posts big blind 3500
Dealt to P1xel7 [2d Jc]
*** PRE-FLOP *** 
O.PicsoU folds
NonMaisFold folds
pi-ratt-R2d2 folds
P1xel7 folds
RizdeCanard raises 8750 to 12250
Dimix68 calls 8750
*** FLOP *** [As 4d 7c]
RizdeCanard bets 8877
Dimix68 raises 14127 to 23004
RizdeCanard folds
Dimix68 collected 58781 from pot
*** SUMMARY ***
Total pot 58781 | No rake
Board: [As 4d 7c]
Seat 4: Dimix68 (big blind) won 58781


Winamax Poker - Tournament "X-MAS FEVER 5 € - DAY 1" buyIn: 4.50€ + 0.50€ level: 17 - HandId: #3150633295033663502-329-1703373028 - Holdem no limit (400/1750/3500) - 2023/12/23 23:10:28 UTC
Table: 'X-MAS FEVER 5 € - DAY 1(733563978)#0013' 6-max (real money) Seat #3 is the button
Seat 1: pi-ratt-R2d2 (317407)
Seat 2: P1xel7 (236497)
Seat 3: RizdeCanard (241036)
Seat 4: Dimix68 (200708)
Seat 5: O.PicsoU (29507)
Seat 6: NonMaisFold (213025)
*** ANTE/BLINDS ***
Dimix68 posts ante 400
O.PicsoU posts ante 400
pi-ratt-R2d2 posts ante 400
P1xel7 posts ante 400
RizdeCanard posts ante 400
NonMaisFold posts ante 400
Dimix68 posts small blind 1750
O.PicsoU posts big blind 3500
Dealt to P1xel7 [8h As]
*** PRE-FLOP *** 
NonMaisFold folds
pi-ratt-R2d2 folds
P1xel7 raises 4200 to 7700
RizdeCanard folds
Dimix68 calls 5950
O.PicsoU folds
*** FLOP *** [2h 5s Qd]
Dimix68 checks
P1xel7 bets 7455
Dimix68 calls 7455
*** TURN *** [2h 5s Qd][4h]
Dimix68 checks
P1xel7 checks
*** RIVER *** [2h 5s Qd 4h][3h]
Dimix68 checks
P1xel7 bets 9053
Dimix68 calls 9053
*** SHOW DOWN ***
Dimix68 shows [Jc Qs] (One pair : Queens)
P1xel7 shows [8h As] (Straight 5 high)
P1xel7 collected 54316 from pot
*** SUMMARY ***
Total pot 54316 | No rake
Board: [2h 5s Qd 4h 3h]
Seat 2: P1xel7 showed [8h As] and won 54316 with Straight 5 high
Seat 4: Dimix68 (small blind) showed [Jc Qs] and lost with One pair : Queens


Winamax Poker - Tournament "X-MAS FEVER 5 € - DAY 1" buyIn: 4.50€ + 0.50€ level: 17 - HandId: #3150633295033663502-330-1703373107 - Holdem no limit (400/1750/3500) - 2023/12/23 23:11:47 UTC
Table: 'X-MAS FEVER 5 € - DAY 1(733563978)#0013' 6-max (real money) Seat #4 is the button
Seat 1: pi-ratt-R2d2 (317007)
Seat 2: P1xel7 (266205)
Seat 3: RizdeCanard (240636)
Seat 4: Dimix68 (176100)
Seat 5: O.PicsoU (25607)
Seat 6: NonMaisFold (212625)
*** ANTE/BLINDS ***
O.PicsoU posts ante 400
NonMaisFold posts ante 400
pi-ratt-R2d2 posts ante 400
P1xel7 posts ante 400
RizdeCanard posts ante 400
Dimix68 posts ante 400
O.PicsoU posts small blind 1750
NonMaisFold posts big blind 3500
Dealt to P1xel7 [Js 7d]
*** PRE-FLOP *** 
pi-ratt-R2d2 folds
P1xel7 folds
RizdeCanard folds
Dimix68 raises 5250 to 8750
O.PicsoU folds
NonMaisFold calls 5250
*** FLOP *** [Tc Ts 6c]
NonMaisFold checks
Dimix68 bets 10825
NonMaisFold folds
Dimix68 collected 32475 from pot
*** SUMMARY ***
Total pot 32475 | No rake
Board: [Tc Ts 6c]
Seat 4: Dimix68 (button) won 32475


Winamax Poker - Tournament "X-MAS FEVER 5 € - DAY 1" buyIn: 4.50€ + 0.50€ level: 17 - HandId: #3150633295033663502-331-1703373155 - Holdem no limit (400/1750/3500) - 2023/12/23 23:12:35 UTC
Table: 'X-MAS FEVER 5 € - DAY 1(733563978)#0013' 6-max (real money) Seat #5 is the button
Seat 1: pi-ratt-R2d2 (316607)
Seat 2: P1xel7 (265805)
Seat 3: RizdeCanard (240236)
Seat 4: Dimix68 (188600)
Seat 5: O.PicsoU (23457)
Seat 6: NonMaisFold (203475)
*** ANTE/BLINDS ***
NonMaisFold posts ante 400
pi-ratt-R2d2 posts ante 400
P1xel7 posts ante 400
RizdeCanard posts ante 400
Dimix68 posts ante 400
O.PicsoU posts ante 400
NonMaisFold posts small blind 1750
pi-ratt-R2d2 posts big blind 3500
Dealt to P1xel7 [7d 4c]
*** PRE-FLOP *** 
P1xel7 folds
RizdeCanard folds
Dimix68 folds
O.PicsoU folds
NonMaisFold calls 1750
pi-ratt-R2d2 checks
*** FLOP *** [2d 2c 3h]
NonMaisFold checks
pi-ratt-R2d2 checks
*** TURN *** [2d 2c 3h][Kd]
NonMaisFold checks
pi-ratt-R2d2 checks
*** RIVER *** [2d 2c 3h Kd][Jd]
NonMaisFold bets 7050
pi-ratt-R2d2 folds
NonMaisFold collected 16450 from pot
*** SUMMARY ***
Total pot 16450 | No rake
Board: [2d 2c 3h Kd Jd]
Seat 6: NonMaisFold (small blind) won 16450


Winamax Poker - Tournament "X-MAS FEVER 5 € - DAY 1" buyIn: 4.50€ + 0.50€ level: 17 - HandId: #3150633295033663502-332-1703373182 - Holdem no limit (400/1750/3500) - 2023/12/23 23:13:02 UTC
Table: 'X-MAS FEVER 5 € - DAY 1(733563978)#0013' 6-max (real money) Seat #6 is the button
Seat 1: pi-ratt-R2d2 (312707)
Seat 2: P1xel7 (265405)
Seat 3: RizdeCanard (239836)
Seat 4: Dimix68 (188200)
Seat 5: O.PicsoU (23057)
Seat 6: NonMaisFold (208975)
*** ANTE/BLINDS ***
pi-ratt-R2d2 posts ante 400
P1xel7 posts ante 400
RizdeCanard posts ante 400
Dimix68 posts ante 400
O.PicsoU posts ante 400
NonMaisFold posts ante 400
pi-ratt-R2d2 posts small blind 1750
P1xel7 posts big blind 3500
Dealt to P1xel7 [3d 7s]
*** PRE-FLOP *** 
RizdeCanard raises 3500 to 7000
Dimix68 calls 7000
O.PicsoU folds
NonMaisFold folds
pi-ratt-R2d2 raises 10500 to 17500
P1xel7 folds
RizdeCanard calls 10500
Dimix68 calls 10500
*** FLOP *** [Th 8c Ad]
pi-ratt-R2d2 checks
RizdeCanard bets 19272
Dimix68 folds
pi-ratt-R2d2 calls 19272
*** TURN *** [Th 8c Ad][6s]
pi-ratt-R2d2 checks
RizdeCanard bets 77555
pi-ratt-R2d2 folds
RizdeCanard collected 174499 from pot
*** SUMMARY ***
Total pot 174499 | No rake
Board: [Th 8c Ad 6s]
Seat 3: RizdeCanard won 174499


Winamax Poker - Tournament "X-MAS FEVER 5 € - DAY 1" buyIn: 4.50€ + 0.50€ level: 17 - HandId: #3150633295033663502-333-1703373283 - Holdem no limit (400/1750/3500) - 2023/12/23 23:14:43 UTC
Table: 'X-MAS FEVER 5 € - DAY 1(733563978)#0013' 6-max (real money) Seat #1 is the button
Seat 1: pi-ratt-R2d2 (275535)
Seat 2: P1xel7 (261505)
Seat 3: RizdeCanard (299608)
Seat 4: Dimix68 (170300)
Seat 5: O.PicsoU (22657)
Seat 6: NonMaisFold (208575)
*** ANTE/BLINDS ***
P1xel7 posts ante 400
RizdeCanard posts ante 400
pi-ratt-R2d2 posts ante 400
Dimix68 posts ante 400
O.PicsoU posts ante 400
NonMaisFold posts ante 400
P1xel7 posts small blind 1750
RizdeCanard posts big blind 3500
Dealt to P1xel7 [5c 8s]
*** PRE-FLOP *** 
Dimix68 folds
O.PicsoU folds
NonMaisFold folds
pi-ratt-R2d2 raises 11150 to 14650
P1xel7 folds
RizdeCanard calls 11150
*** FLOP *** [Kh 4s Ks]
RizdeCanard checks
pi-ratt-R2d2 checks
*** TURN *** [Kh 4s Ks][7h]
RizdeCanard checks
pi-ratt-R2d2 checks
*** RIVER *** [Kh 4s Ks 7h][Ah]
RizdeCanard checks
pi-ratt-R2d2 bets 11708
RizdeCanard calls 11708
*** SHOW DOWN ***
RizdeCanard shows [2c Ad] (Two pairs : Aces and Kings)
pi-ratt-R2d2 shows [As 8h] (Two pairs : Aces and Kings)
pi-ratt-R2d2 collected 56866 from pot
*** SUMMARY ***
Total pot 56866 | No rake
Board: [Kh 4s Ks 7h Ah]
Seat 1: pi-ratt-R2d2 (button) showed [As 8h] and won 56866 with Two pairs : Aces and Kings
Seat 3: RizdeCanard (big blind) showed [2c Ad] and lost with Two pairs : Aces and Kings


Winamax Poker - Tournament "X-MAS FEVER 5 € - DAY 1" buyIn: 4.50€ + 0.50€ level: 17 - HandId: #3150633295033663502-334-1703373317 - Holdem no limit (400/1750/3500) - 2023/12/23 23:15:17 UTC
Table: 'X-MAS FEVER 5 € - DAY 1(733563978)#0013' 6-max (real money) Seat #2 is the button
Seat 1: pi-ratt-R2d2 (305643)
Seat 2: P1xel7 (259355)
Seat 3: RizdeCanard (272850)
Seat 4: Dimix68 (169900)
Seat 5: O.PicsoU (22257)
Seat 6: NonMaisFold (208175)
*** ANTE/BLINDS ***
RizdeCanard posts ante 400
Dimix68 posts ante 400
pi-ratt-R2d2 posts ante 400
P1xel7 posts ante 400
O.PicsoU posts ante 400
NonMaisFold posts ante 400
RizdeCanard posts small blind 1750
Dimix68 posts big blind 3500
Dealt to P1xel7 [Js Tc]
*** PRE-FLOP *** 
O.PicsoU folds
NonMaisFold folds
pi-ratt-R2d2 folds
P1xel7 raises 4200 to 7700
RizdeCanard folds
Dimix68 calls 4200
*** FLOP *** [Kh 2c 7h]
Dimix68 checks
P1xel7 checks
*** TURN *** [Kh 2c 7h][9h]
Dimix68 bets 9775
P1xel7 calls 9775
*** RIVER *** [Kh 2c 7h 9h][3h]
Dimix68 bets 19250
P1xel7 folds
Dimix68 collected 58350 from pot
*** SUMMARY ***
Total pot 58350 | No rake
Board: [Kh 2c 7h 9h 3h]
Seat 4: Dimix68 (big blind) won 58350


Winamax Poker - Tournament "X-MAS FEVER 5 € - DAY 1" buyIn: 4.50€ + 0.50€ level: 17 - HandId: #3150633295033663502-335-1703373375 - Holdem no limit (400/1750/3500) - 2023/12/23 23:16:15 UTC
Table: 'X-MAS FEVER 5 € - DAY 1(733563978)#0013' 6-max (real money) Seat #3 is the button
Seat 1: pi-ratt-R2d2 (305243)
Seat 2: P1xel7 (241480)
Seat 3: RizdeCanard (270700)
Seat 4: Dimix68 (191125)
Seat 5: O.PicsoU (21857)
Seat 6: NonMaisFold (207775)
*** ANTE/BLINDS ***
Dimix68 posts ante 400
O.PicsoU posts ante 400
pi-ratt-R2d2 posts ante 400
P1xel7 posts ante 400
RizdeCanard posts ante 400
NonMaisFold posts ante 400
Dimix68 posts small blind 1750
O.PicsoU posts big blind 3500
Dealt to P1xel7 [2c 5s]
*** PRE-FLOP *** 
NonMaisFold raises 5250 to 8750
pi-ratt-R2d2 calls 8750
P1xel7 folds
RizdeCanard folds
Dimix68 folds
O.PicsoU calls 5250
*** FLOP *** [6h Ad 6c]
O.PicsoU checks
NonMaisFold bets 9120
pi-ratt-R2d2 calls 9120
O.PicsoU folds
*** TURN *** [6h Ad 6c][Jd]
NonMaisFold checks
pi-ratt-R2d2 checks
*** RIVER *** [6h Ad 6c Jd][8h]
NonMaisFold checks
pi-ratt-R2d2 bets 17024
NonMaisFold calls 17024
*** SHOW DOWN ***
NonMaisFold shows [Kd Kc] (Two pairs : Kings and 6)
pi-ratt-R2d2 shows [Ah Qc] (Two pairs : Aces and 6)
pi-ratt-R2d2 collected 82688 from pot
*** SUMMARY ***
Total pot 82688 | No rake
Board: [6h Ad 6c Jd 8h]
Seat 1: pi-ratt-R2d2 showed [Ah Qc] and won 82688 with Two pairs : Aces and 6
Seat 6: NonMaisFold showed [Kd Kc] and lost with Two pairs : Kings and 6


Winamax Poker - Tournament "X-MAS FEVER 5 € - DAY 1" buyIn: 4.50€ + 0.50€ level: 17 - HandId: #3150633295033663502-336-1703373442 - Holdem no limit (400/1750/3500) - 2023/12/23 23:17:22 UTC
Table: 'X-MAS FEVER 5 € - DAY 1(733563978)#0013' 6-max (real money) Seat #4 is the button
Seat 1: pi-ratt-R2d2 (352637)
Seat 2: P1xel7 (241080)
Seat 3: RizdeCanard (270300)
Seat 4: Dimix68 (188975)
Seat 5: O.PicsoU (12707)
Seat 6: NonMaisFold (172481)
*** ANTE/BLINDS ***
O.PicsoU posts ante 400
NonMaisFold posts ante 400
pi-ratt-R2d2 posts ante 400
P1xel7 posts ante 400
RizdeCanard posts ante 400
Dimix68 posts ante 400
O.PicsoU posts small blind 1750
NonMaisFold posts big blind 3500
Dealt to P1xel7 [5h 4c]
*** PRE-FLOP *** 
pi-ratt-R2d2 raises 3500 to 7000
P1xel7 folds
RizdeCanard raises 14000 to 21000
Dimix68 folds
O.PicsoU folds
NonMaisFold folds
pi-ratt-R2d2 calls 14000
*** FLOP *** [Ad Qd Js]
pi-ratt-R2d2 checks
RizdeCanard bets 16385
pi-ratt-R2d2 calls 16385
*** TURN *** [Ad Qd Js][3s]
pi-ratt-R2d2 checks
RizdeCanard bets 87500
pi-ratt-R2d2 calls 87500
*** RIVER *** [Ad Qd Js 3s][4s]
pi-ratt-R2d2 checks
RizdeCanard bets 145015 and is all-in
pi-ratt-R2d2 raises 82337 to 227352 and is all-in
*** SHOW DOWN ***
RizdeCanard shows [Ac Jc] (Two pairs : Aces and Jacks)
pi-ratt-R2d2 shows [As 8s] (Flush Ace high)
pi-ratt-R2d2 collected 629787 from pot
*** SUMMARY ***
Total pot 629787 | No rake
Board: [Ad Qd Js 3s 4s]
Seat 1: pi-ratt-R2d2 showed [As 8s] and won 629787 with Flush Ace high
Seat 3: RizdeCanard showed [Ac Jc] and lost with Two pairs : Aces and Jacks


Winamax Poker - Tournament "X-MAS FEVER 5 € - DAY 1" buyIn: 4.50€ + 0.50€ level: 17 - HandId: #3150633295033663502-337-1703373507 - Holdem no limit (400/1750/3500) - 2023/12/23 23:18:27 UTC
Table: 'X-MAS FEVER 5 € - DAY 1(733563978)#0013' 6-max (real money) Seat #5 is the button
Seat 1: pi-ratt-R2d2 (629787)
Seat 2: P1xel7 (240680)
Seat 4: Dimix68 (188575)
Seat 5: O.PicsoU (10557)
Seat 6: NonMaisFold (168581)
*** ANTE/BLINDS ***
NonMaisFold posts ante 400
pi-ratt-R2d2 posts ante 400
P1xel7 posts ante 400
Dimix68 posts ante 400
O.PicsoU posts ante 400
NonMaisFold posts small blind 1750
pi-ratt-R2d2 posts big blind 3500
Dealt to P1xel7 [9h 6d]
*** PRE-FLOP *** 
P1xel7 folds
Dimix68 raises 3500 to 7000
O.PicsoU folds
NonMaisFold calls 5250
pi-ratt-R2d2 calls 3500
*** FLOP *** [3s Kd Th]
NonMaisFold checks
pi-ratt-R2d2 checks
Dimix68 bets 11500
NonMaisFold folds
pi-ratt-R2d2 raises 46000 to 57500
Dimix68 calls 46000
*** TURN *** [3s Kd Th][Tc]
pi-ratt-R2d2 bets 564887 and is all-in
Dimix68 folds
pi-ratt-R2d2 collected 702887 from pot
*** SUMMARY ***
Total pot 702887 | No rake
Board: [3s Kd Th Tc]
Seat 1: pi-ratt-R2d2 (big blind) won 702887


Winamax Poker - Tournament "X-MAS FEVER 5 € - DAY 1" buyIn: 4.50€ + 0.50€ level: 17 - HandId: #3150633295033663502-338-1703373575 - Holdem no limit (400/1750/3500) - 2023/12/23 23:19:35 UTC
Table: 'X-MAS FEVER 5 € - DAY 1(733563978)#0013' 6-max (real money) Seat #6 is the button
Seat 1: pi-ratt-R2d2 (702887)
Seat 2: P1xel7 (240280)
Seat 3: J.Rackham (148074)
Seat 4: Dimix68 (123675)
Seat 5: O.PicsoU (10157)
Seat 6: NonMaisFold (161181)
*** ANTE/BLINDS ***
pi-ratt-R2d2 posts ante 400
P1xel7 posts ante 400
J.Rackham posts ante 400
Dimix68 posts ante 400
O.PicsoU posts ante 400
NonMaisFold posts ante 400
pi-ratt-R2d2 posts small blind 1750
P1xel7 posts big blind 3500
Dealt to P1xel7 [Qc 3h]
*** PRE-FLOP *** 
J.Rackham raises 4375 to 7875
Dimix68 folds
O.PicsoU folds
NonMaisFold calls 7875
pi-ratt-R2d2 folds
P1xel7 folds
*** FLOP *** [3s 3d Qd]
J.Rackham bets 8190
NonMaisFold calls 8190
*** TURN *** [3s 3d Qd][Ts]
J.Rackham bets 25857
NonMaisFold folds
J.Rackham collected 65637 from pot
*** SUMMARY ***
Total pot 65637 | No rake
Board: [3s 3d Qd Ts]
Seat 3: J.Rackham won 65637


Winamax Poker - Tournament "X-MAS FEVER 5 € - DAY 1" buyIn: 4.50€ + 0.50€ level: 18 - HandId: #3150633295033663502-339-1703373638 - Holdem no limit (500/2000/4000) - 2023/12/23 23:20:38 UTC
Table: 'X-MAS FEVER 5 € - DAY 1(733563978)#0013' 6-max (real money) Seat #1 is the button
Seat 1: pi-ratt-R2d2 (700737)
Seat 2: P1xel7 (236380)
Seat 3: J.Rackham (171389)
Seat 4: Dimix68 (123275)
Seat 5: O.PicsoU (9757)
Seat 6: NonMaisFold (144716)
*** ANTE/BLINDS ***
P1xel7 posts ante 500
J.Rackham posts ante 500
pi-ratt-R2d2 posts ante 500
Dimix68 posts ante 500
O.PicsoU posts ante 500
NonMaisFold posts ante 500
P1xel7 posts small blind 2000
J.Rackham posts big blind 4000
Dealt to P1xel7 [8d Kc]
*** PRE-FLOP *** 
Dimix68 calls 4000
O.PicsoU folds
NonMaisFold folds
pi-ratt-R2d2 folds
P1xel7 folds
J.Rackham checks
*** FLOP *** [9h 4s 9s]
J.Rackham checks
Dimix68 bets 4000
J.Rackham calls 4000
*** TURN *** [9h 4s 9s][Ac]
J.Rackham checks
Dimix68 bets 8000
J.Rackham calls 8000
*** RIVER *** [9h 4s 9s Ac][9c]
J.Rackham checks
Dimix68 checks
*** SHOW DOWN ***
J.Rackham shows [Ts 7s] (Trips of 9)
Dimix68 shows [8s 8c] (Full of 9 and 8)
Dimix68 collected 37000 from pot
*** SUMMARY ***
Total pot 37000 | No rake
Board: [9h 4s 9s Ac 9c]
Seat 3: J.Rackham (big blind) showed [Ts 7s] and lost with Trips of 9
Seat 4: Dimix68 showed [8s 8c] and won 37000 with Full of 9 and 8


Winamax Poker - Tournament "X-MAS FEVER 5 € - DAY 1" buyIn: 4.50€ + 0.50€ level: 18 - HandId: #3150633295033663502-340-1703373692 - Holdem no limit (500/2000/4000) - 2023/12/23 23:21:32 UTC
Table: 'X-MAS FEVER 5 € - DAY 1(733563978)#0013' 6-max (real money) Seat #2 is the button
Seat 1: pi-ratt-R2d2 (700237)
Seat 2: P1xel7 (233880)
Seat 3: J.Rackham (154889)
Seat 4: Dimix68 (143775)
Seat 5: O.PicsoU (9257)
Seat 6: NonMaisFold (144216)
*** ANTE/BLINDS ***
J.Rackham posts ante 500
Dimix68 posts ante 500
pi-ratt-R2d2 posts ante 500
P1xel7 posts ante 500
O.PicsoU posts ante 500
NonMaisFold posts ante 500
J.Rackham posts small blind 2000
Dimix68 posts big blind 4000
Dealt to P1xel7 [7c 4d]
*** PRE-FLOP *** 
O.PicsoU folds
NonMaisFold raises 6000 to 10000
pi-ratt-R2d2 folds
P1xel7 folds
J.Rackham calls 8000
Dimix68 folds
*** FLOP *** [4c 3d 6c]
J.Rackham bets 9450
NonMaisFold folds
J.Rackham collected 36450 from pot
*** SUMMARY ***
Total pot 36450 | No rake
Board: [4c 3d 6c]
Seat 3: J.Rackham (small blind) won 36450


Winamax Poker - Tournament "X-MAS FEVER 5 € - DAY 1" buyIn: 4.50€ + 0.50€ level: 18 - HandId: #3150633295033663502-341-1703373746 - Holdem no limit (500/2000/4000) - 2023/12/23 23:22:26 UTC
Table: 'X-MAS FEVER 5 € - DAY 1(733563978)#0013' 6-max (real money) Seat #3 is the button
Seat 1: pi-ratt-R2d2 (699737)
Seat 2: P1xel7 (233380)
Seat 3: J.Rackham (171389)
Seat 4: Dimix68 (139275)
Seat 5: O.PicsoU (8757)
Seat 6: NonMaisFold (133716)
*** ANTE/BLINDS ***
Dimix68 posts ante 500
O.PicsoU posts ante 500
pi-ratt-R2d2 posts ante 500
P1xel7 posts ante 500
J.Rackham posts ante 500
NonMaisFold posts ante 500
Dimix68 posts small blind 2000
O.PicsoU posts big blind 4000
Dealt to P1xel7 [Ts 8h]
*** PRE-FLOP *** 
NonMaisFold raises 6000 to 10000
pi-ratt-R2d2 folds
P1xel7 folds
J.Rackham folds
Dimix68 raises 128775 to 138775 and is all-in
O.PicsoU calls 4257 and is all-in
NonMaisFold folds
*** FLOP *** [As Qc Td]
*** TURN *** [As Qc Td][5h]
*** RIVER *** [As Qc Td 5h][3d]
*** SHOW DOWN ***
O.PicsoU shows [Kc 9d] (High card : Ace)
Dimix68 shows [Kd Kh] (One pair : Kings)
Dimix68 collected 160032 from pot
*** SUMMARY ***
Total pot 160032 | No rake
Board: [As Qc Td 5h 3d]
Seat 4: Dimix68 (small blind) showed [Kd Kh] and won 160032 with One pair : Kings
Seat 5: O.PicsoU (big blind) showed [Kc 9d] and lost with High card : Ace


Winamax Poker - Tournament "X-MAS FEVER 5 € - DAY 1" buyIn: 4.50€ + 0.50€ level: 18 - HandId: #3150633295033663502-342-1703373790 - Holdem no limit (500/2000/4000) - 2023/12/23 23:23:10 UTC
Table: 'X-MAS FEVER 5 € - DAY 1(733563978)#0013' 6-max (real money) Seat #4 is the button
Seat 1: pi-ratt-R2d2 (699237)
Seat 2: P1xel7 (232880)
Seat 3: J.Rackham (170889)
Seat 4: Dimix68 (160032)
Seat 6: NonMaisFold (123216)
*** ANTE/BLINDS ***
NonMaisFold posts ante 500
pi-ratt-R2d2 posts ante 500
P1xel7 posts ante 500
J.Rackham posts ante 500
Dimix68 posts ante 500
NonMaisFold posts big blind 4000
Dealt to P1xel7 [9s 4s]
*** PRE-FLOP *** 
pi-ratt-R2d2 folds
P1xel7 folds
J.Rackham raises 5000 to 9000
Dimix68 folds
NonMaisFold calls 5000
*** FLOP *** [Kd Kc 9h]
NonMaisFold checks
J.Rackham bets 7175
NonMaisFold calls 7175
*** TURN *** [Kd Kc 9h][8h]
NonMaisFold checks
J.Rackham bets 12198
NonMaisFold folds
J.Rackham collected 47048 from pot
*** SUMMARY ***
Total pot 47048 | No rake
Board: [Kd Kc 9h 8h]
Seat 3: J.Rackham won 47048


Winamax Poker - Tournament "X-MAS FEVER 5 € - DAY 1" buyIn: 4.50€ + 0.50€ level: 18 - HandId: #3150633295033663502-343-1703373851 - Holdem no limit (500/2000/4000) - 2023/12/23 23:24:11 UTC
Table: 'X-MAS FEVER 5 € - DAY 1(733563978)#0013' 6-max (real money) Seat #5 is the button
Seat 1: pi-ratt-R2d2 (698737)
Seat 2: P1xel7 (232380)
Seat 3: J.Rackham (189064)
Seat 4: Dimix68 (159532)
Seat 5: Pinkananas (359465)
Seat 6: NonMaisFold (106541)
*** ANTE/BLINDS ***
NonMaisFold posts ante 500
pi-ratt-R2d2 posts ante 500
P1xel7 posts ante 500
J.Rackham posts ante 500
Dimix68 posts ante 500
NonMaisFold posts small blind 2000
pi-ratt-R2d2 posts big blind 4000
Dealt to P1xel7 [9h 6c]
*** PRE-FLOP *** 
P1xel7 folds
J.Rackham folds
Dimix68 folds
NonMaisFold calls 2000
pi-ratt-R2d2 checks
*** FLOP *** [9d Jd Js]
NonMaisFold checks
pi-ratt-R2d2 checks
*** TURN *** [9d Jd Js][6s]
NonMaisFold checks
pi-ratt-R2d2 checks
*** RIVER *** [9d Jd Js 6s][Qc]
NonMaisFold bets 5250
pi-ratt-R2d2 folds
NonMaisFold collected 15750 from pot
*** SUMMARY ***
Total pot 15750 | No rake
Board: [9d Jd Js 6s Qc]
Seat 6: NonMaisFold (small blind) won 15750


Winamax Poker - Tournament "X-MAS FEVER 5 € - DAY 1" buyIn: 4.50€ + 0.50€ level: 18 - HandId: #3150633295033663502-344-1703373912 - Holdem no limit (500/2000/4000) - 2023/12/23 23:25:12 UTC
Table: 'X-MAS FEVER 5 € - DAY 1(733563978)#0013' 6-max (real money) Seat #6 is the button
Seat 1: pi-ratt-R2d2 (694237)
Seat 2: P1xel7 (231880)
Seat 3: J.Rackham (188564)
Seat 4: Dimix68 (159032)
Seat 5: Pinkananas (359465)
Seat 6: NonMaisFold (112541)
*** ANTE/BLINDS ***
pi-ratt-R2d2 posts ante 500
P1xel7 posts ante 500
J.Rackham posts ante 500
Dimix68 posts ante 500
Pinkananas posts ante 500
NonMaisFold posts ante 500
pi-ratt-R2d2 posts small blind 2000
P1xel7 posts big blind 4000
Dealt to P1xel7 [3c 8s]
*** PRE-FLOP *** 
J.Rackham raises 5000 to 9000
Dimix68 folds
Pinkananas calls 9000
NonMaisFold folds
pi-ratt-R2d2 folds
P1xel7 folds
*** FLOP *** [Ts 7c 6s]
J.Rackham checks
Pinkananas bets 8910
J.Rackham calls 8910
*** TURN *** [Ts 7c 6s][3h]
J.Rackham checks
Pinkananas checks
*** RIVER *** [Ts 7c 6s 3h][4d]
J.Rackham checks
Pinkananas bets 30029
J.Rackham folds
Pinkananas collected 74849 from pot
*** SUMMARY ***
Total pot 74849 | No rake
Board: [Ts 7c 6s 3h 4d]
Seat 5: Pinkananas won 74849


Winamax Poker - Tournament "X-MAS FEVER 5 € - DAY 1" buyIn: 4.50€ + 0.50€ level: 18 - HandId: #3150633295033663502-345-1703374053 - Holdem no limit (500/2000/4000) - 2023/12/23 23:27:33 UTC
Table: 'X-MAS FEVER 5 € - DAY 1(733563978)#0013' 6-max (real money) Seat #1 is the button
Seat 1: pi-ratt-R2d2 (691737)
Seat 2: P1xel7 (227380)
Seat 3: J.Rackham (170154)
Seat 4: Dimix68 (158532)
Seat 5: Pinkananas (385875)
Seat 6: NonMaisFold (112041)
*** ANTE/BLINDS ***
P1xel7 posts ante 500
J.Rackham posts ante 500
pi-ratt-R2d2 posts ante 500
Dimix68 posts ante 500
Pinkananas posts ante 500
NonMaisFold posts ante 500
P1xel7 posts small blind 2000
J.Rackham posts big blind 4000
Dealt to P1xel7 [Td 2c]
*** PRE-FLOP *** 
Dimix68 folds
Pinkananas folds
NonMaisFold folds
pi-ratt-R2d2 raises 4000 to 8000
P1xel7 folds
J.Rackham calls 4000
*** FLOP *** [5h 3s Tc]
J.Rackham checks
pi-ratt-R2d2 bets 13650
J.Rackham folds
pi-ratt-R2d2 collected 34650 from pot
*** SUMMARY ***
Total pot 34650 | No rake
Board: [5h 3s Tc]
Seat 1: pi-ratt-R2d2 (button) won 34650


Winamax Poker - Tournament "X-MAS FEVER 5 € - DAY 1" buyIn: 4.50€ + 0.50€ level: 18 - HandId: #3150633295033663502-346-1703374100 - Holdem no limit (500/2000/4000) - 2023/12/23 23:28:20 UTC
Table: 'X-MAS FEVER 5 € - DAY 1(733563978)#0013' 6-max (real money) Seat #2 is the button
Seat 1: pi-ratt-R2d2 (704237)
Seat 2: P1xel7 (224880)
Seat 3: J.Rackham (161654)
Seat 4: Dimix68 (158032)
Seat 5: Pinkananas (385375)
Seat 6: NonMaisFold (111541)
*** ANTE/BLINDS ***
J.Rackham posts ante 500
Dimix68 posts ante 500
pi-ratt-R2d2 posts ante 500
P1xel7 posts ante 500
Pinkananas posts ante 500
NonMaisFold posts ante 500
J.Rackham posts small blind 2000
Dimix68 posts big blind 4000
Dealt to P1xel7 [As 9d]
*** PRE-FLOP *** 
Pinkananas raises 4400 to 8400
NonMaisFold folds
pi-ratt-R2d2 folds
P1xel7 calls 8400
J.Rackham folds
Dimix68 calls 4400
*** FLOP *** [3s 5d Ac]
Dimix68 checks
Pinkananas bets 7550
P1xel7 raises 18875 to 26425
Dimix68 folds
Pinkananas folds
P1xel7 collected 64175 from pot
*** SUMMARY ***
Total pot 64175 | No rake
Board: [3s 5d Ac]
Seat 2: P1xel7 (button) won 64175


Winamax Poker - Tournament "X-MAS FEVER 5 € - DAY 1" buyIn: 4.50€ + 0.50€ level: 18 - HandId: #3150633295033663502-347-1703374157 - Holdem no limit (500/2000/4000) - 2023/12/23 23:29:17 UTC
Table: 'X-MAS FEVER 5 € - DAY 1(733563978)#0013' 6-max (real money) Seat #3 is the button
Seat 1: pi-ratt-R2d2 (703737)
Seat 2: P1xel7 (253730)
Seat 3: J.Rackham (159154)
Seat 4: Dimix68 (149132)
Seat 5: Pinkananas (368925)
Seat 6: NonMaisFold (111041)
*** ANTE/BLINDS ***
Dimix68 posts ante 500
Pinkananas posts ante 500
pi-ratt-R2d2 posts ante 500
P1xel7 posts ante 500
J.Rackham posts ante 500
NonMaisFold posts ante 500
Dimix68 posts small blind 2000
Pinkananas posts big blind 4000
Dealt to P1xel7 [5h 3d]
*** PRE-FLOP *** 
NonMaisFold folds
pi-ratt-R2d2 calls 4000
P1xel7 folds
J.Rackham folds
Dimix68 calls 2000
Pinkananas raises 18000 to 22000
pi-ratt-R2d2 calls 18000
Dimix68 folds
*** FLOP *** [3c 3h Td]
Pinkananas checks
pi-ratt-R2d2 checks
*** TURN *** [3c 3h Td][7h]
Pinkananas checks
pi-ratt-R2d2 bets 51000
Pinkananas folds
pi-ratt-R2d2 collected 102000 from pot
*** SUMMARY ***
Total pot 102000 | No rake
Board: [3c 3h Td 7h]
Seat 1: pi-ratt-R2d2 won 102000


Winamax Poker - Tournament "X-MAS FEVER 5 € - DAY 1" buyIn: 4.50€ + 0.50€ level: 18 - HandId: #3150633295033663502-348-1703374228 - Holdem no limit (500/2000/4000) - 2023/12/23 23:30:28 UTC
Table: 'X-MAS FEVER 5 € - DAY 1(733563978)#0013' 6-max (real money) Seat #4 is the button
Seat 1: pi-ratt-R2d2 (732237)
Seat 2: P1xel7 (253230)
Seat 3: J.Rackham (158654)
Seat 4: Dimix68 (144632)
Seat 5: Pinkananas (346425)
Seat 6: NonMaisFold (110541)
*** ANTE/BLINDS ***
Pinkananas posts ante 500
NonMaisFold posts ante 500
pi-ratt-R2d2 posts ante 500
P1xel7 posts ante 500
J.Rackham posts ante 500
Dimix68 posts ante 500
Pinkananas posts small blind 2000
NonMaisFold posts big blind 4000
Dealt to P1xel7 [6h Jh]
*** PRE-FLOP *** 
pi-ratt-R2d2 calls 4000
P1xel7 folds
J.Rackham folds
Dimix68 folds
Pinkananas raises 18000 to 22000
NonMaisFold folds
pi-ratt-R2d2 calls 18000
*** FLOP *** [4h Kh Tc]
Pinkananas bets 12750
pi-ratt-R2d2 calls 12750
*** TURN *** [4h Kh Tc][3c]
Pinkananas bets 99450
pi-ratt-R2d2 folds
Pinkananas collected 175950 from pot
*** SUMMARY ***
Total pot 175950 | No rake
Board: [4h Kh Tc 3c]
Seat 5: Pinkananas (small blind) won 175950


Winamax Poker - Tournament "X-MAS FEVER 5 € - DAY 1" buyIn: 4.50€ + 0.50€ level: 19 - HandId: #3150633295033663502-349-1703374277 - Holdem no limit (600/2500/5000) - 2023/12/23 23:31:17 UTC
Table: 'X-MAS FEVER 5 € - DAY 1(733563978)#0013' 6-max (real money) Seat #5 is the button
Seat 1: pi-ratt-R2d2 (696987)
Seat 2: P1xel7 (252730)
Seat 3: J.Rackham (158154)
Seat 4: Dimix68 (144132)
Seat 5: Pinkananas (387675)
Seat 6: NonMaisFold (106041)
*** ANTE/BLINDS ***
NonMaisFold posts ante 600
pi-ratt-R2d2 posts ante 600
P1xel7 posts ante 600
J.Rackham posts ante 600
Dimix68 posts ante 600
Pinkananas posts ante 600
NonMaisFold posts small blind 2500
pi-ratt-R2d2 posts big blind 5000
Dealt to P1xel7 [9c 9d]
*** PRE-FLOP *** 
P1xel7 raises 7500 to 12500
J.Rackham folds
Dimix68 folds
Pinkananas folds
NonMaisFold folds
pi-ratt-R2d2 folds
P1xel7 collected 23600 from pot
*** SUMMARY ***
Total pot 23600 | No rake
Seat 2: P1xel7 won 23600


Winamax Poker - Tournament "X-MAS FEVER 5 € - DAY 1" buyIn: 4.50€ + 0.50€ level: 19 - HandId: #3150633295033663502-350-1703374314 - Holdem no limit (600/2500/5000) - 2023/12/23 23:31:54 UTC
Table: 'X-MAS FEVER 5 € - DAY 1(733563978)#0013' 6-max (real money) Seat #6 is the button
Seat 1: pi-ratt-R2d2 (691387)
Seat 2: P1xel7 (263230)
Seat 3: J.Rackham (157554)
Seat 4: Dimix68 (143532)
Seat 5: Pinkananas (387075)
Seat 6: NonMaisFold (102941)
*** ANTE/BLINDS ***
pi-ratt-R2d2 posts ante 600
P1xel7 posts ante 600
J.Rackham posts ante 600
Dimix68 posts ante 600
Pinkananas posts ante 600
NonMaisFold posts ante 600
pi-ratt-R2d2 posts small blind 2500
P1xel7 posts big blind 5000
Dealt to P1xel7 [8c 6c]
*** PRE-FLOP *** 
J.Rackham folds
Dimix68 raises 7500 to 12500
Pinkananas folds
NonMaisFold folds
pi-ratt-R2d2 folds
P1xel7 calls 7500
*** FLOP *** [6d Qh 3s]
P1xel7 checks
Dimix68 bets 15550
P1xel7 calls 15550
*** TURN *** [6d Qh 3s][9h]
P1xel7 checks
Dimix68 bets 31100
P1xel7 calls 31100
*** RIVER *** [6d Qh 3s 9h][2h]
P1xel7 checks
Dimix68 checks
*** SHOW DOWN ***
Dimix68 shows [Kd Ah] (High card : Ace)
P1xel7 shows [8c 6c] (One pair : 6)
P1xel7 collected 124400 from pot
*** SUMMARY ***
Total pot 124400 | No rake
Board: [6d Qh 3s 9h 2h]
Seat 2: P1xel7 (big blind) showed [8c 6c] and won 124400 with One pair : 6
Seat 4: Dimix68 showed [Kd Ah] and lost with High card : Ace


Winamax Poker - Tournament "X-MAS FEVER 5 € - DAY 1" buyIn: 4.50€ + 0.50€ level: 19 - HandId: #3150633295033663502-351-1703374379 - Holdem no limit (600/2500/5000) - 2023/12/23 23:32:59 UTC
Table: 'X-MAS FEVER 5 € - DAY 1(733563978)#0013' 6-max (real money) Seat #1 is the button
Seat 1: pi-ratt-R2d2 (688287)
Seat 2: P1xel7 (327880)
Seat 3: J.Rackham (156954)
Seat 4: Dimix68 (83782)
Seat 5: Pinkananas (386475)
Seat 6: NonMaisFold (102341)
*** ANTE/BLINDS ***
P1xel7 posts ante 600
J.Rackham posts ante 600
pi-ratt-R2d2 posts ante 600
Dimix68 posts ante 600
Pinkananas posts ante 600
NonMaisFold posts ante 600
P1xel7 posts small blind 2500
J.Rackham posts big blind 5000
Dealt to P1xel7 [9s Ah]
*** PRE-FLOP *** 
Dimix68 calls 5000
Pinkananas folds
NonMaisFold folds
pi-ratt-R2d2 raises 32500 to 37500
P1xel7 folds
J.Rackham folds
Dimix68 raises 45682 to 83182 and is all-in
pi-ratt-R2d2 calls 45682
*** FLOP *** [2s Kc Jd]
*** TURN *** [2s Kc Jd][9h]
*** RIVER *** [2s Kc Jd 9h][2d]
*** SHOW DOWN ***
Dimix68 shows [Ts Tc] (Two pairs : Tens and 2)
pi-ratt-R2d2 shows [As Kd] (Two pairs : Kings and 2)
pi-ratt-R2d2 collected 177464 from pot
*** SUMMARY ***
Total pot 177464 | No rake
Board: [2s Kc Jd 9h 2d]
Seat 1: pi-ratt-R2d2 (button) showed [As Kd] and won 177464 with Two pairs : Kings and 2
Seat 4: Dimix68 showed [Ts Tc] and lost with Two pairs : Tens and 2


Winamax Poker - Tournament "X-MAS FEVER 5 € - DAY 1" buyIn: 4.50€ + 0.50€ level: 19 - HandId: #3150633295033663502-352-1703374411 - Holdem no limit (600/2500/5000) - 2023/12/23 23:33:31 UTC
Table: 'X-MAS FEVER 5 € - DAY 1(733563978)#0013' 6-max (real money) Seat #2 is the button
Seat 1: pi-ratt-R2d2 (781969)
Seat 2: P1xel7 (324780)
Seat 3: J.Rackham (151354)
Seat 5: Pinkananas (385875)
Seat 6: NonMaisFold (101741)
*** ANTE/BLINDS ***
J.Rackham posts ante 600
Pinkananas posts ante 600
pi-ratt-R2d2 posts ante 600
P1xel7 posts ante 600
NonMaisFold posts ante 600
J.Rackham posts small blind 2500
Pinkananas posts big blind 5000
Dealt to P1xel7 [8c 2d]
*** PRE-FLOP *** 
NonMaisFold folds
pi-ratt-R2d2 folds
P1xel7 folds
J.Rackham folds
Pinkananas collected 10500 from pot
*** SUMMARY ***
Total pot 10500 | No rake
Seat 5: Pinkananas (big blind) won 10500


Winamax Poker - Tournament "X-MAS FEVER 5 € - DAY 1" buyIn: 4.50€ + 0.50€ level: 19 - HandId: #3150633295033663502-353-1703374424 - Holdem no limit (600/2500/5000) - 2023/12/23 23:33:44 UTC
Table: 'X-MAS FEVER 5 € - DAY 1(733563978)#0013' 6-max (real money) Seat #3 is the button
Seat 1: pi-ratt-R2d2 (781369)
Seat 2: P1xel7 (324180)
Seat 3: J.Rackham (148254)
Seat 5: Pinkananas (390775)
Seat 6: NonMaisFold (101141)
*** ANTE/BLINDS ***
Pinkananas posts ante 600
NonMaisFold posts ante 600
pi-ratt-R2d2 posts ante 600
P1xel7 posts ante 600
J.Rackham posts ante 600
Pinkananas posts small blind 2500
NonMaisFold posts big blind 5000
Dealt to P1xel7 [4s Qd]
*** PRE-FLOP *** 
pi-ratt-R2d2 folds
P1xel7 folds
J.Rackham folds
Pinkananas raises 10000 to 15000
NonMaisFold calls 10000
*** FLOP *** [8s 6d 2s]
Pinkananas checks
NonMaisFold checks
*** TURN *** [8s 6d 2s][As]
Pinkananas bets 16500
NonMaisFold folds
Pinkananas collected 49500 from pot
*** SUMMARY ***
Total pot 49500 | No rake
Board: [8s 6d 2s As]
Seat 5: Pinkananas (small blind) won 49500


Winamax Poker - Tournament "X-MAS FEVER 5 € - DAY 1" buyIn: 4.50€ + 0.50€ level: 19 - HandId: #3150633295033663502-354-1703374477 - Holdem no limit (600/2500/5000) - 2023/12/23 23:34:37 UTC
Table: 'X-MAS FEVER 5 € - DAY 1(733563978)#0013' 6-max (real money) Seat #5 is the button
Seat 1: pi-ratt-R2d2 (780769)
Seat 2: P1xel7 (323580)
Seat 3: J.Rackham (147654)
Seat 4: 1313131313 (366974)
Seat 5: Pinkananas (408175)
Seat 6: NonMaisFold (85541)
*** ANTE/BLINDS ***
NonMaisFold posts ante 600
pi-ratt-R2d2 posts ante 600
P1xel7 posts ante 600
J.Rackham posts ante 600
1313131313 posts ante 600
Pinkananas posts ante 600
NonMaisFold posts small blind 2500
pi-ratt-R2d2 posts big blind 5000
Dealt to P1xel7 [Ah Kd]
*** PRE-FLOP *** 
P1xel7 raises 7500 to 12500
J.Rackham folds
1313131313 calls 12500
Pinkananas calls 12500
NonMaisFold folds
pi-ratt-R2d2 folds
*** FLOP *** [4c Th Qd]
P1xel7 checks
1313131313 checks
Pinkananas checks
*** TURN *** [4c Th Qd][3s]
P1xel7 checks
1313131313 bets 20000
Pinkananas folds
P1xel7 calls 20000
*** RIVER *** [4c Th Qd 3s][Kc]
P1xel7 checks
1313131313 checks
*** SHOW DOWN ***
1313131313 shows [Tc 9c] (One pair : Tens)
P1xel7 shows [Ah Kd] (One pair : Kings)
P1xel7 collected 88600 from pot
*** SUMMARY ***
Total pot 88600 | No rake
Board: [4c Th Qd 3s Kc]
Seat 2: P1xel7 showed [Ah Kd] and won 88600 with One pair : Kings
Seat 4: 1313131313 showed [Tc 9c] and lost with One pair : Tens


Winamax Poker - Tournament "X-MAS FEVER 5 € - DAY 1" buyIn: 4.50€ + 0.50€ level: 19 - HandId: #3150633295033663502-355-1703374557 - Holdem no limit (600/2500/5000) - 2023/12/23 23:35:57 UTC
Table: 'X-MAS FEVER 5 € - DAY 1(733563978)#0013' 6-max (real money) Seat #6 is the button
Seat 1: pi-ratt-R2d2 (775169)
Seat 2: P1xel7 (379080)
Seat 3: J.Rackham (147054)
Seat 4: 1313131313 (333874)
Seat 5: Pinkananas (395075)
Seat 6: NonMaisFold (82441)
*** ANTE/BLINDS ***
pi-ratt-R2d2 posts ante 600
P1xel7 posts ante 600
J.Rackham posts ante 600
1313131313 posts ante 600
Pinkananas posts ante 600
NonMaisFold posts ante 600
pi-ratt-R2d2 posts small blind 2500
P1xel7 posts big blind 5000
Dealt to P1xel7 [2c 3d]
*** PRE-FLOP *** 
J.Rackham folds
1313131313 folds
Pinkananas folds
NonMaisFold raises 76841 to 81841 and is all-in
pi-ratt-R2d2 folds
P1xel7 folds
NonMaisFold collected 92941 from pot
*** SUMMARY ***
Total pot 92941 | No rake
Seat 6: NonMaisFold (button) won 92941


Winamax Poker - Tournament "X-MAS FEVER 5 € - DAY 1" buyIn: 4.50€ + 0.50€ level: 19 - HandId: #3150633295033663502-356-1703374589 - Holdem no limit (600/2500/5000) - 2023/12/23 23:36:29 UTC
Table: 'X-MAS FEVER 5 € - DAY 1(733563978)#0013' 6-max (real money) Seat #1 is the button
Seat 1: pi-ratt-R2d2 (772069)
Seat 2: P1xel7 (373480)
Seat 3: J.Rackham (146454)
Seat 4: 1313131313 (333274)
Seat 5: Pinkananas (394475)
Seat 6: NonMaisFold (92941)
*** ANTE/BLINDS ***
P1xel7 posts ante 600
J.Rackham posts ante 600
pi-ratt-R2d2 posts ante 600
1313131313 posts ante 600
Pinkananas posts ante 600
NonMaisFold posts ante 600
P1xel7 posts small blind 2500
J.Rackham posts big blind 5000
Dealt to P1xel7 [Js 9h]
*** PRE-FLOP *** 
1313131313 raises 5000 to 10000
Pinkananas folds
NonMaisFold folds
pi-ratt-R2d2 raises 15000 to 25000
P1xel7 folds
J.Rackham folds
1313131313 calls 15000
*** FLOP *** [Kd Ah 8d]
1313131313 checks
pi-ratt-R2d2 bets 39715
1313131313 folds
pi-ratt-R2d2 collected 100815 from pot
*** SUMMARY ***
Total pot 100815 | No rake
Board: [Kd Ah 8d]
Seat 1: pi-ratt-R2d2 (button) won 100815


Winamax Poker - Tournament "X-MAS FEVER 5 € - DAY 1" buyIn: 4.50€ + 0.50€ level: 19 - HandId: #3150633295033663502-357-1703374637 - Holdem no limit (600/2500/5000) - 2023/12/23 23:37:17 UTC
Table: 'X-MAS FEVER 5 € - DAY 1(733563978)#0013' 6-max (real money) Seat #2 is the button
Seat 1: pi-ratt-R2d2 (807569)
Seat 2: P1xel7 (370380)
Seat 3: J.Rackham (140854)
Seat 4: 1313131313 (307674)
Seat 5: Pinkananas (393875)
Seat 6: NonMaisFold (92341)
*** ANTE/BLINDS ***
J.Rackham posts ante 600
1313131313 posts ante 600
pi-ratt-R2d2 posts ante 600
P1xel7 posts ante 600
Pinkananas posts ante 600
NonMaisFold posts ante 600
J.Rackham posts small blind 2500
1313131313 posts big blind 5000
Dealt to P1xel7 [8c 4d]
*** PRE-FLOP *** 
Pinkananas folds
NonMaisFold folds
pi-ratt-R2d2 folds
P1xel7 folds
J.Rackham folds
1313131313 collected 11100 from pot
*** SUMMARY ***
Total pot 11100 | No rake
Seat 4: 1313131313 (big blind) won 11100


Winamax Poker - Tournament "X-MAS FEVER 5 € - DAY 1" buyIn: 4.50€ + 0.50€ level: 19 - HandId: #3150633295033663502-358-1703374650 - Holdem no limit (600/2500/5000) - 2023/12/23 23:37:30 UTC
Table: 'X-MAS FEVER 5 € - DAY 1(733563978)#0013' 6-max (real money) Seat #3 is the button
Seat 1: pi-ratt-R2d2 (806969)
Seat 2: P1xel7 (369780)
Seat 3: J.Rackham (137754)
Seat 4: 1313131313 (313174)
Seat 5: Pinkananas (393275)
Seat 6: NonMaisFold (91741)
*** ANTE/BLINDS ***
1313131313 posts ante 600
Pinkananas posts ante 600
pi-ratt-R2d2 posts ante 600
P1xel7 posts ante 600
J.Rackham posts ante 600
NonMaisFold posts ante 600
1313131313 posts small blind 2500
Pinkananas posts big blind 5000
Dealt to P1xel7 [6c Ad]
*** PRE-FLOP *** 
NonMaisFold folds
pi-ratt-R2d2 calls 5000
P1xel7 folds
J.Rackham folds
1313131313 calls 2500
Pinkananas checks
*** FLOP *** [Kd 3c 5s]
1313131313 checks
Pinkananas checks
pi-ratt-R2d2 bets 12090
1313131313 folds
Pinkananas calls 12090
*** TURN *** [Kd 3c 5s][8h]
Pinkananas checks
pi-ratt-R2d2 bets 42780
Pinkananas calls 42780
*** RIVER *** [Kd 3c 5s 8h][Qc]
Pinkananas checks
pi-ratt-R2d2 checks
*** SHOW DOWN ***
pi-ratt-R2d2 shows [3h 4h] (One pair : 3)
Pinkananas shows [7s Kh] (One pair : Kings)
Pinkananas collected 128340 from pot
*** SUMMARY ***
Total pot 128340 | No rake
Board: [Kd 3c 5s 8h Qc]
Seat 1: pi-ratt-R2d2 showed [3h 4h] and lost with One pair : 3
Seat 5: Pinkananas (big blind) showed [7s Kh] and won 128340 with One pair : Kings


Winamax Poker - Tournament "X-MAS FEVER 5 € - DAY 1" buyIn: 4.50€ + 0.50€ level: 19 - HandId: #3150633295033663502-359-1703374700 - Holdem no limit (600/2500/5000) - 2023/12/23 23:38:20 UTC
Table: 'X-MAS FEVER 5 € - DAY 1(733563978)#0013' 6-max (real money) Seat #4 is the button
Seat 1: pi-ratt-R2d2 (746499)
Seat 2: P1xel7 (369180)
Seat 3: J.Rackham (137154)
Seat 4: 1313131313 (307574)
Seat 5: Pinkananas (461145)
Seat 6: NonMaisFold (91141)
*** ANTE/BLINDS ***
Pinkananas posts ante 600
NonMaisFold posts ante 600
pi-ratt-R2d2 posts ante 600
P1xel7 posts ante 600
J.Rackham posts ante 600
1313131313 posts ante 600
Pinkananas posts small blind 2500
NonMaisFold posts big blind 5000
Dealt to P1xel7 [Ac Td]
*** PRE-FLOP *** 
pi-ratt-R2d2 folds
P1xel7 raises 6000 to 11000
J.Rackham folds
1313131313 folds
Pinkananas folds
NonMaisFold folds
P1xel7 collected 22100 from pot
*** SUMMARY ***
Total pot 22100 | No rake
Seat 2: P1xel7 won 22100


Winamax Poker - Tournament "X-MAS FEVER 5 € - DAY 1" buyIn: 4.50€ + 0.50€ level: 19 - HandId: #3150633295033663502-360-1703374749 - Holdem no limit (600/2500/5000) - 2023/12/23 23:39:09 UTC
Table: 'X-MAS FEVER 5 € - DAY 1(733563978)#0013' 6-max (real money) Seat #5 is the button
Seat 1: pi-ratt-R2d2 (745899)
Seat 2: P1xel7 (379680)
Seat 3: J.Rackham (136554)
Seat 4: 1313131313 (306974)
Seat 5: Pinkananas (458045)
Seat 6: NonMaisFold (85541)
*** ANTE/BLINDS ***
NonMaisFold posts ante 600
pi-ratt-R2d2 posts ante 600
P1xel7 posts ante 600
J.Rackham posts ante 600
1313131313 posts ante 600
Pinkananas posts ante 600
NonMaisFold posts small blind 2500
pi-ratt-R2d2 posts big blind 5000
Dealt to P1xel7 [2h Td]
*** PRE-FLOP *** 
P1xel7 folds
J.Rackham folds
1313131313 raises 5000 to 10000
Pinkananas calls 10000
NonMaisFold calls 7500
pi-ratt-R2d2 calls 5000
*** FLOP *** [9d 6s 4s]
NonMaisFold checks
pi-ratt-R2d2 checks
1313131313 checks
Pinkananas bets 10900
NonMaisFold folds
pi-ratt-R2d2 calls 10900
1313131313 calls 10900
*** TURN *** [9d 6s 4s][7c]
pi-ratt-R2d2 checks
1313131313 checks
Pinkananas checks
*** RIVER *** [9d 6s 4s 7c][Ah]
pi-ratt-R2d2 checks
1313131313 checks
Pinkananas checks
*** SHOW DOWN ***
pi-ratt-R2d2 shows [Kd Qd] (High card : Ace)
Pinkananas shows [Ks Js] (High card : Ace)
1313131313 shows [Kh 6h] (One pair : 6)
1313131313 collected 76300 from pot
*** SUMMARY ***
Total pot 76300 | No rake
Board: [9d 6s 4s 7c Ah]
Seat 1: pi-ratt-R2d2 (big blind) showed [Kd Qd] and lost with High card : Ace
Seat 4: 1313131313 showed [Kh 6h] and won 76300 with One pair : 6
Seat 5: Pinkananas (button) showed [Ks Js] and lost with High card : Ace


Winamax Poker - Tournament "X-MAS FEVER 5 € - DAY 1" buyIn: 4.50€ + 0.50€ level: 19 - HandId: #3150633295033663502-361-1703374822 - Holdem no limit (600/2500/5000) - 2023/12/23 23:40:22 UTC
Table: 'X-MAS FEVER 5 € - DAY 1(733563978)#0013' 6-max (real money) Seat #6 is the button
Seat 1: pi-ratt-R2d2 (724399)
Seat 2: P1xel7 (379080)
Seat 3: J.Rackham (135954)
Seat 4: 1313131313 (361774)
Seat 5: Pinkananas (436545)
Seat 6: NonMaisFold (74941)
*** ANTE/BLINDS ***
pi-ratt-R2d2 posts ante 600
P1xel7 posts ante 600
J.Rackham posts ante 600
1313131313 posts ante 600
Pinkananas posts ante 600
NonMaisFold posts ante 600
pi-ratt-R2d2 posts small blind 2500
P1xel7 posts big blind 5000
Dealt to P1xel7 [6d Jh]
*** PRE-FLOP *** 
J.Rackham folds
1313131313 folds
Pinkananas folds
NonMaisFold raises 69341 to 74341 and is all-in
pi-ratt-R2d2 folds
P1xel7 folds
NonMaisFold collected 85441 from pot
*** SUMMARY ***
Total pot 85441 | No rake
Seat 6: NonMaisFold (button) won 85441


Winamax Poker - Tournament "X-MAS FEVER 5 € - DAY 1" buyIn: 4.50€ + 0.50€ level: 19 - HandId: #3150633295033663502-362-1703374846 - Holdem no limit (600/2500/5000) - 2023/12/23 23:40:46 UTC
Table: 'X-MAS FEVER 5 € - DAY 1(733563978)#0013' 6-max (real money) Seat #1 is the button
Seat 1: pi-ratt-R2d2 (721299)
Seat 2: P1xel7 (373480)
Seat 3: J.Rackham (135354)
Seat 4: 1313131313 (361174)
Seat 5: Pinkananas (435945)
Seat 6: NonMaisFold (85441)
*** ANTE/BLINDS ***
P1xel7 posts ante 600
J.Rackham posts ante 600
pi-ratt-R2d2 posts ante 600
1313131313 posts ante 600
Pinkananas posts ante 600
NonMaisFold posts ante 600
P1xel7 posts small blind 2500
J.Rackham posts big blind 5000
Dealt to P1xel7 [6d 6s]
*** PRE-FLOP *** 
1313131313 raises 5000 to 10000
Pinkananas folds
NonMaisFold folds
pi-ratt-R2d2 calls 10000
P1xel7 calls 7500
J.Rackham folds
*** FLOP *** [7d Qh Kc]
P1xel7 checks
1313131313 bets 13510
pi-ratt-R2d2 calls 13510
P1xel7 calls 13510
*** TURN *** [7d Qh Kc][2d]
P1xel7 checks
1313131313 bets 19783
pi-ratt-R2d2 calls 19783
P1xel7 folds
*** RIVER *** [7d Qh Kc 2d][2h]
1313131313 checks
pi-ratt-R2d2 bets 41544
1313131313 folds
pi-ratt-R2d2 collected 160240 from pot
*** SUMMARY ***
Total pot 160240 | No rake
Board: [7d Qh Kc 2d 2h]
Seat 1: pi-ratt-R2d2 (button) won 160240


Winamax Poker - Tournament "X-MAS FEVER 5 € - DAY 1" buyIn: 4.50€ + 0.50€ level: 19 - HandId: #3150633295033663502-363-1703374889 - Holdem no limit (600/2500/5000) - 2023/12/23 23:41:29 UTC
Table: 'X-MAS FEVER 5 € - DAY 1(733563978)#0013' 6-max (real money) Seat #2 is the button
Seat 1: pi-ratt-R2d2 (796102)
Seat 2: P1xel7 (349370)
Seat 3: J.Rackham (129754)
Seat 4: 1313131313 (317281)
Seat 5: Pinkananas (435345)
Seat 6: NonMaisFold (84841)
*** ANTE/BLINDS ***
J.Rackham posts ante 600
1313131313 posts ante 600
pi-ratt-R2d2 posts ante 600
P1xel7 posts ante 600
Pinkananas posts ante 600
NonMaisFold posts ante 600
J.Rackham posts small blind 2500
1313131313 posts big blind 5000
Dealt to P1xel7 [Qs 8h]
*** PRE-FLOP *** 
Pinkananas folds
NonMaisFold raises 5000 to 10000
pi-ratt-R2d2 calls 10000
P1xel7 folds
J.Rackham folds
1313131313 calls 5000
*** FLOP *** [5d 4h Jd]
1313131313 checks
NonMaisFold checks
pi-ratt-R2d2 bets 12635
1313131313 calls 12635
NonMaisFold folds
*** TURN *** [5d 4h Jd][Ad]
1313131313 checks
pi-ratt-R2d2 checks
*** RIVER *** [5d 4h Jd Ad][3c]
1313131313 bets 49096
pi-ratt-R2d2 folds
1313131313 collected 110466 from pot
*** SUMMARY ***
Total pot 110466 | No rake
Board: [5d 4h Jd Ad 3c]
Seat 4: 1313131313 (big blind) won 110466


Winamax Poker - Tournament "X-MAS FEVER 5 € - DAY 1" buyIn: 4.50€ + 0.50€ level: 19 - HandId: #3150633295033663502-364-1703374923 - Holdem no limit (600/2500/5000) - 2023/12/23 23:42:03 UTC
Table: 'X-MAS FEVER 5 € - DAY 1(733563978)#0013' 6-max (real money) Seat #3 is the button
Seat 1: pi-ratt-R2d2 (772867)
Seat 2: P1xel7 (348770)
Seat 3: J.Rackham (126654)
Seat 4: 1313131313 (355416)
Seat 5: Pinkananas (434745)
Seat 6: NonMaisFold (74241)
*** ANTE/BLINDS ***
1313131313 posts ante 600
Pinkananas posts ante 600
pi-ratt-R2d2 posts ante 600
P1xel7 posts ante 600
J.Rackham posts ante 600
NonMaisFold posts ante 600
1313131313 posts small blind 2500
Pinkananas posts big blind 5000
Dealt to P1xel7 [3c 7h]
*** PRE-FLOP *** 
NonMaisFold folds
pi-ratt-R2d2 calls 5000
P1xel7 folds
J.Rackham folds
1313131313 folds
Pinkananas checks
*** FLOP *** [6d Tc 4c]
Pinkananas checks
pi-ratt-R2d2 checks
*** TURN *** [6d Tc 4c][Ks]
Pinkananas checks
pi-ratt-R2d2 bets 10465
Pinkananas calls 10465
*** RIVER *** [6d Tc 4c Ks][2s]
Pinkananas checks
pi-ratt-R2d2 checks
*** SHOW DOWN ***
pi-ratt-R2d2 shows [3s 4s] (One pair : 4)
Pinkananas shows [6s Qs] (One pair : 6)
Pinkananas collected 37030 from pot
*** SUMMARY ***
Total pot 37030 | No rake
Board: [6d Tc 4c Ks 2s]
Seat 1: pi-ratt-R2d2 showed [3s 4s] and lost with One pair : 4
Seat 5: Pinkananas (big blind) showed [6s Qs] and won 37030 with One pair : 6


Winamax Poker - Tournament "X-MAS FEVER 5 € - DAY 1" buyIn: 4.50€ + 0.50€ level: 20 - HandId: #3150633295033663502-365-1703374959 - Holdem no limit (700/3000/6000) - 2023/12/23 23:42:39 UTC
Table: 'X-MAS FEVER 5 € - DAY 1(733563978)#0013' 6-max (real money) Seat #4 is the button
Seat 1: pi-ratt-R2d2 (756802)
Seat 2: P1xel7 (348170)
Seat 3: J.Rackham (126054)
Seat 4: 1313131313 (352316)
Seat 5: Pinkananas (455710)
Seat 6: NonMaisFold (73641)
*** ANTE/BLINDS ***
Pinkananas posts ante 700
NonMaisFold posts ante 700
pi-ratt-R2d2 posts ante 700
P1xel7 posts ante 700
J.Rackham posts ante 700
1313131313 posts ante 700
Pinkananas posts small blind 3000
NonMaisFold posts big blind 6000
Dealt to P1xel7 [9c 7h]
*** PRE-FLOP *** 
pi-ratt-R2d2 folds
P1xel7 folds
J.Rackham folds
1313131313 raises 6000 to 12000
Pinkananas raises 42000 to 54000
NonMaisFold folds
1313131313 folds
Pinkananas collected 76200 from pot
*** SUMMARY ***
Total pot 76200 | No rake
Seat 5: Pinkananas (small blind) won 76200


Winamax Poker - Tournament "X-MAS FEVER 5 € - DAY 1" buyIn: 4.50€ + 0.50€ level: 20 - HandId: #3150633295033663502-366-1703375002 - Holdem no limit (700/3000/6000) - 2023/12/23 23:43:22 UTC
Table: 'X-MAS FEVER 5 € - DAY 1(733563978)#0013' 6-max (real money) Seat #5 is the button
Seat 1: pi-ratt-R2d2 (756102)
Seat 2: P1xel7 (347470)
Seat 3: J.Rackham (125354)
Seat 4: 1313131313 (339616)
Seat 5: Pinkananas (477210)
Seat 6: NonMaisFold (66941)
*** ANTE/BLINDS ***
NonMaisFold posts ante 700
pi-ratt-R2d2 posts ante 700
P1xel7 posts ante 700
J.Rackham posts ante 700
1313131313 posts ante 700
Pinkananas posts ante 700
NonMaisFold posts small blind 3000
pi-ratt-R2d2 posts big blind 6000
Dealt to P1xel7 [9s 6d]
*** PRE-FLOP *** 
P1xel7 folds
J.Rackham folds
1313131313 folds
Pinkananas folds
NonMaisFold folds
pi-ratt-R2d2 collected 13200 from pot
*** SUMMARY ***
Total pot 13200 | No rake
Seat 1: pi-ratt-R2d2 (big blind) won 13200


Winamax Poker - Tournament "X-MAS FEVER 5 € - DAY 1" buyIn: 4.50€ + 0.50€ level: 20 - HandId: #3150633295033663502-367-1703375039 - Holdem no limit (700/3000/6000) - 2023/12/23 23:43:59 UTC
Table: 'X-MAS FEVER 5 € - DAY 1(733563978)#0013' 6-max (real money) Seat #6 is the button
Seat 1: pi-ratt-R2d2 (762602)
Seat 2: P1xel7 (346770)
Seat 3: J.Rackham (124654)
Seat 4: 1313131313 (338916)
Seat 5: Pinkananas (476510)
Seat 6: NonMaisFold (63241)
*** ANTE/BLINDS ***
pi-ratt-R2d2 posts ante 700
P1xel7 posts ante 700
J.Rackham posts ante 700
1313131313 posts ante 700
Pinkananas posts ante 700
NonMaisFold posts ante 700
pi-ratt-R2d2 posts small blind 3000
P1xel7 posts big blind 6000
Dealt to P1xel7 [3c Ts]
*** PRE-FLOP *** 
J.Rackham folds
1313131313 folds
Pinkananas folds
NonMaisFold folds
pi-ratt-R2d2 calls 3000
P1xel7 checks
*** FLOP *** [4c 4h 2d]
pi-ratt-R2d2 checks
P1xel7 bets 8100
pi-ratt-R2d2 folds
P1xel7 collected 24300 from pot
*** SUMMARY ***
Total pot 24300 | No rake
Board: [4c 4h 2d]
Seat 2: P1xel7 (big blind) won 24300


Winamax Poker - Tournament "X-MAS FEVER 5 € - DAY 1" buyIn: 4.50€ + 0.50€ level: 20 - HandId: #3150633295033663502-368-1703375054 - Holdem no limit (700/3000/6000) - 2023/12/23 23:44:14 UTC
Table: 'X-MAS FEVER 5 € - DAY 1(733563978)#0013' 6-max (real money) Seat #1 is the button
Seat 1: pi-ratt-R2d2 (755902)
Seat 2: P1xel7 (356270)
Seat 3: J.Rackham (123954)
Seat 4: 1313131313 (338216)
Seat 5: Pinkananas (475810)
Seat 6: NonMaisFold (62541)
*** ANTE/BLINDS ***
P1xel7 posts ante 700
J.Rackham posts ante 700
pi-ratt-R2d2 posts ante 700
1313131313 posts ante 700
Pinkananas posts ante 700
NonMaisFold posts ante 700
P1xel7 posts small blind 3000
J.Rackham posts big blind 6000
Dealt to P1xel7 [5s 9d]
*** PRE-FLOP *** 
1313131313 raises 6000 to 12000
Pinkananas folds
NonMaisFold folds
pi-ratt-R2d2 calls 12000
P1xel7 folds
J.Rackham folds
*** FLOP *** [3d 2h 8c]
1313131313 bets 13020
pi-ratt-R2d2 raises 13671 to 26691
1313131313 calls 13671
*** TURN *** [3d 2h 8c][8s]
1313131313 checks
pi-ratt-R2d2 bets 31704
1313131313 folds
pi-ratt-R2d2 collected 122286 from pot
*** SUMMARY ***
Total pot 122286 | No rake
Board: [3d 2h 8c 8s]
Seat 1: pi-ratt-R2d2 (button) won 122286


Winamax Poker - Tournament "X-MAS FEVER 5 € - DAY 1" buyIn: 4.50€ + 0.50€ level: 20 - HandId: #3150633295033663502-369-1703375076 - Holdem no limit (700/3000/6000) - 2023/12/23 23:44:36 UTC
Table: 'X-MAS FEVER 5 € - DAY 1(733563978)#0013' 6-max (real money) Seat #2 is the button
Seat 1: pi-ratt-R2d2 (807093)
Seat 2: P1xel7 (352570)
Seat 3: J.Rackham (117254)
Seat 4: 1313131313 (298825)
Seat 5: Pinkananas (475110)
Seat 6: NonMaisFold (61841)
*** ANTE/BLINDS ***
J.Rackham posts ante 700
1313131313 posts ante 700
pi-ratt-R2d2 posts ante 700
P1xel7 posts ante 700
Pinkananas posts ante 700
NonMaisFold posts ante 700
J.Rackham posts small blind 3000
1313131313 posts big blind 6000
Dealt to P1xel7 [6c 3h]
*** PRE-FLOP *** 
Pinkananas folds
NonMaisFold folds
pi-ratt-R2d2 folds
P1xel7 folds
J.Rackham folds
1313131313 collected 13200 from pot
*** SUMMARY ***
Total pot 13200 | No rake
Seat 4: 1313131313 (big blind) won 13200


Winamax Poker - Tournament "X-MAS FEVER 5 € - DAY 1" buyIn: 4.50€ + 0.50€ level: 20 - HandId: #3150633295033663502-370-1703375088 - Holdem no limit (700/3000/6000) - 2023/12/23 23:44:48 UTC
Table: 'X-MAS FEVER 5 € - DAY 1(733563978)#0013' 6-max (real money) Seat #3 is the button
Seat 1: pi-ratt-R2d2 (806393)
Seat 2: P1xel7 (351870)
Seat 3: J.Rackham (113554)
Seat 4: 1313131313 (305325)
Seat 5: Pinkananas (474410)
Seat 6: NonMaisFold (61141)
*** ANTE/BLINDS ***
1313131313 posts ante 700
Pinkananas posts ante 700
pi-ratt-R2d2 posts ante 700
P1xel7 posts ante 700
J.Rackham posts ante 700
NonMaisFold posts ante 700
1313131313 posts small blind 3000
Pinkananas posts big blind 6000
Dealt to P1xel7 [Qc 2h]
*** PRE-FLOP *** 
NonMaisFold folds
pi-ratt-R2d2 folds
P1xel7 folds
J.Rackham folds
1313131313 calls 3000
Pinkananas raises 15000 to 21000
1313131313 folds
Pinkananas collected 31200 from pot
*** SUMMARY ***
Total pot 31200 | No rake
Seat 5: Pinkananas (big blind) won 31200


Winamax Poker - Tournament "X-MAS FEVER 5 € - DAY 1" buyIn: 4.50€ + 0.50€ level: 20 - HandId: #3150633295033663502-371-1703375111 - Holdem no limit (700/3000/6000) - 2023/12/23 23:45:11 UTC
Table: 'X-MAS FEVER 5 € - DAY 1(733563978)#0013' 6-max (real money) Seat #4 is the button
Seat 1: pi-ratt-R2d2 (805693)
Seat 2: P1xel7 (351170)
Seat 3: J.Rackham (112854)
Seat 4: 1313131313 (298625)
Seat 5: Pinkananas (483910)
Seat 6: NonMaisFold (60441)
*** ANTE/BLINDS ***
Pinkananas posts ante 700
NonMaisFold posts ante 700
pi-ratt-R2d2 posts ante 700
P1xel7 posts ante 700
J.Rackham posts ante 700
1313131313 posts ante 700
Pinkananas posts small blind 3000
NonMaisFold posts big blind 6000
Dealt to P1xel7 [9c 8c]
*** PRE-FLOP *** 
pi-ratt-R2d2 folds
P1xel7 raises 9000 to 15000
J.Rackham folds
1313131313 folds
Pinkananas folds
NonMaisFold folds
P1xel7 collected 28200 from pot
*** SUMMARY ***
Total pot 28200 | No rake
Seat 2: P1xel7 won 28200


Winamax Poker - Tournament "X-MAS FEVER 5 € - DAY 1" buyIn: 4.50€ + 0.50€ level: 20 - HandId: #3150633295033663502-372-1703375138 - Holdem no limit (700/3000/6000) - 2023/12/23 23:45:38 UTC
Table: 'X-MAS FEVER 5 € - DAY 1(733563978)#0013' 6-max (real money) Seat #5 is the button
Seat 1: pi-ratt-R2d2 (804993)
Seat 2: P1xel7 (363670)
Seat 3: J.Rackham (112154)
Seat 4: 1313131313 (297925)
Seat 5: Pinkananas (480210)
Seat 6: NonMaisFold (53741)
*** ANTE/BLINDS ***
NonMaisFold posts ante 700
pi-ratt-R2d2 posts ante 700
P1xel7 posts ante 700
J.Rackham posts ante 700
1313131313 posts ante 700
Pinkananas posts ante 700
NonMaisFold posts small blind 3000
pi-ratt-R2d2 posts big blind 6000
Dealt to P1xel7 [2h 6c]
*** PRE-FLOP *** 
P1xel7 folds
J.Rackham folds
1313131313 folds
Pinkananas raises 6600 to 12600
NonMaisFold folds
pi-ratt-R2d2 calls 6600
*** FLOP *** [Jc Ad 3s]
pi-ratt-R2d2 checks
Pinkananas bets 33000
pi-ratt-R2d2 folds
Pinkananas collected 65400 from pot
*** SUMMARY ***
Total pot 65400 | No rake
Board: [Jc Ad 3s]
Seat 5: Pinkananas (button) won 65400


Winamax Poker - Tournament "X-MAS FEVER 5 € - DAY 1" buyIn: 4.50€ + 0.50€ level: 20 - HandId: #3150633295033663502-373-1703375170 - Holdem no limit (700/3000/6000) - 2023/12/23 23:46:10 UTC
Table: 'X-MAS FEVER 5 € - DAY 1(733563978)#0013' 6-max (real money) Seat #6 is the button
Seat 1: pi-ratt-R2d2 (791693)
Seat 2: P1xel7 (362970)
Seat 3: J.Rackham (111454)
Seat 4: 1313131313 (297225)
Seat 5: Pinkananas (499310)
Seat 6: NonMaisFold (50041)
*** ANTE/BLINDS ***
pi-ratt-R2d2 posts ante 700
P1xel7 posts ante 700
J.Rackham posts ante 700
1313131313 posts ante 700
Pinkananas posts ante 700
NonMaisFold posts ante 700
pi-ratt-R2d2 posts small blind 3000
P1xel7 posts big blind 6000
Dealt to P1xel7 [2d 6c]
*** PRE-FLOP *** 
J.Rackham folds
1313131313 folds
Pinkananas folds
NonMaisFold folds
pi-ratt-R2d2 calls 3000
P1xel7 checks
*** FLOP *** [Kd 3h 8c]
pi-ratt-R2d2 bets 10530
P1xel7 folds
pi-ratt-R2d2 collected 26730 from pot
*** SUMMARY ***
Total pot 26730 | No rake
Board: [Kd 3h 8c]
Seat 1: pi-ratt-R2d2 (small blind) won 26730


Winamax Poker - Tournament "X-MAS FEVER 5 € - DAY 1" buyIn: 4.50€ + 0.50€ level: 20 - HandId: #3150633295033663502-374-1703375199 - Holdem no limit (700/3000/6000) - 2023/12/23 23:46:39 UTC
Table: 'X-MAS FEVER 5 € - DAY 1(733563978)#0013' 6-max (real money) Seat #1 is the button
Seat 1: pi-ratt-R2d2 (801193)
Seat 2: P1xel7 (356270)
Seat 3: J.Rackham (110754)
Seat 4: 1313131313 (296525)
Seat 5: Pinkananas (498610)
Seat 6: NonMaisFold (49341)
*** ANTE/BLINDS ***
P1xel7 posts ante 700
J.Rackham posts ante 700
pi-ratt-R2d2 posts ante 700
1313131313 posts ante 700
Pinkananas posts ante 700
NonMaisFold posts ante 700
P1xel7 posts small blind 3000
J.Rackham posts big blind 6000
Dealt to P1xel7 [Ac 3s]
*** PRE-FLOP *** 
1313131313 folds
Pinkananas folds
NonMaisFold folds
pi-ratt-R2d2 raises 6000 to 12000
P1xel7 folds
J.Rackham folds
pi-ratt-R2d2 collected 25200 from pot
*** SUMMARY ***
Total pot 25200 | No rake
Seat 1: pi-ratt-R2d2 (button) won 25200


Winamax Poker - Tournament "X-MAS FEVER 5 € - DAY 1" buyIn: 4.50€ + 0.50€ level: 20 - HandId: #3150633295033663502-375-1703375222 - Holdem no limit (700/3000/6000) - 2023/12/23 23:47:02 UTC
Table: 'X-MAS FEVER 5 € - DAY 1(733563978)#0013' 6-max (real money) Seat #2 is the button
Seat 1: pi-ratt-R2d2 (813693)
Seat 2: P1xel7 (352570)
Seat 3: J.Rackham (104054)
Seat 4: 1313131313 (295825)
Seat 5: Pinkananas (497910)
Seat 6: NonMaisFold (48641)
*** ANTE/BLINDS ***
J.Rackham posts ante 700
1313131313 posts ante 700
pi-ratt-R2d2 posts ante 700
P1xel7 posts ante 700
Pinkananas posts ante 700
NonMaisFold posts ante 700
J.Rackham posts small blind 3000
1313131313 posts big blind 6000
Dealt to P1xel7 [Jc Jd]
*** PRE-FLOP *** 
Pinkananas folds
NonMaisFold folds
pi-ratt-R2d2 folds
P1xel7 raises 9000 to 15000
J.Rackham folds
1313131313 calls 9000
*** FLOP *** [7c 5s 9d]
1313131313 checks
P1xel7 bets 24180
1313131313 calls 24180
*** TURN *** [7c 5s 9d][8d]
1313131313 bets 48000
P1xel7 calls 48000
*** RIVER *** [7c 5s 9d 8d][Kd]
1313131313 bets 102000
P1xel7 folds
1313131313 collected 283560 from pot
*** SUMMARY ***
Total pot 283560 | No rake
Board: [7c 5s 9d 8d Kd]
Seat 4: 1313131313 (big blind) won 283560


Winamax Poker - Tournament "X-MAS FEVER 5 € - DAY 1" buyIn: 4.50€ + 0.50€ level: 20 - HandId: #3150633295033663502-376-1703375278 - Holdem no limit (700/3000/6000) - 2023/12/23 23:47:58 UTC
Table: 'X-MAS FEVER 5 € - DAY 1(733563978)#0013' 6-max (real money) Seat #3 is the button
Seat 1: pi-ratt-R2d2 (812993)
Seat 2: P1xel7 (264690)
Seat 3: J.Rackham (100354)
Seat 4: 1313131313 (389505)
Seat 5: Pinkananas (497210)
Seat 6: NonMaisFold (47941)
*** ANTE/BLINDS ***
1313131313 posts ante 700
Pinkananas posts ante 700
pi-ratt-R2d2 posts ante 700
P1xel7 posts ante 700
J.Rackham posts ante 700
NonMaisFold posts ante 700
1313131313 posts small blind 3000
Pinkananas posts big blind 6000
Dealt to P1xel7 [Qd 7c]
*** PRE-FLOP *** 
NonMaisFold folds
pi-ratt-R2d2 folds
P1xel7 folds
J.Rackham folds
1313131313 calls 3000
Pinkananas checks
*** FLOP *** [Tc 7s 6d]
1313131313 bets 6000
Pinkananas raises 15000 to 21000
1313131313 calls 15000
*** TURN *** [Tc 7s 6d][Qc]
1313131313 checks
Pinkananas bets 46560
1313131313 folds
Pinkananas collected 104760 from pot
*** SUMMARY ***
Total pot 104760 | No rake
Board: [Tc 7s 6d Qc]
Seat 5: Pinkananas (big blind) won 104760


Winamax Poker - Tournament "X-MAS FEVER 5 € - DAY 1" buyIn: 4.50€ + 0.50€ level: 20 - HandId: #3150633295033663502-377-1703375315 - Holdem no limit (700/3000/6000) - 2023/12/23 23:48:35 UTC
Table: 'X-MAS FEVER 5 € - DAY 1(733563978)#0013' 6-max (real money) Seat #4 is the button
Seat 1: pi-ratt-R2d2 (812293)
Seat 2: P1xel7 (263990)
Seat 3: J.Rackham (99654)
Seat 4: 1313131313 (361805)
Seat 5: Pinkananas (527710)
Seat 6: NonMaisFold (47241)
*** ANTE/BLINDS ***
Pinkananas posts ante 700
NonMaisFold posts ante 700
pi-ratt-R2d2 posts ante 700
P1xel7 posts ante 700
J.Rackham posts ante 700
1313131313 posts ante 700
Pinkananas posts small blind 3000
NonMaisFold posts big blind 6000
Dealt to P1xel7 [5h Jh]
*** PRE-FLOP *** 
pi-ratt-R2d2 folds
P1xel7 folds
J.Rackham folds
1313131313 raises 6000 to 12000
Pinkananas folds
NonMaisFold calls 6000
*** FLOP *** [7h Kh Ah]
NonMaisFold bets 34541 and is all-in
1313131313 calls 34541
*** TURN *** [7h Kh Ah][Kc]
*** RIVER *** [7h Kh Ah Kc][Kd]
*** SHOW DOWN ***
NonMaisFold shows [9h 7d] (Full of Kings and 7)
1313131313 shows [8c Ac] (Full of Kings and Aces)
1313131313 collected 100282 from pot
*** SUMMARY ***
Total pot 100282 | No rake
Board: [7h Kh Ah Kc Kd]
Seat 4: 1313131313 (button) showed [8c Ac] and won 100282 with Full of Kings and Aces
Seat 6: NonMaisFold (big blind) showed [9h 7d] and lost with Full of Kings and 7


Winamax Poker - Tournament "X-MAS FEVER 5 € - DAY 1" buyIn: 4.50€ + 0.50€ level: 20 - HandId: #3150633295033663502-378-1703375359 - Holdem no limit (700/3000/6000) - 2023/12/23 23:49:19 UTC
Table: 'X-MAS FEVER 5 € - DAY 1(733563978)#0013' 6-max (real money) Seat #5 is the button
Seat 1: pi-ratt-R2d2 (811593)
Seat 2: P1xel7 (263290)
Seat 3: J.Rackham (98954)
Seat 4: 1313131313 (414846)
Seat 5: Pinkananas (524010)
*** ANTE/BLINDS ***
pi-ratt-R2d2 posts ante 700
P1xel7 posts ante 700
J.Rackham posts ante 700
1313131313 posts ante 700
Pinkananas posts ante 700
pi-ratt-R2d2 posts big blind 6000
Dealt to P1xel7 [Jd 9h]
*** PRE-FLOP *** 
P1xel7 folds
J.Rackham folds
1313131313 folds
Pinkananas raises 6600 to 12600
pi-ratt-R2d2 calls 6600
*** FLOP *** [9d 2c Jh]
pi-ratt-R2d2 checks
Pinkananas checks
*** TURN *** [9d 2c Jh][Ts]
pi-ratt-R2d2 bets 28700
Pinkananas raises 85300 to 114000
pi-ratt-R2d2 folds
Pinkananas collected 171400 from pot
*** SUMMARY ***
Total pot 171400 | No rake
Board: [9d 2c Jh Ts]
Seat 5: Pinkananas (button) won 171400


Winamax Poker - Tournament "X-MAS FEVER 5 € - DAY 1" buyIn: 4.50€ + 0.50€ level: 20 - HandId: #3150633295033663502-379-1703375402 - Holdem no limit (700/3000/6000) - 2023/12/23 23:50:02 UTC
Table: 'X-MAS FEVER 5 € - DAY 1(733563978)#0013' 6-max (real money) Seat #6 is the button
Seat 1: pi-ratt-R2d2 (769593)
Seat 2: P1xel7 (262590)
Seat 3: J.Rackham (98254)
Seat 4: 1313131313 (414146)
Seat 5: Pinkananas (568110)
Seat 6: Raigon (170433)
*** ANTE/BLINDS ***
pi-ratt-R2d2 posts ante 700
P1xel7 posts ante 700
J.Rackham posts ante 700
1313131313 posts ante 700
Pinkananas posts ante 700
pi-ratt-R2d2 posts small blind 3000
P1xel7 posts big blind 6000
Dealt to P1xel7 [4c 2h]
*** PRE-FLOP *** 
J.Rackham folds
1313131313 folds
Pinkananas folds
pi-ratt-R2d2 calls 3000
P1xel7 checks
*** FLOP *** [8c 4s Tc]
pi-ratt-R2d2 checks
P1xel7 bets 7750
pi-ratt-R2d2 calls 7750
*** TURN *** [8c 4s Tc][Ts]
pi-ratt-R2d2 checks
P1xel7 bets 15500
pi-ratt-R2d2 calls 15500
*** RIVER *** [8c 4s Tc Ts][Jd]
pi-ratt-R2d2 checks
P1xel7 checks
*** SHOW DOWN ***
P1xel7 shows [4c 2h] (Two pairs : Tens and 4)
pi-ratt-R2d2 shows [7d 9d] (Straight Jack high)
pi-ratt-R2d2 collected 62000 from pot
*** SUMMARY ***
Total pot 62000 | No rake
Board: [8c 4s Tc Ts Jd]
Seat 1: pi-ratt-R2d2 (small blind) showed [7d 9d] and won 62000 with Straight Jack high
Seat 2: P1xel7 (big blind) showed [4c 2h] and lost with Two pairs : Tens and 4


Winamax Poker - Tournament "X-MAS FEVER 5 € - DAY 1" buyIn: 4.50€ + 0.50€ level: 20 - HandId: #3150633295033663502-380-1703375431 - Holdem no limit (700/3000/6000) - 2023/12/23 23:50:31 UTC
Table: 'X-MAS FEVER 5 € - DAY 1(733563978)#0013' 6-max (real money) Seat #1 is the button
Seat 1: pi-ratt-R2d2 (801643)
Seat 2: P1xel7 (232640)
Seat 3: J.Rackham (97554)
Seat 4: 1313131313 (413446)
Seat 5: Pinkananas (567410)
Seat 6: Raigon (170433)
*** ANTE/BLINDS ***
P1xel7 posts ante 700
J.Rackham posts ante 700
pi-ratt-R2d2 posts ante 700
1313131313 posts ante 700
Pinkananas posts ante 700
Raigon posts ante 700
P1xel7 posts small blind 3000
J.Rackham posts big blind 6000
Dealt to P1xel7 [7c Ad]
*** PRE-FLOP *** 
1313131313 folds
Pinkananas folds
Raigon raises 9000 to 15000
pi-ratt-R2d2 folds
P1xel7 calls 12000
J.Rackham folds
*** FLOP *** [Qc Qs 8c]
P1xel7 checks
Raigon bets 14070
P1xel7 folds
Raigon collected 54270 from pot
*** SUMMARY ***
Total pot 54270 | No rake
Board: [Qc Qs 8c]
Seat 6: Raigon won 54270


Winamax Poker - Tournament "X-MAS FEVER 5 € - DAY 1" buyIn: 4.50€ + 0.50€ level: 20 - HandId: #3150633295033663502-381-1703375456 - Holdem no limit (700/3000/6000) - 2023/12/23 23:50:56 UTC
Table: 'X-MAS FEVER 5 € - DAY 1(733563978)#0013' 6-max (real money) Seat #2 is the button
Seat 1: pi-ratt-R2d2 (800943)
Seat 2: P1xel7 (216940)
Seat 3: J.Rackham (90854)
Seat 4: 1313131313 (412746)
Seat 5: Pinkananas (566710)
Seat 6: Raigon (194933)
*** ANTE/BLINDS ***
J.Rackham posts ante 700
1313131313 posts ante 700
pi-ratt-R2d2 posts ante 700
P1xel7 posts ante 700
Pinkananas posts ante 700
Raigon posts ante 700
J.Rackham posts small blind 3000
1313131313 posts big blind 6000
Dealt to P1xel7 [2h 5h]
*** PRE-FLOP *** 
Pinkananas raises 6600 to 12600
Raigon folds
pi-ratt-R2d2 folds
P1xel7 folds
J.Rackham folds
1313131313 calls 6600
*** FLOP *** [8s 9c 7c]
1313131313 checks
Pinkananas checks
*** TURN *** [8s 9c 7c][Kc]
1313131313 checks
Pinkananas bets 25920
1313131313 calls 25920
*** RIVER *** [8s 9c 7c Kc][3h]
1313131313 checks
Pinkananas bets 67392
1313131313 folds
Pinkananas collected 151632 from pot
*** SUMMARY ***
Total pot 151632 | No rake
Board: [8s 9c 7c Kc 3h]
Seat 5: Pinkananas won 151632


Winamax Poker - Tournament "X-MAS FEVER 5 € - DAY 1" buyIn: 4.50€ + 0.50€ level: 20 - HandId: #3150633295033663502-382-1703375546 - Holdem no limit (700/3000/6000) - 2023/12/23 23:52:26 UTC
Table: 'X-MAS FEVER 5 € - DAY 1(733563978)#0013' 6-max (real money) Seat #3 is the button
Seat 1: pi-ratt-R2d2 (800243)
Seat 2: P1xel7 (216240)
Seat 3: J.Rackham (87154)
Seat 4: 1313131313 (373526)
Seat 5: Pinkananas (611730)
Seat 6: Raigon (194233)
*** ANTE/BLINDS ***
1313131313 posts ante 700
Pinkananas posts ante 700
pi-ratt-R2d2 posts ante 700
P1xel7 posts ante 700
J.Rackham posts ante 700
Raigon posts ante 700
1313131313 posts small blind 3000
Pinkananas posts big blind 6000
Dealt to P1xel7 [6d 9s]
*** PRE-FLOP *** 
Raigon raises 6000 to 12000
pi-ratt-R2d2 folds
P1xel7 folds
J.Rackham folds
1313131313 folds
Pinkananas calls 6000
*** FLOP *** [Js 2d 9d]
Pinkananas checks
Raigon bets 10920
Pinkananas calls 10920
*** TURN *** [Js 2d 9d][Kd]
Pinkananas checks
Raigon bets 30000
Pinkananas calls 30000
*** RIVER *** [Js 2d 9d Kd][Kc]
Pinkananas checks
Raigon checks
*** SHOW DOWN ***
Raigon shows [3d 3c] (Two pairs : Kings and 3)
Pinkananas shows [Ks 8s] (Trips of Kings)
Pinkananas collected 113040 from pot
*** SUMMARY ***
Total pot 113040 | No rake
Board: [Js 2d 9d Kd Kc]
Seat 5: Pinkananas (big blind) showed [Ks 8s] and won 113040 with Trips of Kings
Seat 6: Raigon showed [3d 3c] and lost with Two pairs : Kings and 3


Winamax Poker - Tournament "X-MAS FEVER 5 € - DAY 1" buyIn: 4.50€ + 0.50€ level: 21 - HandId: #3150633295033663502-383-1703375655 - Holdem no limit (800/3500/7000) - 2023/12/23 23:54:15 UTC
Table: 'X-MAS FEVER 5 € - DAY 1(733563978)#0013' 6-max (real money) Seat #4 is the button
Seat 1: pi-ratt-R2d2 (799543)
Seat 2: P1xel7 (215540)
Seat 3: J.Rackham (86454)
Seat 4: 1313131313 (369826)
Seat 5: Pinkananas (671150)
Seat 6: Raigon (140613)
*** ANTE/BLINDS ***
Pinkananas posts ante 800
Raigon posts ante 800
pi-ratt-R2d2 posts ante 800
P1xel7 posts ante 800
J.Rackham posts ante 800
1313131313 posts ante 800
Pinkananas posts small blind 3500
Raigon posts big blind 7000
Dealt to P1xel7 [5c 7h]
*** PRE-FLOP *** 
pi-ratt-R2d2 folds
P1xel7 folds
J.Rackham folds
1313131313 raises 7000 to 14000
Pinkananas folds
Raigon raises 36300 to 50300
1313131313 folds
Raigon collected 72600 from pot
*** SUMMARY ***
Total pot 72600 | No rake
Seat 6: Raigon (big blind) won 72600


Winamax Poker - Tournament "X-MAS FEVER 5 € - DAY 1" buyIn: 4.50€ + 0.50€ level: 21 - HandId: #3150633295033663502-384-1703375680 - Holdem no limit (800/3500/7000) - 2023/12/23 23:54:40 UTC
Table: 'X-MAS FEVER 5 € - DAY 1(733563978)#0013' 6-max (real money) Seat #5 is the button
Seat 1: pi-ratt-R2d2 (798743)
Seat 2: P1xel7 (214740)
Seat 3: J.Rackham (85654)
Seat 4: 1313131313 (355026)
Seat 5: Pinkananas (666850)
Seat 6: Raigon (162113)
*** ANTE/BLINDS ***
Raigon posts ante 800
pi-ratt-R2d2 posts ante 800
P1xel7 posts ante 800
J.Rackham posts ante 800
1313131313 posts ante 800
Pinkananas posts ante 800
Raigon posts small blind 3500
pi-ratt-R2d2 posts big blind 7000
Dealt to P1xel7 [Td 8c]
*** PRE-FLOP *** 
P1xel7 folds
J.Rackham folds
1313131313 folds
Pinkananas raises 7700 to 14700
Raigon folds
pi-ratt-R2d2 calls 7700
*** FLOP *** [Jd 9c Ks]
pi-ratt-R2d2 checks
Pinkananas checks
*** TURN *** [Jd 9c Ks][Tc]
pi-ratt-R2d2 checks
Pinkananas bets 9425
pi-ratt-R2d2 calls 9425
*** RIVER *** [Jd 9c Ks Tc][Th]
pi-ratt-R2d2 checks
Pinkananas bets 45240
pi-ratt-R2d2 folds
Pinkananas collected 101790 from pot
*** SUMMARY ***
Total pot 101790 | No rake
Board: [Jd 9c Ks Tc Th]
Seat 5: Pinkananas (button) won 101790


