Winamax Poker - Tournament "MYSTERY KO" buyIn: 1.80€ + 0.20€ level: 1 - HandId: #3104311471450882133-33-1703099114 - Holdem no limit (25/100/200) - 2023/12/20 19:05:14 UTC
Table: 'MYSTERY KO(722778838)#0084' 6-max (real money) Seat #1 is the button
Seat 1: JohnKoff (20270)
Seat 2: pechaur27000 (38249)
Seat 3: P1xel7 (20000)
Seat 4: khamssssa (17700)
Seat 5: abran10 (27836)
Seat 6: hikarisan (20000)
*** ANTE/BLINDS ***
pechaur27000 posts ante 25
P1xel7 posts ante 25
JohnKoff posts ante 25
khamssssa posts ante 25
abran10 posts ante 25
hikarisan posts ante 25
pechaur27000 posts small blind 100
P1xel7 posts big blind 200
Dealt to P1xel7 [Ad 5s]
*** PRE-FLOP *** 
khamssssa folds
abran10 raises 300 to 500
hikarisan folds
JohnKoff folds
pechaur27000 calls 400
P1xel7 calls 300
*** FLOP *** [7s 8h 5h]
pechaur27000 bets 37724 and is all-in
P1xel7 folds
abran10 folds
pechaur27000 collected 39374 from pot
*** SUMMARY ***
Total pot 39374 | No rake
Board: [7s 8h 5h]
Seat 2: pechaur27000 (small blind) won 39374


Winamax Poker - Tournament "MYSTERY KO" buyIn: 1.80€ + 0.20€ level: 1 - HandId: #3104311471450882133-34-1703099173 - Holdem no limit (25/100/200) - 2023/12/20 19:06:13 UTC
Table: 'MYSTERY KO(722778838)#0084' 6-max (real money) Seat #2 is the button
Seat 1: JohnKoff (20245)
Seat 2: pechaur27000 (39374)
Seat 3: P1xel7 (19475)
Seat 4: khamssssa (17675)
Seat 5: abran10 (27311)
Seat 6: hikarisan (19975)
*** ANTE/BLINDS ***
P1xel7 posts ante 25
khamssssa posts ante 25
JohnKoff posts ante 25
pechaur27000 posts ante 25
abran10 posts ante 25
hikarisan posts ante 25
P1xel7 posts small blind 100
khamssssa posts big blind 200
Dealt to P1xel7 [Kh 7c]
*** PRE-FLOP *** 
abran10 folds
hikarisan folds
JohnKoff folds
pechaur27000 folds
P1xel7 folds
khamssssa collected 450 from pot
*** SUMMARY ***
Total pot 450 | No rake
Seat 4: khamssssa (big blind) won 450


Winamax Poker - Tournament "MYSTERY KO" buyIn: 1.80€ + 0.20€ level: 1 - HandId: #3104311471450882133-35-1703099207 - Holdem no limit (25/100/200) - 2023/12/20 19:06:47 UTC
Table: 'MYSTERY KO(722778838)#0084' 6-max (real money) Seat #3 is the button
Seat 1: JohnKoff (20220)
Seat 2: pechaur27000 (39349)
Seat 3: P1xel7 (19350)
Seat 4: khamssssa (17900)
Seat 5: abran10 (27286)
Seat 6: hikarisan (19950)
*** ANTE/BLINDS ***
khamssssa posts ante 25
abran10 posts ante 25
JohnKoff posts ante 25
pechaur27000 posts ante 25
P1xel7 posts ante 25
hikarisan posts ante 25
khamssssa posts small blind 100
abran10 posts big blind 200
Dealt to P1xel7 [Ah Th]
*** PRE-FLOP *** 
hikarisan folds
JohnKoff raises 218 to 418
pechaur27000 calls 418
P1xel7 calls 418
khamssssa folds
abran10 folds
*** FLOP *** [2s Qd 7c]
JohnKoff bets 596
pechaur27000 folds
P1xel7 calls 596
*** TURN *** [2s Qd 7c][Kc]
JohnKoff bets 1882
P1xel7 folds
JohnKoff collected 4778 from pot
*** SUMMARY ***
Total pot 4778 | No rake
Board: [2s Qd 7c Kc]
Seat 1: JohnKoff won 4778


Winamax Poker - Tournament "MYSTERY KO" buyIn: 1.80€ + 0.20€ level: 1 - HandId: #3104311471450882133-36-1703099292 - Holdem no limit (25/100/200) - 2023/12/20 19:08:12 UTC
Table: 'MYSTERY KO(722778838)#0084' 6-max (real money) Seat #4 is the button
Seat 1: JohnKoff (22077)
Seat 2: pechaur27000 (38906)
Seat 3: P1xel7 (18311)
Seat 4: khamssssa (17775)
Seat 5: abran10 (27061)
Seat 6: hikarisan (19925)
*** ANTE/BLINDS ***
abran10 posts ante 25
hikarisan posts ante 25
JohnKoff posts ante 25
pechaur27000 posts ante 25
P1xel7 posts ante 25
khamssssa posts ante 25
abran10 posts small blind 100
hikarisan posts big blind 200
Dealt to P1xel7 [As 9h]
*** PRE-FLOP *** 
JohnKoff folds
pechaur27000 folds
P1xel7 raises 400 to 600
khamssssa folds
abran10 calls 500
hikarisan calls 400
*** FLOP *** [Ts 2h 3s]
abran10 bets 1268
hikarisan folds
P1xel7 folds
abran10 collected 3218 from pot
*** SUMMARY ***
Total pot 3218 | No rake
Board: [Ts 2h 3s]
Seat 5: abran10 (small blind) won 3218


Winamax Poker - Tournament "MYSTERY KO" buyIn: 1.80€ + 0.20€ level: 1 - HandId: #3104311471450882133-37-1703099336 - Holdem no limit (25/100/200) - 2023/12/20 19:08:56 UTC
Table: 'MYSTERY KO(722778838)#0084' 6-max (real money) Seat #5 is the button
Seat 1: JohnKoff (22052)
Seat 2: pechaur27000 (38881)
Seat 3: P1xel7 (17686)
Seat 4: khamssssa (17750)
Seat 5: abran10 (28386)
Seat 6: hikarisan (19300)
*** ANTE/BLINDS ***
hikarisan posts ante 25
JohnKoff posts ante 25
pechaur27000 posts ante 25
P1xel7 posts ante 25
khamssssa posts ante 25
abran10 posts ante 25
hikarisan posts small blind 100
JohnKoff posts big blind 200
Dealt to P1xel7 [Ac 7s]
*** PRE-FLOP *** 
pechaur27000 folds
P1xel7 folds
khamssssa folds
abran10 folds
hikarisan folds
JohnKoff collected 450 from pot
*** SUMMARY ***
Total pot 450 | No rake
Seat 1: JohnKoff (big blind) won 450


Winamax Poker - Tournament "MYSTERY KO" buyIn: 1.80€ + 0.20€ level: 1 - HandId: #3104311471450882133-38-1703099360 - Holdem no limit (25/100/200) - 2023/12/20 19:09:20 UTC
Table: 'MYSTERY KO(722778838)#0084' 6-max (real money) Seat #6 is the button
Seat 1: JohnKoff (22277)
Seat 2: pechaur27000 (38856)
Seat 3: P1xel7 (17661)
Seat 4: khamssssa (17725)
Seat 5: abran10 (28361)
Seat 6: hikarisan (19175)
*** ANTE/BLINDS ***
JohnKoff posts ante 25
pechaur27000 posts ante 25
P1xel7 posts ante 25
khamssssa posts ante 25
abran10 posts ante 25
hikarisan posts ante 25
JohnKoff posts small blind 100
pechaur27000 posts big blind 200
Dealt to P1xel7 [Qd Jd]
*** PRE-FLOP *** 
P1xel7 raises 300 to 500
khamssssa folds
abran10 folds
hikarisan folds
JohnKoff folds
pechaur27000 calls 300
*** FLOP *** [9d 3c 2c]
pechaur27000 checks
P1xel7 bets 438
pechaur27000 folds
P1xel7 collected 1688 from pot
*** SUMMARY ***
Total pot 1688 | No rake
Board: [9d 3c 2c]
Seat 3: P1xel7 won 1688


Winamax Poker - Tournament "MYSTERY KO" buyIn: 1.80€ + 0.20€ level: 1 - HandId: #3104311471450882133-39-1703099419 - Holdem no limit (25/100/200) - 2023/12/20 19:10:19 UTC
Table: 'MYSTERY KO(722778838)#0084' 6-max (real money) Seat #1 is the button
Seat 1: JohnKoff (22152)
Seat 2: pechaur27000 (38331)
Seat 3: P1xel7 (18386)
Seat 4: khamssssa (17700)
Seat 5: abran10 (28336)
Seat 6: hikarisan (19150)
*** ANTE/BLINDS ***
pechaur27000 posts ante 25
P1xel7 posts ante 25
JohnKoff posts ante 25
khamssssa posts ante 25
abran10 posts ante 25
hikarisan posts ante 25
pechaur27000 posts small blind 100
P1xel7 posts big blind 200
Dealt to P1xel7 [Th 8s]
*** PRE-FLOP *** 
khamssssa folds
abran10 folds
hikarisan folds
JohnKoff raises 218 to 418
pechaur27000 calls 318
P1xel7 calls 218
*** FLOP *** [Kc 8c 5s]
pechaur27000 bets 37888 and is all-in
P1xel7 folds
JohnKoff folds
pechaur27000 collected 39292 from pot
*** SUMMARY ***
Total pot 39292 | No rake
Board: [Kc 8c 5s]
Seat 2: pechaur27000 (small blind) won 39292


Winamax Poker - Tournament "MYSTERY KO" buyIn: 1.80€ + 0.20€ level: 2 - HandId: #3104311471450882133-40-1703099501 - Holdem no limit (30/125/250) - 2023/12/20 19:11:41 UTC
Table: 'MYSTERY KO(722778838)#0084' 6-max (real money) Seat #2 is the button
Seat 1: JohnKoff (21709)
Seat 2: pechaur27000 (39292)
Seat 3: P1xel7 (17943)
Seat 4: khamssssa (17675)
Seat 5: abran10 (28311)
Seat 6: hikarisan (19125)
*** ANTE/BLINDS ***
P1xel7 posts ante 30
khamssssa posts ante 30
JohnKoff posts ante 30
pechaur27000 posts ante 30
abran10 posts ante 30
hikarisan posts ante 30
P1xel7 posts small blind 125
khamssssa posts big blind 250
Dealt to P1xel7 [5c 6s]
*** PRE-FLOP *** 
abran10 folds
hikarisan folds
JohnKoff folds
pechaur27000 folds
P1xel7 raises 250 to 500
khamssssa folds
P1xel7 collected 930 from pot
*** SUMMARY ***
Total pot 930 | No rake
Seat 3: P1xel7 (small blind) won 930


Winamax Poker - Tournament "MYSTERY KO" buyIn: 1.80€ + 0.20€ level: 2 - HandId: #3104311471450882133-41-1703099518 - Holdem no limit (30/125/250) - 2023/12/20 19:11:58 UTC
Table: 'MYSTERY KO(722778838)#0084' 6-max (real money) Seat #3 is the button
Seat 1: JohnKoff (21679)
Seat 2: pechaur27000 (39262)
Seat 3: P1xel7 (18343)
Seat 4: khamssssa (17395)
Seat 5: abran10 (28281)
Seat 6: hikarisan (19095)
*** ANTE/BLINDS ***
khamssssa posts ante 30
abran10 posts ante 30
JohnKoff posts ante 30
pechaur27000 posts ante 30
P1xel7 posts ante 30
hikarisan posts ante 30
khamssssa posts small blind 125
abran10 posts big blind 250
Dealt to P1xel7 [Qd Ks]
*** PRE-FLOP *** 
hikarisan raises 375 to 625
JohnKoff calls 625
pechaur27000 folds
P1xel7 calls 625
khamssssa folds
abran10 folds
*** FLOP *** [4s 5h 3s]
hikarisan checks
JohnKoff checks
P1xel7 checks
*** TURN *** [4s 5h 3s][4c]
hikarisan checks
JohnKoff bets 608
P1xel7 folds
hikarisan calls 608
*** RIVER *** [4s 5h 3s 4c][Ac]
hikarisan checks
JohnKoff bets 1276
hikarisan calls 1276
*** SHOW DOWN ***
hikarisan shows [Th As] (Two pairs : Aces and 4)
JohnKoff shows [Qh Ah] (Two pairs : Aces and 4)
JohnKoff collected 6198 from pot
*** SUMMARY ***
Total pot 6198 | No rake
Board: [4s 5h 3s 4c Ac]
Seat 1: JohnKoff showed [Qh Ah] and won 6198 with Two pairs : Aces and 4
Seat 6: hikarisan showed [Th As] and lost with Two pairs : Aces and 4


Winamax Poker - Tournament "MYSTERY KO" buyIn: 1.80€ + 0.20€ level: 2 - HandId: #3104311471450882133-42-1703099618 - Holdem no limit (30/125/250) - 2023/12/20 19:13:38 UTC
Table: 'MYSTERY KO(722778838)#0084' 6-max (real money) Seat #4 is the button
Seat 1: JohnKoff (25338)
Seat 2: pechaur27000 (39232)
Seat 3: P1xel7 (17688)
Seat 4: khamssssa (17240)
Seat 5: abran10 (28001)
Seat 6: hikarisan (16556)
*** ANTE/BLINDS ***
abran10 posts ante 30
hikarisan posts ante 30
JohnKoff posts ante 30
pechaur27000 posts ante 30
P1xel7 posts ante 30
khamssssa posts ante 30
abran10 posts small blind 125
hikarisan posts big blind 250
Dealt to P1xel7 [8d 9d]
*** PRE-FLOP *** 
JohnKoff folds
pechaur27000 raises 38952 to 39202 and is all-in
P1xel7 folds
khamssssa folds
abran10 folds
hikarisan folds
pechaur27000 collected 39757 from pot
*** SUMMARY ***
Total pot 39757 | No rake
Seat 2: pechaur27000 won 39757


Winamax Poker - Tournament "MYSTERY KO" buyIn: 1.80€ + 0.20€ level: 2 - HandId: #3104311471450882133-43-1703099643 - Holdem no limit (30/125/250) - 2023/12/20 19:14:03 UTC
Table: 'MYSTERY KO(722778838)#0084' 6-max (real money) Seat #5 is the button
Seat 1: JohnKoff (25308)
Seat 2: pechaur27000 (39757)
Seat 3: P1xel7 (17658)
Seat 4: khamssssa (17210)
Seat 5: abran10 (27846)
Seat 6: hikarisan (16276)
*** ANTE/BLINDS ***
hikarisan posts ante 30
JohnKoff posts ante 30
pechaur27000 posts ante 30
P1xel7 posts ante 30
khamssssa posts ante 30
abran10 posts ante 30
hikarisan posts small blind 125
JohnKoff posts big blind 250
Dealt to P1xel7 [6s Qs]
*** PRE-FLOP *** 
pechaur27000 calls 250
P1xel7 folds
khamssssa folds
abran10 folds
hikarisan folds
JohnKoff checks
*** FLOP *** [2c 4s 9s]
JohnKoff checks
pechaur27000 checks
*** TURN *** [2c 4s 9s][Ac]
JohnKoff bets 250
pechaur27000 calls 250
*** RIVER *** [2c 4s 9s Ac][Jd]
JohnKoff bets 979
pechaur27000 folds
JohnKoff collected 2284 from pot
*** SUMMARY ***
Total pot 2284 | No rake
Board: [2c 4s 9s Ac Jd]
Seat 1: JohnKoff (big blind) won 2284


Winamax Poker - Tournament "MYSTERY KO" buyIn: 1.80€ + 0.20€ level: 2 - HandId: #3104311471450882133-44-1703099741 - Holdem no limit (30/125/250) - 2023/12/20 19:15:41 UTC
Table: 'MYSTERY KO(722778838)#0084' 6-max (real money) Seat #6 is the button
Seat 1: JohnKoff (26083)
Seat 2: pechaur27000 (39227)
Seat 3: P1xel7 (17628)
Seat 4: khamssssa (17180)
Seat 5: abran10 (27816)
Seat 6: hikarisan (16121)
*** ANTE/BLINDS ***
JohnKoff posts ante 30
pechaur27000 posts ante 30
P1xel7 posts ante 30
khamssssa posts ante 30
abran10 posts ante 30
hikarisan posts ante 30
JohnKoff posts small blind 125
pechaur27000 posts big blind 250
Dealt to P1xel7 [8d Ac]
*** PRE-FLOP *** 
P1xel7 folds
khamssssa folds
abran10 folds
hikarisan raises 375 to 625
JohnKoff folds
pechaur27000 folds
hikarisan collected 1180 from pot
*** SUMMARY ***
Total pot 1180 | No rake
Seat 6: hikarisan (button) won 1180


Winamax Poker - Tournament "MYSTERY KO" buyIn: 1.80€ + 0.20€ level: 2 - HandId: #3104311471450882133-45-1703099766 - Holdem no limit (30/125/250) - 2023/12/20 19:16:06 UTC
Table: 'MYSTERY KO(722778838)#0084' 6-max (real money) Seat #1 is the button
Seat 1: JohnKoff (25928)
Seat 2: pechaur27000 (38947)
Seat 3: P1xel7 (17598)
Seat 4: khamssssa (17150)
Seat 5: abran10 (27786)
Seat 6: hikarisan (16646)
*** ANTE/BLINDS ***
pechaur27000 posts ante 30
P1xel7 posts ante 30
JohnKoff posts ante 30
khamssssa posts ante 30
abran10 posts ante 30
hikarisan posts ante 30
pechaur27000 posts small blind 125
P1xel7 posts big blind 250
Dealt to P1xel7 [2d 7s]
*** PRE-FLOP *** 
khamssssa folds
abran10 folds
hikarisan folds
JohnKoff folds
pechaur27000 calls 125
P1xel7 checks
*** FLOP *** [Jd Ad Tc]
pechaur27000 bets 38667 and is all-in
P1xel7 folds
pechaur27000 collected 39347 from pot
*** SUMMARY ***
Total pot 39347 | No rake
Board: [Jd Ad Tc]
Seat 2: pechaur27000 (small blind) won 39347


Winamax Poker - Tournament "MYSTERY KO" buyIn: 1.80€ + 0.20€ level: 2 - HandId: #3104311471450882133-46-1703099808 - Holdem no limit (30/125/250) - 2023/12/20 19:16:48 UTC
Table: 'MYSTERY KO(722778838)#0084' 6-max (real money) Seat #2 is the button
Seat 1: JohnKoff (25898)
Seat 2: pechaur27000 (39347)
Seat 3: P1xel7 (17318)
Seat 4: khamssssa (17120)
Seat 5: abran10 (27756)
Seat 6: hikarisan (16616)
*** ANTE/BLINDS ***
P1xel7 posts ante 30
khamssssa posts ante 30
JohnKoff posts ante 30
pechaur27000 posts ante 30
abran10 posts ante 30
hikarisan posts ante 30
P1xel7 posts small blind 125
khamssssa posts big blind 250
Dealt to P1xel7 [Kc 4d]
*** PRE-FLOP *** 
abran10 folds
hikarisan folds
JohnKoff raises 272 to 522
pechaur27000 folds
P1xel7 folds
khamssssa folds
JohnKoff collected 1077 from pot
*** SUMMARY ***
Total pot 1077 | No rake
Seat 1: JohnKoff won 1077


Winamax Poker - Tournament "MYSTERY KO" buyIn: 1.80€ + 0.20€ level: 2 - HandId: #3104311471450882133-47-1703099825 - Holdem no limit (30/125/250) - 2023/12/20 19:17:05 UTC
Table: 'MYSTERY KO(722778838)#0084' 6-max (real money) Seat #3 is the button
Seat 1: JohnKoff (26423)
Seat 2: pechaur27000 (39317)
Seat 3: P1xel7 (17163)
Seat 4: khamssssa (16840)
Seat 5: abran10 (27726)
Seat 6: hikarisan (16586)
*** ANTE/BLINDS ***
khamssssa posts ante 30
abran10 posts ante 30
JohnKoff posts ante 30
pechaur27000 posts ante 30
P1xel7 posts ante 30
hikarisan posts ante 30
khamssssa posts small blind 125
abran10 posts big blind 250
Dealt to P1xel7 [Qs 3h]
*** PRE-FLOP *** 
hikarisan raises 375 to 625
JohnKoff folds
pechaur27000 folds
P1xel7 folds
khamssssa folds
abran10 folds
hikarisan collected 1180 from pot
*** SUMMARY ***
Total pot 1180 | No rake
Seat 6: hikarisan won 1180


Winamax Poker - Tournament "MYSTERY KO" buyIn: 1.80€ + 0.20€ level: 2 - HandId: #3104311471450882133-48-1703099856 - Holdem no limit (30/125/250) - 2023/12/20 19:17:36 UTC
Table: 'MYSTERY KO(722778838)#0084' 6-max (real money) Seat #4 is the button
Seat 1: JohnKoff (26393)
Seat 2: pechaur27000 (39287)
Seat 3: P1xel7 (17133)
Seat 4: khamssssa (16685)
Seat 5: abran10 (27446)
Seat 6: hikarisan (17111)
*** ANTE/BLINDS ***
abran10 posts ante 30
hikarisan posts ante 30
JohnKoff posts ante 30
pechaur27000 posts ante 30
P1xel7 posts ante 30
khamssssa posts ante 30
abran10 posts small blind 125
hikarisan posts big blind 250
Dealt to P1xel7 [Tc Jh]
*** PRE-FLOP *** 
JohnKoff raises 272 to 522
pechaur27000 folds
P1xel7 folds
khamssssa folds
abran10 calls 397
hikarisan folds
*** FLOP *** [8d As 4h]
abran10 checks
JohnKoff bets 516
abran10 folds
JohnKoff collected 1990 from pot
*** SUMMARY ***
Total pot 1990 | No rake
Board: [8d As 4h]
Seat 1: JohnKoff won 1990


Winamax Poker - Tournament "MYSTERY KO" buyIn: 1.80€ + 0.20€ level: 3 - HandId: #3104311471450882133-49-1703099901 - Holdem no limit (35/150/300) - 2023/12/20 19:18:21 UTC
Table: 'MYSTERY KO(722778838)#0084' 6-max (real money) Seat #5 is the button
Seat 1: JohnKoff (27315)
Seat 2: pechaur27000 (39257)
Seat 3: P1xel7 (17103)
Seat 4: khamssssa (16655)
Seat 5: abran10 (26894)
Seat 6: hikarisan (16831)
*** ANTE/BLINDS ***
hikarisan posts ante 35
JohnKoff posts ante 35
pechaur27000 posts ante 35
P1xel7 posts ante 35
khamssssa posts ante 35
abran10 posts ante 35
hikarisan posts small blind 150
JohnKoff posts big blind 300
Dealt to P1xel7 [5c 8d]
*** PRE-FLOP *** 
pechaur27000 calls 300
P1xel7 folds
khamssssa folds
abran10 folds
hikarisan folds
JohnKoff checks
*** FLOP *** [7h Qc 6d]
JohnKoff checks
pechaur27000 checks
*** TURN *** [7h Qc 6d][Kh]
JohnKoff checks
pechaur27000 bets 38922 and is all-in
JohnKoff folds
pechaur27000 collected 39882 from pot
*** SUMMARY ***
Total pot 39882 | No rake
Board: [7h Qc 6d Kh]
Seat 2: pechaur27000 won 39882


Winamax Poker - Tournament "MYSTERY KO" buyIn: 1.80€ + 0.20€ level: 3 - HandId: #3104311471450882133-50-1703099966 - Holdem no limit (35/150/300) - 2023/12/20 19:19:26 UTC
Table: 'MYSTERY KO(722778838)#0084' 6-max (real money) Seat #6 is the button
Seat 1: JohnKoff (26980)
Seat 2: pechaur27000 (39882)
Seat 3: P1xel7 (17068)
Seat 4: khamssssa (16620)
Seat 5: abran10 (26859)
Seat 6: hikarisan (16646)
*** ANTE/BLINDS ***
JohnKoff posts ante 35
pechaur27000 posts ante 35
P1xel7 posts ante 35
khamssssa posts ante 35
abran10 posts ante 35
hikarisan posts ante 35
JohnKoff posts small blind 150
pechaur27000 posts big blind 300
Dealt to P1xel7 [As Js]
*** PRE-FLOP *** 
P1xel7 raises 450 to 750
khamssssa folds
abran10 folds
hikarisan folds
JohnKoff folds
pechaur27000 folds
P1xel7 collected 1410 from pot
*** SUMMARY ***
Total pot 1410 | No rake
Seat 3: P1xel7 won 1410


Winamax Poker - Tournament "MYSTERY KO" buyIn: 1.80€ + 0.20€ level: 3 - HandId: #3104311471450882133-51-1703099995 - Holdem no limit (35/150/300) - 2023/12/20 19:19:55 UTC
Table: 'MYSTERY KO(722778838)#0084' 6-max (real money) Seat #1 is the button
Seat 1: JohnKoff (26795)
Seat 2: pechaur27000 (39547)
Seat 3: P1xel7 (17693)
Seat 4: khamssssa (16585)
Seat 5: abran10 (26824)
Seat 6: hikarisan (16611)
*** ANTE/BLINDS ***
pechaur27000 posts ante 35
P1xel7 posts ante 35
JohnKoff posts ante 35
khamssssa posts ante 35
abran10 posts ante 35
hikarisan posts ante 35
pechaur27000 posts small blind 150
P1xel7 posts big blind 300
Dealt to P1xel7 [2h 8c]
*** PRE-FLOP *** 
khamssssa folds
abran10 raises 450 to 750
hikarisan folds
JohnKoff raises 1500 to 2250
pechaur27000 folds
P1xel7 folds
abran10 calls 1500
*** FLOP *** [2d Ah 5s]
abran10 checks
JohnKoff bets 1806
abran10 folds
JohnKoff collected 6966 from pot
*** SUMMARY ***
Total pot 6966 | No rake
Board: [2d Ah 5s]
Seat 1: JohnKoff (button) won 6966


Winamax Poker - Tournament "MYSTERY KO" buyIn: 1.80€ + 0.20€ level: 3 - HandId: #3104311471450882133-52-1703100033 - Holdem no limit (35/150/300) - 2023/12/20 19:20:33 UTC
Table: 'MYSTERY KO(722778838)#0084' 6-max (real money) Seat #2 is the button
Seat 1: JohnKoff (29670)
Seat 2: pechaur27000 (39362)
Seat 3: P1xel7 (17358)
Seat 4: khamssssa (16550)
Seat 5: abran10 (24539)
Seat 6: hikarisan (16576)
*** ANTE/BLINDS ***
P1xel7 posts ante 35
khamssssa posts ante 35
JohnKoff posts ante 35
pechaur27000 posts ante 35
abran10 posts ante 35
hikarisan posts ante 35
P1xel7 posts small blind 150
khamssssa posts big blind 300
Dealt to P1xel7 [Th Tc]
*** PRE-FLOP *** 
abran10 raises 600 to 900
hikarisan folds
JohnKoff folds
pechaur27000 folds
P1xel7 raises 1350 to 2250
khamssssa folds
abran10 folds
P1xel7 collected 3660 from pot
*** SUMMARY ***
Total pot 3660 | No rake
Seat 3: P1xel7 (small blind) won 3660


Winamax Poker - Tournament "MYSTERY KO" buyIn: 1.80€ + 0.20€ level: 3 - HandId: #3104311471450882133-53-1703100070 - Holdem no limit (35/150/300) - 2023/12/20 19:21:10 UTC
Table: 'MYSTERY KO(722778838)#0084' 6-max (real money) Seat #3 is the button
Seat 1: JohnKoff (29635)
Seat 2: pechaur27000 (39327)
Seat 3: P1xel7 (18733)
Seat 4: khamssssa (16215)
Seat 5: abran10 (23604)
Seat 6: hikarisan (16541)
*** ANTE/BLINDS ***
khamssssa posts ante 35
abran10 posts ante 35
JohnKoff posts ante 35
pechaur27000 posts ante 35
P1xel7 posts ante 35
hikarisan posts ante 35
khamssssa posts small blind 150
abran10 posts big blind 300
Dealt to P1xel7 [3c 4s]
*** PRE-FLOP *** 
hikarisan folds
JohnKoff folds
pechaur27000 folds
P1xel7 folds
khamssssa folds
abran10 collected 660 from pot
*** SUMMARY ***
Total pot 660 | No rake
Seat 5: abran10 (big blind) won 660


Winamax Poker - Tournament "MYSTERY KO" buyIn: 1.80€ + 0.20€ level: 3 - HandId: #3104311471450882133-54-1703100084 - Holdem no limit (35/150/300) - 2023/12/20 19:21:24 UTC
Table: 'MYSTERY KO(722778838)#0084' 6-max (real money) Seat #4 is the button
Seat 1: JohnKoff (29600)
Seat 2: pechaur27000 (39292)
Seat 3: P1xel7 (18698)
Seat 4: khamssssa (16030)
Seat 5: abran10 (23929)
Seat 6: hikarisan (16506)
*** ANTE/BLINDS ***
abran10 posts ante 35
hikarisan posts ante 35
JohnKoff posts ante 35
pechaur27000 posts ante 35
P1xel7 posts ante 35
khamssssa posts ante 35
abran10 posts small blind 150
hikarisan posts big blind 300
Dealt to P1xel7 [5c Jh]
*** PRE-FLOP *** 
JohnKoff raises 477 to 777
pechaur27000 folds
P1xel7 folds
khamssssa folds
abran10 folds
hikarisan folds
JohnKoff collected 1437 from pot
*** SUMMARY ***
Total pot 1437 | No rake
Seat 1: JohnKoff won 1437


Winamax Poker - Tournament "MYSTERY KO" buyIn: 1.80€ + 0.20€ level: 3 - HandId: #3104311471450882133-55-1703100117 - Holdem no limit (35/150/300) - 2023/12/20 19:21:57 UTC
Table: 'MYSTERY KO(722778838)#0084' 6-max (real money) Seat #5 is the button
Seat 1: JohnKoff (30225)
Seat 2: pechaur27000 (39257)
Seat 3: P1xel7 (18663)
Seat 4: khamssssa (15995)
Seat 5: abran10 (23744)
Seat 6: hikarisan (16171)
*** ANTE/BLINDS ***
hikarisan posts ante 35
JohnKoff posts ante 35
pechaur27000 posts ante 35
P1xel7 posts ante 35
khamssssa posts ante 35
abran10 posts ante 35
hikarisan posts small blind 150
JohnKoff posts big blind 300
Dealt to P1xel7 [5h Ts]
*** PRE-FLOP *** 
pechaur27000 folds
P1xel7 folds
khamssssa folds
abran10 folds
hikarisan folds
JohnKoff collected 660 from pot
*** SUMMARY ***
Total pot 660 | No rake
Seat 1: JohnKoff (big blind) won 660


Winamax Poker - Tournament "MYSTERY KO" buyIn: 1.80€ + 0.20€ level: 3 - HandId: #3104311471450882133-56-1703100139 - Holdem no limit (35/150/300) - 2023/12/20 19:22:19 UTC
Table: 'MYSTERY KO(722778838)#0084' 6-max (real money) Seat #6 is the button
Seat 1: JohnKoff (30550)
Seat 2: pechaur27000 (39222)
Seat 3: P1xel7 (18628)
Seat 4: khamssssa (15960)
Seat 5: abran10 (23709)
Seat 6: hikarisan (15986)
*** ANTE/BLINDS ***
JohnKoff posts ante 35
pechaur27000 posts ante 35
P1xel7 posts ante 35
khamssssa posts ante 35
abran10 posts ante 35
hikarisan posts ante 35
JohnKoff posts small blind 150
pechaur27000 posts big blind 300
Dealt to P1xel7 [2c 6c]
*** PRE-FLOP *** 
P1xel7 folds
khamssssa folds
abran10 raises 600 to 900
hikarisan folds
JohnKoff calls 750
pechaur27000 folds
*** FLOP *** [9h 2h Ah]
JohnKoff checks
abran10 bets 1502
JohnKoff folds
abran10 collected 3812 from pot
*** SUMMARY ***
Total pot 3812 | No rake
Board: [9h 2h Ah]
Seat 5: abran10 won 3812


Winamax Poker - Tournament "MYSTERY KO" buyIn: 1.80€ + 0.20€ level: 3 - HandId: #3104311471450882133-57-1703100171 - Holdem no limit (35/150/300) - 2023/12/20 19:22:51 UTC
Table: 'MYSTERY KO(722778838)#0084' 6-max (real money) Seat #1 is the button
Seat 1: JohnKoff (29615)
Seat 2: pechaur27000 (38887)
Seat 3: P1xel7 (18593)
Seat 4: khamssssa (15925)
Seat 5: abran10 (25084)
Seat 6: hikarisan (15951)
*** ANTE/BLINDS ***
pechaur27000 posts ante 35
P1xel7 posts ante 35
JohnKoff posts ante 35
khamssssa posts ante 35
abran10 posts ante 35
hikarisan posts ante 35
pechaur27000 posts small blind 150
P1xel7 posts big blind 300
Dealt to P1xel7 [Td 5c]
*** PRE-FLOP *** 
khamssssa folds
abran10 raises 600 to 900
hikarisan folds
JohnKoff folds
pechaur27000 folds
P1xel7 folds
abran10 collected 1560 from pot
*** SUMMARY ***
Total pot 1560 | No rake
Seat 5: abran10 won 1560


Winamax Poker - Tournament "MYSTERY KO" buyIn: 1.80€ + 0.20€ level: 3 - HandId: #3104311471450882133-58-1703100189 - Holdem no limit (35/150/300) - 2023/12/20 19:23:09 UTC
Table: 'MYSTERY KO(722778838)#0084' 6-max (real money) Seat #2 is the button
Seat 1: JohnKoff (29580)
Seat 2: pechaur27000 (38702)
Seat 3: P1xel7 (18258)
Seat 4: khamssssa (15890)
Seat 5: abran10 (25709)
Seat 6: hikarisan (15916)
*** ANTE/BLINDS ***
P1xel7 posts ante 35
khamssssa posts ante 35
JohnKoff posts ante 35
pechaur27000 posts ante 35
abran10 posts ante 35
hikarisan posts ante 35
P1xel7 posts small blind 150
khamssssa posts big blind 300
Dealt to P1xel7 [4c 3c]
*** PRE-FLOP *** 
abran10 folds
hikarisan folds
JohnKoff folds
pechaur27000 folds
P1xel7 raises 300 to 600
khamssssa folds
P1xel7 collected 1110 from pot
*** SUMMARY ***
Total pot 1110 | No rake
Seat 3: P1xel7 (small blind) won 1110


Winamax Poker - Tournament "MYSTERY KO" buyIn: 1.80€ + 0.20€ level: 3 - HandId: #3104311471450882133-59-1703100220 - Holdem no limit (35/150/300) - 2023/12/20 19:23:40 UTC
Table: 'MYSTERY KO(722778838)#0084' 6-max (real money) Seat #3 is the button
Seat 1: JohnKoff (29545)
Seat 2: pechaur27000 (38667)
Seat 3: P1xel7 (18733)
Seat 4: khamssssa (15555)
Seat 5: abran10 (25674)
Seat 6: hikarisan (15881)
*** ANTE/BLINDS ***
khamssssa posts ante 35
abran10 posts ante 35
JohnKoff posts ante 35
pechaur27000 posts ante 35
P1xel7 posts ante 35
hikarisan posts ante 35
khamssssa posts small blind 150
abran10 posts big blind 300
Dealt to P1xel7 [Js 2c]
*** PRE-FLOP *** 
hikarisan folds
JohnKoff raises 327 to 627
pechaur27000 folds
P1xel7 folds
khamssssa folds
abran10 calls 327
*** FLOP *** [Kd 3d Jc]
abran10 checks
JohnKoff bets 565
abran10 folds
JohnKoff collected 2179 from pot
*** SUMMARY ***
Total pot 2179 | No rake
Board: [Kd 3d Jc]
Seat 1: JohnKoff won 2179


Winamax Poker - Tournament "MYSTERY KO" buyIn: 1.80€ + 0.20€ level: 3 - HandId: #3104311471450882133-60-1703100272 - Holdem no limit (35/150/300) - 2023/12/20 19:24:32 UTC
Table: 'MYSTERY KO(722778838)#0084' 6-max (real money) Seat #4 is the button
Seat 1: JohnKoff (30497)
Seat 2: pechaur27000 (38632)
Seat 3: P1xel7 (18698)
Seat 4: khamssssa (15370)
Seat 5: abran10 (25012)
Seat 6: hikarisan (15846)
*** ANTE/BLINDS ***
abran10 posts ante 35
hikarisan posts ante 35
JohnKoff posts ante 35
pechaur27000 posts ante 35
P1xel7 posts ante 35
khamssssa posts ante 35
abran10 posts small blind 150
hikarisan posts big blind 300
Dealt to P1xel7 [Kd Ah]
*** PRE-FLOP *** 
JohnKoff raises 327 to 627
pechaur27000 folds
P1xel7 raises 941 to 1568
khamssssa folds
abran10 folds
hikarisan folds
JohnKoff calls 941
*** FLOP *** [7d 9d 3d]
JohnKoff checks
P1xel7 checks
*** TURN *** [7d 9d 3d][Jh]
JohnKoff bets 1329
P1xel7 folds
JohnKoff collected 5125 from pot
*** SUMMARY ***
Total pot 5125 | No rake
Board: [7d 9d 3d Jh]
Seat 1: JohnKoff won 5125


Winamax Poker - Tournament "MYSTERY KO" buyIn: 1.80€ + 0.20€ level: 4 - HandId: #3104311471450882133-61-1703100313 - Holdem no limit (40/175/350) - 2023/12/20 19:25:13 UTC
Table: 'MYSTERY KO(722778838)#0084' 6-max (real money) Seat #5 is the button
Seat 1: JohnKoff (32690)
Seat 2: pechaur27000 (38597)
Seat 3: P1xel7 (17095)
Seat 4: khamssssa (15335)
Seat 5: abran10 (24827)
Seat 6: hikarisan (15511)
*** ANTE/BLINDS ***
hikarisan posts ante 40
JohnKoff posts ante 40
pechaur27000 posts ante 40
P1xel7 posts ante 40
khamssssa posts ante 40
abran10 posts ante 40
hikarisan posts small blind 175
JohnKoff posts big blind 350
Dealt to P1xel7 [9s 9h]
*** PRE-FLOP *** 
pechaur27000 folds
P1xel7 raises 525 to 875
khamssssa folds
abran10 folds
hikarisan folds
JohnKoff calls 525
*** FLOP *** [Kd 6h Qc]
JohnKoff checks
P1xel7 checks
*** TURN *** [Kd 6h Qc][3s]
JohnKoff checks
P1xel7 bets 758
JohnKoff folds
P1xel7 collected 2923 from pot
*** SUMMARY ***
Total pot 2923 | No rake
Board: [Kd 6h Qc 3s]
Seat 3: P1xel7 won 2923


Winamax Poker - Tournament "MYSTERY KO" buyIn: 1.80€ + 0.20€ level: 4 - HandId: #3104311471450882133-62-1703100350 - Holdem no limit (40/175/350) - 2023/12/20 19:25:50 UTC
Table: 'MYSTERY KO(722778838)#0084' 6-max (real money) Seat #6 is the button
Seat 1: JohnKoff (31775)
Seat 2: pechaur27000 (38557)
Seat 3: P1xel7 (18345)
Seat 4: khamssssa (15295)
Seat 5: abran10 (24787)
Seat 6: hikarisan (15296)
*** ANTE/BLINDS ***
JohnKoff posts ante 40
pechaur27000 posts ante 40
P1xel7 posts ante 40
khamssssa posts ante 40
abran10 posts ante 40
hikarisan posts ante 40
JohnKoff posts small blind 175
pechaur27000 posts big blind 350
Dealt to P1xel7 [8s 5s]
*** PRE-FLOP *** 
P1xel7 folds
khamssssa folds
abran10 raises 525 to 875
hikarisan raises 1750 to 2625
JohnKoff folds
pechaur27000 folds
abran10 calls 1750
*** FLOP *** [2h 3s 8h]
abran10 checks
hikarisan bets 3008
abran10 folds
hikarisan collected 9023 from pot
*** SUMMARY ***
Total pot 9023 | No rake
Board: [2h 3s 8h]
Seat 6: hikarisan (button) won 9023


Winamax Poker - Tournament "MYSTERY KO" buyIn: 1.80€ + 0.20€ level: 4 - HandId: #3104311471450882133-63-1703100383 - Holdem no limit (40/175/350) - 2023/12/20 19:26:23 UTC
Table: 'MYSTERY KO(722778838)#0084' 6-max (real money) Seat #1 is the button
Seat 1: JohnKoff (31560)
Seat 2: pechaur27000 (38167)
Seat 3: P1xel7 (18305)
Seat 4: khamssssa (15255)
Seat 5: abran10 (22122)
Seat 6: hikarisan (18646)
*** ANTE/BLINDS ***
pechaur27000 posts ante 40
P1xel7 posts ante 40
JohnKoff posts ante 40
khamssssa posts ante 40
abran10 posts ante 40
hikarisan posts ante 40
pechaur27000 posts small blind 175
P1xel7 posts big blind 350
Dealt to P1xel7 [8s Ac]
*** PRE-FLOP *** 
khamssssa folds
abran10 folds
hikarisan folds
JohnKoff raises 381 to 731
pechaur27000 folds
P1xel7 calls 381
*** FLOP *** [Td 2h Tc]
P1xel7 checks
JohnKoff bets 657
P1xel7 folds
JohnKoff collected 2534 from pot
*** SUMMARY ***
Total pot 2534 | No rake
Board: [Td 2h Tc]
Seat 1: JohnKoff (button) won 2534


Winamax Poker - Tournament "MYSTERY KO" buyIn: 1.80€ + 0.20€ level: 4 - HandId: #3104311471450882133-64-1703100417 - Holdem no limit (40/175/350) - 2023/12/20 19:26:57 UTC
Table: 'MYSTERY KO(722778838)#0084' 6-max (real money) Seat #2 is the button
Seat 1: JohnKoff (32666)
Seat 2: pechaur27000 (37952)
Seat 3: P1xel7 (17534)
Seat 4: khamssssa (15215)
Seat 5: abran10 (22082)
Seat 6: hikarisan (18606)
*** ANTE/BLINDS ***
P1xel7 posts ante 40
khamssssa posts ante 40
JohnKoff posts ante 40
pechaur27000 posts ante 40
abran10 posts ante 40
hikarisan posts ante 40
P1xel7 posts small blind 175
khamssssa posts big blind 350
Dealt to P1xel7 [Kh 4d]
*** PRE-FLOP *** 
abran10 raises 700 to 1050
hikarisan folds
JohnKoff folds
pechaur27000 folds
P1xel7 folds
khamssssa folds
abran10 collected 1815 from pot
*** SUMMARY ***
Total pot 1815 | No rake
Seat 5: abran10 won 1815


Winamax Poker - Tournament "MYSTERY KO" buyIn: 1.80€ + 0.20€ level: 4 - HandId: #3104311471450882133-65-1703100433 - Holdem no limit (40/175/350) - 2023/12/20 19:27:13 UTC
Table: 'MYSTERY KO(722778838)#0084' 6-max (real money) Seat #3 is the button
Seat 1: JohnKoff (32626)
Seat 2: pechaur27000 (37912)
Seat 3: P1xel7 (17319)
Seat 4: khamssssa (14825)
Seat 5: abran10 (22807)
Seat 6: hikarisan (18566)
*** ANTE/BLINDS ***
khamssssa posts ante 40
abran10 posts ante 40
JohnKoff posts ante 40
pechaur27000 posts ante 40
P1xel7 posts ante 40
hikarisan posts ante 40
khamssssa posts small blind 175
abran10 posts big blind 350
Dealt to P1xel7 [3h 8s]
*** PRE-FLOP *** 
hikarisan folds
JohnKoff raises 381 to 731
pechaur27000 folds
P1xel7 folds
khamssssa folds
abran10 calls 381
*** FLOP *** [5s 8h 4c]
abran10 checks
JohnKoff checks
*** TURN *** [5s 8h 4c][9d]
abran10 bets 350
JohnKoff calls 350
*** RIVER *** [5s 8h 4c 9d][9c]
abran10 bets 902
JohnKoff folds
abran10 collected 3479 from pot
*** SUMMARY ***
Total pot 3479 | No rake
Board: [5s 8h 4c 9d 9c]
Seat 5: abran10 (big blind) won 3479


Winamax Poker - Tournament "MYSTERY KO" buyIn: 1.80€ + 0.20€ level: 4 - HandId: #3104311471450882133-66-1703100486 - Holdem no limit (40/175/350) - 2023/12/20 19:28:06 UTC
Table: 'MYSTERY KO(722778838)#0084' 6-max (real money) Seat #4 is the button
Seat 1: JohnKoff (31505)
Seat 2: pechaur27000 (37872)
Seat 3: P1xel7 (17279)
Seat 4: khamssssa (14610)
Seat 5: abran10 (24263)
Seat 6: hikarisan (18526)
*** ANTE/BLINDS ***
abran10 posts ante 40
hikarisan posts ante 40
JohnKoff posts ante 40
pechaur27000 posts ante 40
P1xel7 posts ante 40
khamssssa posts ante 40
abran10 posts small blind 175
hikarisan posts big blind 350
Dealt to P1xel7 [Jd Tc]
*** PRE-FLOP *** 
JohnKoff raises 381 to 731
pechaur27000 calls 731
P1xel7 folds
khamssssa folds
abran10 folds
hikarisan folds
*** FLOP *** [4h 9h 9s]
JohnKoff checks
pechaur27000 checks
*** TURN *** [4h 9h 9s][Jc]
JohnKoff bets 779
pechaur27000 folds
JohnKoff collected 3006 from pot
*** SUMMARY ***
Total pot 3006 | No rake
Board: [4h 9h 9s Jc]
Seat 1: JohnKoff won 3006


Winamax Poker - Tournament "MYSTERY KO" buyIn: 1.80€ + 0.20€ level: 4 - HandId: #3104311471450882133-67-1703100562 - Holdem no limit (40/175/350) - 2023/12/20 19:29:22 UTC
Table: 'MYSTERY KO(722778838)#0084' 6-max (real money) Seat #5 is the button
Seat 1: JohnKoff (32961)
Seat 2: pechaur27000 (37101)
Seat 3: P1xel7 (17239)
Seat 4: khamssssa (14570)
Seat 5: abran10 (24048)
Seat 6: hikarisan (18136)
*** ANTE/BLINDS ***
hikarisan posts ante 40
JohnKoff posts ante 40
pechaur27000 posts ante 40
P1xel7 posts ante 40
khamssssa posts ante 40
abran10 posts ante 40
hikarisan posts small blind 175
JohnKoff posts big blind 350
Dealt to P1xel7 [2s Js]
*** PRE-FLOP *** 
pechaur27000 folds
P1xel7 folds
khamssssa folds
abran10 folds
hikarisan folds
JohnKoff collected 765 from pot
*** SUMMARY ***
Total pot 765 | No rake
Seat 1: JohnKoff (big blind) won 765


Winamax Poker - Tournament "MYSTERY KO" buyIn: 1.80€ + 0.20€ level: 4 - HandId: #3104311471450882133-68-1703100574 - Holdem no limit (40/175/350) - 2023/12/20 19:29:34 UTC
Table: 'MYSTERY KO(722778838)#0084' 6-max (real money) Seat #6 is the button
Seat 1: JohnKoff (33336)
Seat 2: pechaur27000 (37061)
Seat 3: P1xel7 (17199)
Seat 4: khamssssa (14530)
Seat 5: abran10 (24008)
Seat 6: hikarisan (17921)
*** ANTE/BLINDS ***
JohnKoff posts ante 40
pechaur27000 posts ante 40
P1xel7 posts ante 40
khamssssa posts ante 40
abran10 posts ante 40
hikarisan posts ante 40
JohnKoff posts small blind 175
pechaur27000 posts big blind 350
Dealt to P1xel7 [As Ad]
*** PRE-FLOP *** 
P1xel7 raises 525 to 875
khamssssa folds
abran10 folds
hikarisan folds
JohnKoff raises 1575 to 2450
pechaur27000 folds
P1xel7 calls 1575
*** FLOP *** [8c 5h 3d]
JohnKoff bets 1922
P1xel7 calls 1922
*** TURN *** [8c 5h 3d][Kd]
JohnKoff bets 3267
P1xel7 raises 3267 to 6534
JohnKoff folds
P1xel7 collected 19135 from pot
*** SUMMARY ***
Total pot 19135 | No rake
Board: [8c 5h 3d Kd]
Seat 3: P1xel7 won 19135


Winamax Poker - Tournament "MYSTERY KO" buyIn: 1.80€ + 0.20€ level: 4 - HandId: #3104311471450882133-69-1703100683 - Holdem no limit (40/175/350) - 2023/12/20 19:31:23 UTC
Table: 'MYSTERY KO(722778838)#0084' 6-max (real money) Seat #1 is the button
Seat 1: JohnKoff (25657)
Seat 2: pechaur27000 (36671)
Seat 3: P1xel7 (25388)
Seat 4: khamssssa (14490)
Seat 5: abran10 (23968)
Seat 6: hikarisan (17881)
*** ANTE/BLINDS ***
pechaur27000 posts ante 40
P1xel7 posts ante 40
JohnKoff posts ante 40
khamssssa posts ante 40
abran10 posts ante 40
hikarisan posts ante 40
pechaur27000 posts small blind 175
P1xel7 posts big blind 350
Dealt to P1xel7 [6c Ts]
*** PRE-FLOP *** 
khamssssa folds
abran10 raises 700 to 1050
hikarisan folds
JohnKoff folds
pechaur27000 folds
P1xel7 folds
abran10 collected 1815 from pot
*** SUMMARY ***
Total pot 1815 | No rake
Seat 5: abran10 won 1815


Winamax Poker - Tournament "MYSTERY KO" buyIn: 1.80€ + 0.20€ level: 4 - HandId: #3104311471450882133-70-1703100702 - Holdem no limit (40/175/350) - 2023/12/20 19:31:42 UTC
Table: 'MYSTERY KO(722778838)#0084' 6-max (real money) Seat #2 is the button
Seat 1: JohnKoff (25617)
Seat 2: pechaur27000 (36456)
Seat 3: P1xel7 (24998)
Seat 4: khamssssa (14450)
Seat 5: abran10 (24693)
Seat 6: hikarisan (17841)
*** ANTE/BLINDS ***
P1xel7 posts ante 40
khamssssa posts ante 40
JohnKoff posts ante 40
pechaur27000 posts ante 40
abran10 posts ante 40
hikarisan posts ante 40
P1xel7 posts small blind 175
khamssssa posts big blind 350
Dealt to P1xel7 [7h 3c]
*** PRE-FLOP *** 
abran10 raises 1115 to 1465
hikarisan folds
JohnKoff folds
pechaur27000 folds
P1xel7 folds
khamssssa folds
abran10 collected 2230 from pot
*** SUMMARY ***
Total pot 2230 | No rake
Seat 5: abran10 won 2230


Winamax Poker - Tournament "MYSTERY KO" buyIn: 1.80€ + 0.20€ level: 5 - HandId: #3104311471450882133-71-1703100721 - Holdem no limit (50/200/400) - 2023/12/20 19:32:01 UTC
Table: 'MYSTERY KO(722778838)#0084' 6-max (real money) Seat #3 is the button
Seat 1: JohnKoff (25577)
Seat 2: pechaur27000 (36416)
Seat 3: P1xel7 (24783)
Seat 4: khamssssa (14060)
Seat 5: abran10 (25418)
Seat 6: hikarisan (17801)
*** ANTE/BLINDS ***
khamssssa posts ante 50
abran10 posts ante 50
JohnKoff posts ante 50
pechaur27000 posts ante 50
P1xel7 posts ante 50
hikarisan posts ante 50
khamssssa posts small blind 200
abran10 posts big blind 400
Dealt to P1xel7 [3h 8h]
*** PRE-FLOP *** 
hikarisan folds
JohnKoff folds
pechaur27000 folds
P1xel7 folds
khamssssa folds
abran10 collected 900 from pot
*** SUMMARY ***
Total pot 900 | No rake
Seat 5: abran10 (big blind) won 900


Winamax Poker - Tournament "MYSTERY KO" buyIn: 1.80€ + 0.20€ level: 5 - HandId: #3104311471450882133-72-1703100767 - Holdem no limit (50/200/400) - 2023/12/20 19:32:47 UTC
Table: 'MYSTERY KO(722778838)#0084' 6-max (real money) Seat #4 is the button
Seat 1: JohnKoff (25527)
Seat 2: pechaur27000 (36366)
Seat 3: P1xel7 (24733)
Seat 4: khamssssa (13810)
Seat 5: abran10 (25868)
Seat 6: hikarisan (17751)
*** ANTE/BLINDS ***
abran10 posts ante 50
hikarisan posts ante 50
JohnKoff posts ante 50
pechaur27000 posts ante 50
P1xel7 posts ante 50
khamssssa posts ante 50
abran10 posts small blind 200
hikarisan posts big blind 400
Dealt to P1xel7 [2c As]
*** PRE-FLOP *** 
JohnKoff folds
pechaur27000 folds
P1xel7 folds
khamssssa folds
abran10 folds
hikarisan collected 900 from pot
*** SUMMARY ***
Total pot 900 | No rake
Seat 6: hikarisan (big blind) won 900


Winamax Poker - Tournament "MYSTERY KO" buyIn: 1.80€ + 0.20€ level: 5 - HandId: #3104311471450882133-73-1703100785 - Holdem no limit (50/200/400) - 2023/12/20 19:33:05 UTC
Table: 'MYSTERY KO(722778838)#0084' 6-max (real money) Seat #5 is the button
Seat 1: JohnKoff (25477)
Seat 2: pechaur27000 (36316)
Seat 3: P1xel7 (24683)
Seat 4: khamssssa (13760)
Seat 5: abran10 (25618)
Seat 6: hikarisan (18201)
*** ANTE/BLINDS ***
hikarisan posts ante 50
JohnKoff posts ante 50
pechaur27000 posts ante 50
P1xel7 posts ante 50
khamssssa posts ante 50
abran10 posts ante 50
hikarisan posts small blind 200
JohnKoff posts big blind 400
Dealt to P1xel7 [5d 6s]
*** PRE-FLOP *** 
pechaur27000 folds
P1xel7 folds
khamssssa folds
abran10 raises 600 to 1000
hikarisan folds
JohnKoff calls 600
*** FLOP *** [4d Td 3c]
JohnKoff checks
abran10 bets 875
JohnKoff folds
abran10 collected 3375 from pot
*** SUMMARY ***
Total pot 3375 | No rake
Board: [4d Td 3c]
Seat 5: abran10 (button) won 3375


Winamax Poker - Tournament "MYSTERY KO" buyIn: 1.80€ + 0.20€ level: 5 - HandId: #3104311471450882133-74-1703100822 - Holdem no limit (50/200/400) - 2023/12/20 19:33:42 UTC
Table: 'MYSTERY KO(722778838)#0084' 6-max (real money) Seat #6 is the button
Seat 1: JohnKoff (24427)
Seat 2: pechaur27000 (36266)
Seat 3: P1xel7 (24633)
Seat 4: khamssssa (13710)
Seat 5: abran10 (27068)
Seat 6: hikarisan (17951)
*** ANTE/BLINDS ***
JohnKoff posts ante 50
pechaur27000 posts ante 50
P1xel7 posts ante 50
khamssssa posts ante 50
abran10 posts ante 50
hikarisan posts ante 50
JohnKoff posts small blind 200
pechaur27000 posts big blind 400
Dealt to P1xel7 [6d 7c]
*** PRE-FLOP *** 
P1xel7 folds
khamssssa folds
abran10 folds
hikarisan folds
JohnKoff raises 1000 to 1400
pechaur27000 folds
JohnKoff collected 2100 from pot
*** SUMMARY ***
Total pot 2100 | No rake
Seat 1: JohnKoff (small blind) won 2100


Winamax Poker - Tournament "MYSTERY KO" buyIn: 1.80€ + 0.20€ level: 5 - HandId: #3104311471450882133-75-1703100850 - Holdem no limit (50/200/400) - 2023/12/20 19:34:10 UTC
Table: 'MYSTERY KO(722778838)#0084' 6-max (real money) Seat #1 is the button
Seat 1: JohnKoff (25077)
Seat 2: pechaur27000 (35816)
Seat 3: P1xel7 (24583)
Seat 4: khamssssa (13660)
Seat 5: abran10 (27018)
Seat 6: hikarisan (17901)
*** ANTE/BLINDS ***
pechaur27000 posts ante 50
P1xel7 posts ante 50
JohnKoff posts ante 50
khamssssa posts ante 50
abran10 posts ante 50
hikarisan posts ante 50
pechaur27000 posts small blind 200
P1xel7 posts big blind 400
Dealt to P1xel7 [Th 7h]
*** PRE-FLOP *** 
khamssssa folds
abran10 raises 800 to 1200
hikarisan folds
JohnKoff folds
pechaur27000 folds
P1xel7 folds
abran10 collected 2100 from pot
*** SUMMARY ***
Total pot 2100 | No rake
Seat 5: abran10 won 2100


Winamax Poker - Tournament "MYSTERY KO" buyIn: 1.80€ + 0.20€ level: 5 - HandId: #3104311471450882133-76-1703100926 - Holdem no limit (50/200/400) - 2023/12/20 19:35:26 UTC
Table: 'MYSTERY KO(722778838)#0084' 6-max (real money) Seat #2 is the button
Seat 1: JohnKoff (25027)
Seat 2: pechaur27000 (35566)
Seat 3: P1xel7 (24133)
Seat 4: khamssssa (13610)
Seat 5: abran10 (27868)
Seat 6: hikarisan (17851)
*** ANTE/BLINDS ***
P1xel7 posts ante 50
khamssssa posts ante 50
JohnKoff posts ante 50
pechaur27000 posts ante 50
abran10 posts ante 50
hikarisan posts ante 50
P1xel7 posts small blind 200
khamssssa posts big blind 400
Dealt to P1xel7 [3d Ts]
*** PRE-FLOP *** 
abran10 folds
hikarisan folds
JohnKoff folds
pechaur27000 folds
P1xel7 raises 400 to 800
khamssssa folds
P1xel7 collected 1500 from pot
*** SUMMARY ***
Total pot 1500 | No rake
Seat 3: P1xel7 (small blind) won 1500


Winamax Poker - Tournament "MYSTERY KO" buyIn: 1.80€ + 0.20€ level: 5 - HandId: #3104311471450882133-77-1703100943 - Holdem no limit (50/200/400) - 2023/12/20 19:35:43 UTC
Table: 'MYSTERY KO(722778838)#0084' 6-max (real money) Seat #3 is the button
Seat 1: JohnKoff (24977)
Seat 2: pechaur27000 (35516)
Seat 3: P1xel7 (24783)
Seat 4: khamssssa (13160)
Seat 5: abran10 (27818)
Seat 6: hikarisan (17801)
*** ANTE/BLINDS ***
khamssssa posts ante 50
abran10 posts ante 50
JohnKoff posts ante 50
pechaur27000 posts ante 50
P1xel7 posts ante 50
hikarisan posts ante 50
khamssssa posts small blind 200
abran10 posts big blind 400
Dealt to P1xel7 [4d 3s]
*** PRE-FLOP *** 
hikarisan folds
JohnKoff folds
pechaur27000 folds
P1xel7 folds
khamssssa folds
abran10 collected 900 from pot
*** SUMMARY ***
Total pot 900 | No rake
Seat 5: abran10 (big blind) won 900


Winamax Poker - Tournament "MYSTERY KO" buyIn: 1.80€ + 0.20€ level: 5 - HandId: #3104311471450882133-78-1703100972 - Holdem no limit (50/200/400) - 2023/12/20 19:36:12 UTC
Table: 'MYSTERY KO(722778838)#0084' 6-max (real money) Seat #4 is the button
Seat 1: JohnKoff (24927)
Seat 2: pechaur27000 (35466)
Seat 3: P1xel7 (24733)
Seat 4: khamssssa (12910)
Seat 5: abran10 (28268)
Seat 6: hikarisan (17751)
*** ANTE/BLINDS ***
abran10 posts ante 50
hikarisan posts ante 50
JohnKoff posts ante 50
pechaur27000 posts ante 50
P1xel7 posts ante 50
khamssssa posts ante 50
abran10 posts small blind 200
hikarisan posts big blind 400
Dealt to P1xel7 [Jd 4c]
*** PRE-FLOP *** 
JohnKoff folds
pechaur27000 folds
P1xel7 folds
khamssssa folds
abran10 raises 800 to 1200
hikarisan folds
abran10 collected 1900 from pot
*** SUMMARY ***
Total pot 1900 | No rake
Seat 5: abran10 (small blind) won 1900


Winamax Poker - Tournament "MYSTERY KO" buyIn: 1.80€ + 0.20€ level: 5 - HandId: #3104311471450882133-79-1703101019 - Holdem no limit (50/200/400) - 2023/12/20 19:36:59 UTC
Table: 'MYSTERY KO(722778838)#0084' 6-max (real money) Seat #5 is the button
Seat 1: JohnKoff (24877)
Seat 2: pechaur27000 (35416)
Seat 3: P1xel7 (24683)
Seat 4: khamssssa (12860)
Seat 5: abran10 (28918)
Seat 6: hikarisan (17301)
*** ANTE/BLINDS ***
hikarisan posts ante 50
JohnKoff posts ante 50
pechaur27000 posts ante 50
P1xel7 posts ante 50
khamssssa posts ante 50
abran10 posts ante 50
hikarisan posts small blind 200
JohnKoff posts big blind 400
Dealt to P1xel7 [7s Jd]
*** PRE-FLOP *** 
pechaur27000 folds
P1xel7 folds
khamssssa folds
abran10 raises 800 to 1200
hikarisan folds
JohnKoff calls 800
*** FLOP *** [4c 6s 8h]
JohnKoff checks
abran10 bets 1885
JohnKoff calls 1885
*** TURN *** [4c 6s 8h][As]
JohnKoff checks
abran10 checks
*** RIVER *** [4c 6s 8h As][Ts]
JohnKoff bets 4336
abran10 folds
JohnKoff collected 11006 from pot
*** SUMMARY ***
Total pot 11006 | No rake
Board: [4c 6s 8h As Ts]
Seat 1: JohnKoff (big blind) won 11006


Winamax Poker - Tournament "MYSTERY KO" buyIn: 1.80€ + 0.20€ level: 5 - HandId: #3104311471450882133-80-1703101081 - Holdem no limit (50/200/400) - 2023/12/20 19:38:01 UTC
Table: 'MYSTERY KO(722778838)#0084' 6-max (real money) Seat #6 is the button
Seat 1: JohnKoff (28412)
Seat 2: pechaur27000 (35366)
Seat 3: P1xel7 (24633)
Seat 4: khamssssa (12810)
Seat 5: abran10 (25783)
Seat 6: hikarisan (17051)
*** ANTE/BLINDS ***
JohnKoff posts ante 50
pechaur27000 posts ante 50
P1xel7 posts ante 50
khamssssa posts ante 50
abran10 posts ante 50
hikarisan posts ante 50
JohnKoff posts small blind 200
pechaur27000 posts big blind 400
Dealt to P1xel7 [As 4c]
*** PRE-FLOP *** 
P1xel7 folds
khamssssa folds
abran10 folds
hikarisan folds
JohnKoff raises 1000 to 1400
pechaur27000 calls 1000
*** FLOP *** [Ks 9d Jd]
JohnKoff checks
pechaur27000 bets 33916 and is all-in
JohnKoff calls 26962 and is all-in
*** TURN *** [Ks 9d Jd][8s]
*** RIVER *** [Ks 9d Jd 8s][3s]
*** SHOW DOWN ***
JohnKoff shows [2c Kh] (One pair : Kings)
pechaur27000 shows [Kd Jh] (Two pairs : Kings and Jacks)
pechaur27000 collected 63978 from pot
*** SUMMARY ***
Total pot 63978 | No rake
Board: [Ks 9d Jd 8s 3s]
Seat 1: JohnKoff (small blind) showed [2c Kh] and lost with One pair : Kings
Seat 2: pechaur27000 (big blind) showed [Kd Jh] and won 63978 with Two pairs : Kings and Jacks


Winamax Poker - Tournament "MYSTERY KO" buyIn: 1.80€ + 0.20€ level: 5 - HandId: #3104311471450882133-81-1703101116 - Holdem no limit (50/200/400) - 2023/12/20 19:38:36 UTC
Table: 'MYSTERY KO(722778838)#0084' 6-max (real money) Seat #1 is the button
Seat 2: pechaur27000 (63978)
Seat 3: P1xel7 (24583)
Seat 4: khamssssa (12760)
Seat 5: abran10 (25733)
Seat 6: hikarisan (17001)
*** ANTE/BLINDS ***
pechaur27000 posts ante 50
P1xel7 posts ante 50
khamssssa posts ante 50
abran10 posts ante 50
hikarisan posts ante 50
pechaur27000 posts small blind 200
P1xel7 posts big blind 400
Dealt to P1xel7 [Js Qc]
*** PRE-FLOP *** 
khamssssa folds
abran10 folds
hikarisan raises 600 to 1000
pechaur27000 folds
P1xel7 calls 600
*** FLOP *** [9d 3h Th]
P1xel7 checks
hikarisan checks
*** TURN *** [9d 3h Th][5c]
P1xel7 checks
hikarisan checks
*** RIVER *** [9d 3h Th 5c][6s]
P1xel7 checks
hikarisan checks
*** SHOW DOWN ***
P1xel7 shows [Js Qc] (High card : Queen)
hikarisan shows [As Qs] (High card : Ace)
hikarisan collected 2450 from pot
*** SUMMARY ***
Total pot 2450 | No rake
Board: [9d 3h Th 5c 6s]
Seat 3: P1xel7 (big blind) showed [Js Qc] and lost with High card : Queen
Seat 6: hikarisan showed [As Qs] and won 2450 with High card : Ace


Winamax Poker - Tournament "MYSTERY KO" buyIn: 1.80€ + 0.20€ level: 6 - HandId: #3104311471450882133-82-1703101184 - Holdem no limit (60/250/500) - 2023/12/20 19:39:44 UTC
Table: 'MYSTERY KO(722778838)#0084' 6-max (real money) Seat #2 is the button
Seat 1: Breizhou94 (20000)
Seat 2: pechaur27000 (63728)
Seat 3: P1xel7 (23533)
Seat 4: khamssssa (12710)
Seat 5: abran10 (25683)
Seat 6: hikarisan (18401)
*** ANTE/BLINDS ***
P1xel7 posts ante 60
khamssssa posts ante 60
Breizhou94 posts ante 60
pechaur27000 posts ante 60
abran10 posts ante 60
hikarisan posts ante 60
P1xel7 posts small blind 250
khamssssa posts big blind 500
Dealt to P1xel7 [3s 7h]
*** PRE-FLOP *** 
abran10 raises 750 to 1250
hikarisan folds
Breizhou94 folds
pechaur27000 folds
P1xel7 folds
khamssssa folds
abran10 collected 2360 from pot
*** SUMMARY ***
Total pot 2360 | No rake
Seat 5: abran10 won 2360


Winamax Poker - Tournament "MYSTERY KO" buyIn: 1.80€ + 0.20€ level: 6 - HandId: #3104311471450882133-83-1703101236 - Holdem no limit (60/250/500) - 2023/12/20 19:40:36 UTC
Table: 'MYSTERY KO(722778838)#0084' 6-max (real money) Seat #3 is the button
Seat 1: Breizhou94 (19940)
Seat 2: pechaur27000 (63668)
Seat 3: P1xel7 (23223)
Seat 4: khamssssa (12150)
Seat 5: abran10 (26733)
Seat 6: hikarisan (18341)
*** ANTE/BLINDS ***
khamssssa posts ante 60
abran10 posts ante 60
Breizhou94 posts ante 60
pechaur27000 posts ante 60
P1xel7 posts ante 60
hikarisan posts ante 60
khamssssa posts small blind 250
abran10 posts big blind 500
Dealt to P1xel7 [9h 4s]
*** PRE-FLOP *** 
hikarisan folds
Breizhou94 folds
pechaur27000 folds
P1xel7 folds
khamssssa folds
abran10 collected 1110 from pot
*** SUMMARY ***
Total pot 1110 | No rake
Seat 5: abran10 (big blind) won 1110


Winamax Poker - Tournament "MYSTERY KO" buyIn: 1.80€ + 0.20€ level: 6 - HandId: #3104311471450882133-84-1703101250 - Holdem no limit (60/250/500) - 2023/12/20 19:40:50 UTC
Table: 'MYSTERY KO(722778838)#0084' 6-max (real money) Seat #4 is the button
Seat 1: Breizhou94 (19880)
Seat 2: pechaur27000 (63608)
Seat 3: P1xel7 (23163)
Seat 4: khamssssa (11840)
Seat 5: abran10 (27283)
Seat 6: hikarisan (18281)
*** ANTE/BLINDS ***
abran10 posts ante 60
hikarisan posts ante 60
Breizhou94 posts ante 60
pechaur27000 posts ante 60
P1xel7 posts ante 60
khamssssa posts ante 60
abran10 posts small blind 250
hikarisan posts big blind 500
Dealt to P1xel7 [5c 9d]
*** PRE-FLOP *** 
Breizhou94 folds
pechaur27000 folds
P1xel7 folds
khamssssa folds
abran10 folds
hikarisan collected 1110 from pot
*** SUMMARY ***
Total pot 1110 | No rake
Seat 6: hikarisan (big blind) won 1110


Winamax Poker - Tournament "MYSTERY KO" buyIn: 1.80€ + 0.20€ level: 6 - HandId: #3104311471450882133-85-1703101279 - Holdem no limit (60/250/500) - 2023/12/20 19:41:19 UTC
Table: 'MYSTERY KO(722778838)#0084' 6-max (real money) Seat #5 is the button
Seat 1: Breizhou94 (19820)
Seat 2: pechaur27000 (63548)
Seat 3: P1xel7 (23103)
Seat 4: khamssssa (11780)
Seat 5: abran10 (26973)
Seat 6: hikarisan (18831)
*** ANTE/BLINDS ***
hikarisan posts ante 60
Breizhou94 posts ante 60
pechaur27000 posts ante 60
P1xel7 posts ante 60
khamssssa posts ante 60
abran10 posts ante 60
hikarisan posts small blind 250
Breizhou94 posts big blind 500
Dealt to P1xel7 [4s 5s]
*** PRE-FLOP *** 
pechaur27000 folds
P1xel7 folds
khamssssa folds
abran10 folds
hikarisan calls 250
Breizhou94 checks
*** FLOP *** [9c Jc 3d]
hikarisan checks
Breizhou94 checks
*** TURN *** [9c Jc 3d][8d]
hikarisan checks
Breizhou94 bets 680
hikarisan calls 680
*** RIVER *** [9c Jc 3d 8d][Qc]
hikarisan bets 2720
Breizhou94 calls 2720
*** SHOW DOWN ***
Breizhou94 shows [9d 3c] (Two pairs : 9 and 3)
hikarisan shows [Ts 8s] (Straight Queen high)
hikarisan collected 8160 from pot
*** SUMMARY ***
Total pot 8160 | No rake
Board: [9c Jc 3d 8d Qc]
Seat 1: Breizhou94 (big blind) showed [9d 3c] and lost with Two pairs : 9 and 3
Seat 6: hikarisan (small blind) showed [Ts 8s] and won 8160 with Straight Queen high


Winamax Poker - Tournament "MYSTERY KO" buyIn: 1.80€ + 0.20€ level: 6 - HandId: #3104311471450882133-86-1703101332 - Holdem no limit (60/250/500) - 2023/12/20 19:42:12 UTC
Table: 'MYSTERY KO(722778838)#0084' 6-max (real money) Seat #6 is the button
Seat 1: Breizhou94 (15860)
Seat 2: pechaur27000 (63488)
Seat 3: P1xel7 (23043)
Seat 4: khamssssa (11720)
Seat 5: abran10 (26913)
Seat 6: hikarisan (23031)
*** ANTE/BLINDS ***
Breizhou94 posts ante 60
pechaur27000 posts ante 60
P1xel7 posts ante 60
khamssssa posts ante 60
abran10 posts ante 60
hikarisan posts ante 60
Breizhou94 posts small blind 250
pechaur27000 posts big blind 500
Dealt to P1xel7 [5s 7s]
*** PRE-FLOP *** 
P1xel7 folds
khamssssa folds
abran10 folds
hikarisan folds
Breizhou94 raises 500 to 1000
pechaur27000 folds
Breizhou94 collected 1860 from pot
*** SUMMARY ***
Total pot 1860 | No rake
Seat 1: Breizhou94 (small blind) won 1860


Winamax Poker - Tournament "MYSTERY KO" buyIn: 1.80€ + 0.20€ level: 6 - HandId: #3104311471450882133-87-1703101350 - Holdem no limit (60/250/500) - 2023/12/20 19:42:30 UTC
Table: 'MYSTERY KO(722778838)#0084' 6-max (real money) Seat #1 is the button
Seat 1: Breizhou94 (16660)
Seat 2: pechaur27000 (62928)
Seat 3: P1xel7 (22983)
Seat 4: khamssssa (11660)
Seat 5: abran10 (26853)
Seat 6: hikarisan (22971)
*** ANTE/BLINDS ***
pechaur27000 posts ante 60
P1xel7 posts ante 60
Breizhou94 posts ante 60
khamssssa posts ante 60
abran10 posts ante 60
hikarisan posts ante 60
pechaur27000 posts small blind 250
P1xel7 posts big blind 500
Dealt to P1xel7 [Jd 3h]
*** PRE-FLOP *** 
khamssssa folds
abran10 folds
hikarisan folds
Breizhou94 raises 750 to 1250
pechaur27000 folds
P1xel7 folds
Breizhou94 collected 2360 from pot
*** SUMMARY ***
Total pot 2360 | No rake
Seat 1: Breizhou94 (button) won 2360


Winamax Poker - Tournament "MYSTERY KO" buyIn: 1.80€ + 0.20€ level: 6 - HandId: #3104311471450882133-88-1703101378 - Holdem no limit (60/250/500) - 2023/12/20 19:42:58 UTC
Table: 'MYSTERY KO(722778838)#0084' 6-max (real money) Seat #2 is the button
Seat 1: Breizhou94 (17710)
Seat 2: pechaur27000 (62618)
Seat 3: P1xel7 (22423)
Seat 4: khamssssa (11600)
Seat 5: abran10 (26793)
Seat 6: hikarisan (22911)
*** ANTE/BLINDS ***
P1xel7 posts ante 60
khamssssa posts ante 60
Breizhou94 posts ante 60
pechaur27000 posts ante 60
abran10 posts ante 60
hikarisan posts ante 60
P1xel7 posts small blind 250
khamssssa posts big blind 500
Dealt to P1xel7 [Qc Ac]
*** PRE-FLOP *** 
abran10 folds
hikarisan folds
Breizhou94 folds
pechaur27000 folds
P1xel7 raises 500 to 1000
khamssssa folds
P1xel7 collected 1860 from pot
*** SUMMARY ***
Total pot 1860 | No rake
Seat 3: P1xel7 (small blind) won 1860


Winamax Poker - Tournament "MYSTERY KO" buyIn: 1.80€ + 0.20€ level: 6 - HandId: #3104311471450882133-89-1703101417 - Holdem no limit (60/250/500) - 2023/12/20 19:43:37 UTC
Table: 'MYSTERY KO(722778838)#0084' 6-max (real money) Seat #3 is the button
Seat 1: Breizhou94 (17650)
Seat 2: pechaur27000 (62558)
Seat 3: P1xel7 (23223)
Seat 4: khamssssa (11040)
Seat 5: abran10 (26733)
Seat 6: hikarisan (22851)
*** ANTE/BLINDS ***
khamssssa posts ante 60
abran10 posts ante 60
Breizhou94 posts ante 60
pechaur27000 posts ante 60
P1xel7 posts ante 60
hikarisan posts ante 60
khamssssa posts small blind 250
abran10 posts big blind 500
Dealt to P1xel7 [4d Ac]
*** PRE-FLOP *** 
hikarisan folds
Breizhou94 folds
pechaur27000 folds
P1xel7 raises 600 to 1100
khamssssa folds
abran10 calls 600
*** FLOP *** [4c 5d 7s]
abran10 bets 983
P1xel7 calls 983
*** TURN *** [4c 5d 7s][8s]
abran10 bets 3104
P1xel7 folds
abran10 collected 7880 from pot
*** SUMMARY ***
Total pot 7880 | No rake
Board: [4c 5d 7s 8s]
Seat 5: abran10 (big blind) won 7880


Winamax Poker - Tournament "MYSTERY KO" buyIn: 1.80€ + 0.20€ level: 6 - HandId: #3104311471450882133-90-1703101486 - Holdem no limit (60/250/500) - 2023/12/20 19:44:46 UTC
Table: 'MYSTERY KO(722778838)#0084' 6-max (real money) Seat #4 is the button
Seat 1: Breizhou94 (17590)
Seat 2: pechaur27000 (62498)
Seat 3: P1xel7 (21080)
Seat 4: khamssssa (10730)
Seat 5: abran10 (29366)
Seat 6: hikarisan (22791)
*** ANTE/BLINDS ***
abran10 posts ante 60
hikarisan posts ante 60
Breizhou94 posts ante 60
pechaur27000 posts ante 60
P1xel7 posts ante 60
khamssssa posts ante 60
abran10 posts small blind 250
hikarisan posts big blind 500
Dealt to P1xel7 [Ad Qs]
*** PRE-FLOP *** 
Breizhou94 folds
pechaur27000 folds
P1xel7 raises 750 to 1250
khamssssa folds
abran10 folds
hikarisan folds
P1xel7 collected 2360 from pot
*** SUMMARY ***
Total pot 2360 | No rake
Seat 3: P1xel7 won 2360


Winamax Poker - Tournament "MYSTERY KO" buyIn: 1.80€ + 0.20€ level: 6 - HandId: #3104311471450882133-91-1703101529 - Holdem no limit (60/250/500) - 2023/12/20 19:45:29 UTC
Table: 'MYSTERY KO(722778838)#0084' 6-max (real money) Seat #5 is the button
Seat 1: Breizhou94 (17530)
Seat 2: pechaur27000 (62438)
Seat 3: P1xel7 (22130)
Seat 4: khamssssa (10670)
Seat 5: abran10 (29056)
Seat 6: hikarisan (22231)
*** ANTE/BLINDS ***
hikarisan posts ante 60
Breizhou94 posts ante 60
pechaur27000 posts ante 60
P1xel7 posts ante 60
khamssssa posts ante 60
abran10 posts ante 60
hikarisan posts small blind 250
Breizhou94 posts big blind 500
Dealt to P1xel7 [3d 6s]
*** PRE-FLOP *** 
pechaur27000 folds
P1xel7 folds
khamssssa folds
abran10 folds
hikarisan folds
Breizhou94 collected 1110 from pot
*** SUMMARY ***
Total pot 1110 | No rake
Seat 1: Breizhou94 (big blind) won 1110


Winamax Poker - Tournament "MYSTERY KO" buyIn: 1.80€ + 0.20€ level: 6 - HandId: #3104311471450882133-92-1703101542 - Holdem no limit (60/250/500) - 2023/12/20 19:45:42 UTC
Table: 'MYSTERY KO(722778838)#0084' 6-max (real money) Seat #6 is the button
Seat 1: Breizhou94 (18080)
Seat 2: pechaur27000 (62378)
Seat 3: P1xel7 (22070)
Seat 4: khamssssa (10610)
Seat 5: abran10 (28996)
Seat 6: hikarisan (21921)
*** ANTE/BLINDS ***
Breizhou94 posts ante 60
pechaur27000 posts ante 60
P1xel7 posts ante 60
khamssssa posts ante 60
abran10 posts ante 60
hikarisan posts ante 60
Breizhou94 posts small blind 250
pechaur27000 posts big blind 500
Dealt to P1xel7 [9d Td]
*** PRE-FLOP *** 
P1xel7 folds
khamssssa folds
abran10 folds
hikarisan raises 500 to 1000
Breizhou94 calls 750
pechaur27000 folds
*** FLOP *** [2d 4d 8s]
Breizhou94 checks
hikarisan checks
*** TURN *** [2d 4d 8s][3h]
Breizhou94 checks
hikarisan checks
*** RIVER *** [2d 4d 8s 3h][Qs]
Breizhou94 bets 1001
hikarisan folds
Breizhou94 collected 3861 from pot
*** SUMMARY ***
Total pot 3861 | No rake
Board: [2d 4d 8s 3h Qs]
Seat 1: Breizhou94 (small blind) won 3861


Winamax Poker - Tournament "MYSTERY KO" buyIn: 1.80€ + 0.20€ level: 7 - HandId: #3104311471450882133-93-1703101602 - Holdem no limit (70/300/600) - 2023/12/20 19:46:42 UTC
Table: 'MYSTERY KO(722778838)#0084' 6-max (real money) Seat #1 is the button
Seat 1: Breizhou94 (19880)
Seat 2: pechaur27000 (61818)
Seat 3: P1xel7 (22010)
Seat 4: khamssssa (10550)
Seat 5: abran10 (28936)
Seat 6: hikarisan (20861)
*** ANTE/BLINDS ***
pechaur27000 posts ante 70
P1xel7 posts ante 70
Breizhou94 posts ante 70
khamssssa posts ante 70
abran10 posts ante 70
hikarisan posts ante 70
pechaur27000 posts small blind 300
P1xel7 posts big blind 600
Dealt to P1xel7 [6d 5h]
*** PRE-FLOP *** 
khamssssa folds
abran10 folds
hikarisan raises 900 to 1500
Breizhou94 folds
pechaur27000 folds
P1xel7 folds
hikarisan collected 2820 from pot
*** SUMMARY ***
Total pot 2820 | No rake
Seat 6: hikarisan won 2820


Winamax Poker - Tournament "MYSTERY KO" buyIn: 1.80€ + 0.20€ level: 7 - HandId: #3104311471450882133-94-1703101625 - Holdem no limit (70/300/600) - 2023/12/20 19:47:05 UTC
Table: 'MYSTERY KO(722778838)#0084' 6-max (real money) Seat #2 is the button
Seat 1: Breizhou94 (19810)
Seat 2: pechaur27000 (61448)
Seat 3: P1xel7 (21340)
Seat 4: khamssssa (10480)
Seat 5: abran10 (28866)
Seat 6: hikarisan (22111)
*** ANTE/BLINDS ***
P1xel7 posts ante 70
khamssssa posts ante 70
Breizhou94 posts ante 70
pechaur27000 posts ante 70
abran10 posts ante 70
hikarisan posts ante 70
P1xel7 posts small blind 300
khamssssa posts big blind 600
Dealt to P1xel7 [Jd 3s]
*** PRE-FLOP *** 
abran10 folds
hikarisan folds
Breizhou94 folds
pechaur27000 folds
P1xel7 raises 600 to 1200
khamssssa folds
P1xel7 collected 2220 from pot
*** SUMMARY ***
Total pot 2220 | No rake
Seat 3: P1xel7 (small blind) won 2220


Winamax Poker - Tournament "MYSTERY KO" buyIn: 1.80€ + 0.20€ level: 7 - HandId: #3104311471450882133-95-1703101640 - Holdem no limit (70/300/600) - 2023/12/20 19:47:20 UTC
Table: 'MYSTERY KO(722778838)#0084' 6-max (real money) Seat #3 is the button
Seat 1: Breizhou94 (19740)
Seat 2: pechaur27000 (61378)
Seat 3: P1xel7 (22290)
Seat 4: khamssssa (9810)
Seat 5: abran10 (28796)
Seat 6: hikarisan (22041)
*** ANTE/BLINDS ***
khamssssa posts ante 70
abran10 posts ante 70
Breizhou94 posts ante 70
pechaur27000 posts ante 70
P1xel7 posts ante 70
hikarisan posts ante 70
khamssssa posts small blind 300
abran10 posts big blind 600
Dealt to P1xel7 [Qc 6s]
*** PRE-FLOP *** 
hikarisan raises 600 to 1200
Breizhou94 folds
pechaur27000 folds
P1xel7 folds
khamssssa folds
abran10 folds
hikarisan collected 2520 from pot
*** SUMMARY ***
Total pot 2520 | No rake
Seat 6: hikarisan won 2520


Winamax Poker - Tournament "MYSTERY KO" buyIn: 1.80€ + 0.20€ level: 7 - HandId: #3104311471450882133-96-1703101662 - Holdem no limit (70/300/600) - 2023/12/20 19:47:42 UTC
Table: 'MYSTERY KO(722778838)#0084' 6-max (real money) Seat #4 is the button
Seat 1: Breizhou94 (19670)
Seat 2: pechaur27000 (61308)
Seat 3: P1xel7 (22220)
Seat 4: khamssssa (9440)
Seat 5: abran10 (28126)
Seat 6: hikarisan (23291)
*** ANTE/BLINDS ***
abran10 posts ante 70
hikarisan posts ante 70
Breizhou94 posts ante 70
pechaur27000 posts ante 70
P1xel7 posts ante 70
khamssssa posts ante 70
abran10 posts small blind 300
hikarisan posts big blind 600
Dealt to P1xel7 [3h 6s]
*** PRE-FLOP *** 
Breizhou94 folds
pechaur27000 folds
P1xel7 folds
khamssssa folds
abran10 raises 900 to 1500
hikarisan calls 900
*** FLOP *** [8s 7c 3c]
abran10 bets 2223
hikarisan raises 2822 to 5045
abran10 calls 2822
*** TURN *** [8s 7c 3c][2h]
abran10 checks
hikarisan checks
*** RIVER *** [8s 7c 3c 2h][9d]
abran10 checks
hikarisan checks
*** SHOW DOWN ***
hikarisan shows [5c Ac] (High card : Ace)
abran10 shows [7h Kh] (One pair : 7)
abran10 collected 13510 from pot
*** SUMMARY ***
Total pot 13510 | No rake
Board: [8s 7c 3c 2h 9d]
Seat 5: abran10 (small blind) showed [7h Kh] and won 13510 with One pair : 7
Seat 6: hikarisan (big blind) showed [5c Ac] and lost with High card : Ace


Winamax Poker - Tournament "MYSTERY KO" buyIn: 1.80€ + 0.20€ level: 7 - HandId: #3104311471450882133-97-1703101722 - Holdem no limit (70/300/600) - 2023/12/20 19:48:42 UTC
Table: 'MYSTERY KO(722778838)#0084' 6-max (real money) Seat #5 is the button
Seat 1: Breizhou94 (19600)
Seat 2: pechaur27000 (61238)
Seat 3: P1xel7 (22150)
Seat 4: khamssssa (9370)
Seat 5: abran10 (35021)
Seat 6: hikarisan (16676)
*** ANTE/BLINDS ***
hikarisan posts ante 70
Breizhou94 posts ante 70
pechaur27000 posts ante 70
P1xel7 posts ante 70
khamssssa posts ante 70
abran10 posts ante 70
hikarisan posts small blind 300
Breizhou94 posts big blind 600
Dealt to P1xel7 [Qh 3s]
*** PRE-FLOP *** 
pechaur27000 folds
P1xel7 folds
khamssssa folds
abran10 raises 900 to 1500
hikarisan folds
Breizhou94 folds
abran10 collected 2820 from pot
*** SUMMARY ***
Total pot 2820 | No rake
Seat 5: abran10 (button) won 2820


Winamax Poker - Tournament "MYSTERY KO" buyIn: 1.80€ + 0.20€ level: 7 - HandId: #3104311471450882133-98-1703101744 - Holdem no limit (70/300/600) - 2023/12/20 19:49:04 UTC
Table: 'MYSTERY KO(722778838)#0084' 6-max (real money) Seat #6 is the button
Seat 1: Breizhou94 (18930)
Seat 2: pechaur27000 (61168)
Seat 3: P1xel7 (22080)
Seat 4: khamssssa (9300)
Seat 5: abran10 (36271)
Seat 6: hikarisan (16306)
*** ANTE/BLINDS ***
Breizhou94 posts ante 70
pechaur27000 posts ante 70
P1xel7 posts ante 70
khamssssa posts ante 70
abran10 posts ante 70
hikarisan posts ante 70
Breizhou94 posts small blind 300
pechaur27000 posts big blind 600
Dealt to P1xel7 [6h Td]
*** PRE-FLOP *** 
P1xel7 folds
khamssssa folds
abran10 folds
hikarisan folds
Breizhou94 raises 600 to 1200
pechaur27000 folds
Breizhou94 collected 2220 from pot
*** SUMMARY ***
Total pot 2220 | No rake
Seat 1: Breizhou94 (small blind) won 2220


Winamax Poker - Tournament "MYSTERY KO" buyIn: 1.80€ + 0.20€ level: 7 - HandId: #3104311471450882133-99-1703101758 - Holdem no limit (70/300/600) - 2023/12/20 19:49:18 UTC
Table: 'MYSTERY KO(722778838)#0084' 6-max (real money) Seat #1 is the button
Seat 1: Breizhou94 (19880)
Seat 2: pechaur27000 (60498)
Seat 3: P1xel7 (22010)
Seat 4: khamssssa (9230)
Seat 5: abran10 (36201)
Seat 6: hikarisan (16236)
*** ANTE/BLINDS ***
pechaur27000 posts ante 70
P1xel7 posts ante 70
Breizhou94 posts ante 70
khamssssa posts ante 70
abran10 posts ante 70
hikarisan posts ante 70
pechaur27000 posts small blind 300
P1xel7 posts big blind 600
Dealt to P1xel7 [7d 4h]
*** PRE-FLOP *** 
khamssssa folds
abran10 folds
hikarisan folds
Breizhou94 folds
pechaur27000 folds
P1xel7 collected 1320 from pot
*** SUMMARY ***
Total pot 1320 | No rake
Seat 3: P1xel7 (big blind) won 1320


Winamax Poker - Tournament "MYSTERY KO" buyIn: 1.80€ + 0.20€ level: 7 - HandId: #3104311471450882133-100-1703101771 - Holdem no limit (70/300/600) - 2023/12/20 19:49:31 UTC
Table: 'MYSTERY KO(722778838)#0084' 6-max (real money) Seat #2 is the button
Seat 1: Breizhou94 (19810)
Seat 2: pechaur27000 (60128)
Seat 3: P1xel7 (22660)
Seat 4: khamssssa (9160)
Seat 5: abran10 (36131)
Seat 6: hikarisan (16166)
*** ANTE/BLINDS ***
P1xel7 posts ante 70
khamssssa posts ante 70
Breizhou94 posts ante 70
pechaur27000 posts ante 70
abran10 posts ante 70
hikarisan posts ante 70
P1xel7 posts small blind 300
khamssssa posts big blind 600
Dealt to P1xel7 [3h 7d]
*** PRE-FLOP *** 
abran10 raises 900 to 1500
hikarisan folds
Breizhou94 calls 1500
pechaur27000 folds
P1xel7 folds
khamssssa folds
*** FLOP *** [Qh 8c 6s]
abran10 bets 2808
Breizhou94 folds
abran10 collected 7128 from pot
*** SUMMARY ***
Total pot 7128 | No rake
Board: [Qh 8c 6s]
Seat 5: abran10 won 7128


Winamax Poker - Tournament "MYSTERY KO" buyIn: 1.80€ + 0.20€ level: 7 - HandId: #3104311471450882133-101-1703101811 - Holdem no limit (70/300/600) - 2023/12/20 19:50:11 UTC
Table: 'MYSTERY KO(722778838)#0084' 6-max (real money) Seat #3 is the button
Seat 1: Breizhou94 (18240)
Seat 2: pechaur27000 (60058)
Seat 3: P1xel7 (22290)
Seat 4: khamssssa (8490)
Seat 5: abran10 (38881)
Seat 6: hikarisan (16096)
*** ANTE/BLINDS ***
khamssssa posts ante 70
abran10 posts ante 70
Breizhou94 posts ante 70
pechaur27000 posts ante 70
P1xel7 posts ante 70
hikarisan posts ante 70
khamssssa posts small blind 300
abran10 posts big blind 600
Dealt to P1xel7 [4c 4d]
*** PRE-FLOP *** 
hikarisan raises 600 to 1200
Breizhou94 folds
pechaur27000 folds
P1xel7 calls 1200
khamssssa folds
abran10 folds
*** FLOP *** [4h 2d Ac]
hikarisan checks
P1xel7 checks
*** TURN *** [4h 2d Ac][Qh]
hikarisan checks
P1xel7 bets 1860
hikarisan calls 1860
*** RIVER *** [4h 2d Ac Qh][7s]
hikarisan checks
P1xel7 bets 5952
hikarisan folds
P1xel7 collected 13392 from pot
*** SUMMARY ***
Total pot 13392 | No rake
Board: [4h 2d Ac Qh 7s]
Seat 3: P1xel7 (button) won 13392


Winamax Poker - Tournament "MYSTERY KO" buyIn: 1.80€ + 0.20€ level: 7 - HandId: #3104311471450882133-102-1703101843 - Holdem no limit (70/300/600) - 2023/12/20 19:50:43 UTC
Table: 'MYSTERY KO(722778838)#0084' 6-max (real money) Seat #4 is the button
Seat 1: Breizhou94 (18170)
Seat 2: pechaur27000 (59988)
Seat 3: P1xel7 (26600)
Seat 4: khamssssa (8120)
Seat 5: abran10 (38211)
Seat 6: hikarisan (12966)
*** ANTE/BLINDS ***
abran10 posts ante 70
hikarisan posts ante 70
Breizhou94 posts ante 70
pechaur27000 posts ante 70
P1xel7 posts ante 70
khamssssa posts ante 70
abran10 posts small blind 300
hikarisan posts big blind 600
Dealt to P1xel7 [5d 8d]
*** PRE-FLOP *** 
Breizhou94 folds
pechaur27000 folds
P1xel7 folds
khamssssa folds
abran10 raises 37541 to 38141 and is all-in
hikarisan folds
abran10 collected 39161 from pot
*** SUMMARY ***
Total pot 39161 | No rake
Seat 5: abran10 (small blind) won 39161


Winamax Poker - Tournament "MYSTERY KO" buyIn: 1.80€ + 0.20€ level: 7 - HandId: #3104311471450882133-103-1703101882 - Holdem no limit (70/300/600) - 2023/12/20 19:51:22 UTC
Table: 'MYSTERY KO(722778838)#0084' 6-max (real money) Seat #5 is the button
Seat 1: Breizhou94 (18100)
Seat 2: pechaur27000 (59918)
Seat 3: P1xel7 (26530)
Seat 4: khamssssa (8050)
Seat 5: abran10 (39161)
Seat 6: hikarisan (12296)
*** ANTE/BLINDS ***
hikarisan posts ante 70
Breizhou94 posts ante 70
pechaur27000 posts ante 70
P1xel7 posts ante 70
khamssssa posts ante 70
abran10 posts ante 70
hikarisan posts small blind 300
Breizhou94 posts big blind 600
Dealt to P1xel7 [Ad Qd]
*** PRE-FLOP *** 
pechaur27000 folds
P1xel7 raises 720 to 1320
khamssssa folds
abran10 folds
hikarisan folds
Breizhou94 folds
P1xel7 collected 2640 from pot
*** SUMMARY ***
Total pot 2640 | No rake
Seat 3: P1xel7 won 2640


Winamax Poker - Tournament "MYSTERY KO" buyIn: 1.80€ + 0.20€ level: 7 - HandId: #3104311471450882133-104-1703101905 - Holdem no limit (70/300/600) - 2023/12/20 19:51:45 UTC
Table: 'MYSTERY KO(722778838)#0084' 6-max (real money) Seat #6 is the button
Seat 1: Breizhou94 (17430)
Seat 2: pechaur27000 (59848)
Seat 3: P1xel7 (27780)
Seat 4: khamssssa (7980)
Seat 5: abran10 (39091)
Seat 6: hikarisan (11926)
*** ANTE/BLINDS ***
Breizhou94 posts ante 70
pechaur27000 posts ante 70
P1xel7 posts ante 70
khamssssa posts ante 70
abran10 posts ante 70
hikarisan posts ante 70
Breizhou94 posts small blind 300
pechaur27000 posts big blind 600
Dealt to P1xel7 [Jh 3d]
*** PRE-FLOP *** 
P1xel7 folds
khamssssa folds
abran10 folds
hikarisan folds
Breizhou94 calls 300
pechaur27000 checks
*** FLOP *** [Qs 4s Qh]
Breizhou94 bets 810
pechaur27000 folds
Breizhou94 collected 2430 from pot
*** SUMMARY ***
Total pot 2430 | No rake
Board: [Qs 4s Qh]
Seat 1: Breizhou94 (small blind) won 2430


Winamax Poker - Tournament "MYSTERY KO" buyIn: 1.80€ + 0.20€ level: 7 - HandId: #3104311471450882133-105-1703101927 - Holdem no limit (70/300/600) - 2023/12/20 19:52:07 UTC
Table: 'MYSTERY KO(722778838)#0084' 6-max (real money) Seat #1 is the button
Seat 1: Breizhou94 (18380)
Seat 2: pechaur27000 (59178)
Seat 3: P1xel7 (27710)
Seat 4: khamssssa (7910)
Seat 5: abran10 (39021)
Seat 6: hikarisan (11856)
*** ANTE/BLINDS ***
pechaur27000 posts ante 70
P1xel7 posts ante 70
Breizhou94 posts ante 70
khamssssa posts ante 70
abran10 posts ante 70
hikarisan posts ante 70
pechaur27000 posts small blind 300
P1xel7 posts big blind 600
Dealt to P1xel7 [Ks 8d]
*** PRE-FLOP *** 
khamssssa folds
abran10 folds
hikarisan folds
Breizhou94 folds
pechaur27000 calls 300
P1xel7 checks
*** FLOP *** [2c As Qh]
pechaur27000 checks
P1xel7 bets 1053
pechaur27000 folds
P1xel7 collected 2673 from pot
*** SUMMARY ***
Total pot 2673 | No rake
Board: [2c As Qh]
Seat 3: P1xel7 (big blind) won 2673


Winamax Poker - Tournament "MYSTERY KO" buyIn: 1.80€ + 0.20€ level: 7 - HandId: #3104311471450882133-106-1703101953 - Holdem no limit (70/300/600) - 2023/12/20 19:52:33 UTC
Table: 'MYSTERY KO(722778838)#0084' 6-max (real money) Seat #2 is the button
Seat 1: Breizhou94 (18310)
Seat 2: pechaur27000 (58508)
Seat 3: P1xel7 (28660)
Seat 4: khamssssa (7840)
Seat 5: abran10 (38951)
Seat 6: hikarisan (11786)
*** ANTE/BLINDS ***
P1xel7 posts ante 70
khamssssa posts ante 70
Breizhou94 posts ante 70
pechaur27000 posts ante 70
abran10 posts ante 70
hikarisan posts ante 70
P1xel7 posts small blind 300
khamssssa posts big blind 600
Dealt to P1xel7 [Ts 2s]
*** PRE-FLOP *** 
abran10 raises 900 to 1500
hikarisan folds
Breizhou94 folds
pechaur27000 folds
P1xel7 folds
khamssssa folds
abran10 collected 2820 from pot
*** SUMMARY ***
Total pot 2820 | No rake
Seat 5: abran10 won 2820


Winamax Poker - Tournament "MYSTERY KO" buyIn: 1.80€ + 0.20€ level: 7 - HandId: #3104311471450882133-107-1703101977 - Holdem no limit (70/300/600) - 2023/12/20 19:52:57 UTC
Table: 'MYSTERY KO(722778838)#0084' 6-max (real money) Seat #3 is the button
Seat 1: Breizhou94 (18240)
Seat 2: pechaur27000 (58438)
Seat 3: P1xel7 (28290)
Seat 4: khamssssa (7170)
Seat 5: abran10 (40201)
Seat 6: hikarisan (11716)
*** ANTE/BLINDS ***
khamssssa posts ante 70
abran10 posts ante 70
Breizhou94 posts ante 70
pechaur27000 posts ante 70
P1xel7 posts ante 70
hikarisan posts ante 70
khamssssa posts small blind 300
abran10 posts big blind 600
Dealt to P1xel7 [8d 4h]
*** PRE-FLOP *** 
hikarisan folds
Breizhou94 folds
pechaur27000 folds
P1xel7 folds
khamssssa folds
abran10 collected 1320 from pot
*** SUMMARY ***
Total pot 1320 | No rake
Seat 5: abran10 (big blind) won 1320


Winamax Poker - Tournament "MYSTERY KO" buyIn: 1.80€ + 0.20€ level: 8 - HandId: #3104311471450882133-108-1703102003 - Holdem no limit (80/350/700) - 2023/12/20 19:53:23 UTC
Table: 'MYSTERY KO(722778838)#0084' 6-max (real money) Seat #4 is the button
Seat 1: Breizhou94 (18170)
Seat 2: pechaur27000 (58368)
Seat 3: P1xel7 (28220)
Seat 4: khamssssa (6800)
Seat 5: abran10 (40851)
Seat 6: hikarisan (11646)
*** ANTE/BLINDS ***
abran10 posts ante 80
hikarisan posts ante 80
Breizhou94 posts ante 80
pechaur27000 posts ante 80
P1xel7 posts ante 80
khamssssa posts ante 80
abran10 posts small blind 350
hikarisan posts big blind 700
Dealt to P1xel7 [9d 4d]
*** PRE-FLOP *** 
Breizhou94 folds
pechaur27000 raises 57588 to 58288 and is all-in
P1xel7 folds
khamssssa folds
abran10 folds
hikarisan folds
pechaur27000 collected 59818 from pot
*** SUMMARY ***
Total pot 59818 | No rake
Seat 2: pechaur27000 won 59818


Winamax Poker - Tournament "MYSTERY KO" buyIn: 1.80€ + 0.20€ level: 8 - HandId: #3104311471450882133-109-1703102027 - Holdem no limit (80/350/700) - 2023/12/20 19:53:47 UTC
Table: 'MYSTERY KO(722778838)#0084' 6-max (real money) Seat #5 is the button
Seat 1: Breizhou94 (18090)
Seat 2: pechaur27000 (59818)
Seat 3: P1xel7 (28140)
Seat 4: khamssssa (6720)
Seat 5: abran10 (40421)
Seat 6: hikarisan (10866)
*** ANTE/BLINDS ***
hikarisan posts ante 80
Breizhou94 posts ante 80
pechaur27000 posts ante 80
P1xel7 posts ante 80
khamssssa posts ante 80
abran10 posts ante 80
hikarisan posts small blind 350
Breizhou94 posts big blind 700
Dealt to P1xel7 [Kd 5d]
*** PRE-FLOP *** 
pechaur27000 folds
P1xel7 folds
khamssssa folds
abran10 folds
hikarisan folds
Breizhou94 collected 1530 from pot
*** SUMMARY ***
Total pot 1530 | No rake
Seat 1: Breizhou94 (big blind) won 1530


Winamax Poker - Tournament "MYSTERY KO" buyIn: 1.80€ + 0.20€ level: 8 - HandId: #3104311471450882133-110-1703102044 - Holdem no limit (80/350/700) - 2023/12/20 19:54:04 UTC
Table: 'MYSTERY KO(722778838)#0084' 6-max (real money) Seat #6 is the button
Seat 1: Breizhou94 (18840)
Seat 2: pechaur27000 (59738)
Seat 3: P1xel7 (28060)
Seat 4: khamssssa (6640)
Seat 5: abran10 (40341)
Seat 6: hikarisan (10436)
*** ANTE/BLINDS ***
Breizhou94 posts ante 80
pechaur27000 posts ante 80
P1xel7 posts ante 80
khamssssa posts ante 80
abran10 posts ante 80
hikarisan posts ante 80
Breizhou94 posts small blind 350
pechaur27000 posts big blind 700
Dealt to P1xel7 [Qc 4c]
*** PRE-FLOP *** 
P1xel7 folds
khamssssa folds
abran10 raises 1050 to 1750
hikarisan folds
Breizhou94 folds
pechaur27000 folds
abran10 collected 3280 from pot
*** SUMMARY ***
Total pot 3280 | No rake
Seat 5: abran10 won 3280


Winamax Poker - Tournament "MYSTERY KO" buyIn: 1.80€ + 0.20€ level: 8 - HandId: #3104311471450882133-111-1703102066 - Holdem no limit (80/350/700) - 2023/12/20 19:54:26 UTC
Table: 'MYSTERY KO(722778838)#0084' 6-max (real money) Seat #1 is the button
Seat 1: Breizhou94 (18410)
Seat 2: pechaur27000 (58958)
Seat 3: P1xel7 (27980)
Seat 4: khamssssa (6560)
Seat 5: abran10 (41791)
Seat 6: hikarisan (10356)
*** ANTE/BLINDS ***
pechaur27000 posts ante 80
P1xel7 posts ante 80
Breizhou94 posts ante 80
khamssssa posts ante 80
abran10 posts ante 80
hikarisan posts ante 80
pechaur27000 posts small blind 350
P1xel7 posts big blind 700
Dealt to P1xel7 [7c Jc]
*** PRE-FLOP *** 
khamssssa folds
abran10 folds
hikarisan folds
Breizhou94 raises 1050 to 1750
pechaur27000 folds
P1xel7 folds
Breizhou94 collected 3280 from pot
*** SUMMARY ***
Total pot 3280 | No rake
Seat 1: Breizhou94 (button) won 3280


Winamax Poker - Tournament "MYSTERY KO" buyIn: 1.80€ + 0.20€ level: 8 - HandId: #3104311471450882133-112-1703102088 - Holdem no limit (80/350/700) - 2023/12/20 19:54:48 UTC
Table: 'MYSTERY KO(722778838)#0084' 6-max (real money) Seat #2 is the button
Seat 1: Breizhou94 (19860)
Seat 2: pechaur27000 (58528)
Seat 3: P1xel7 (27200)
Seat 4: khamssssa (6480)
Seat 5: abran10 (41711)
Seat 6: hikarisan (10276)
*** ANTE/BLINDS ***
P1xel7 posts ante 80
khamssssa posts ante 80
Breizhou94 posts ante 80
pechaur27000 posts ante 80
abran10 posts ante 80
hikarisan posts ante 80
P1xel7 posts small blind 350
khamssssa posts big blind 700
Dealt to P1xel7 [Qc 7s]
*** PRE-FLOP *** 
abran10 raises 1050 to 1750
hikarisan folds
Breizhou94 folds
pechaur27000 folds
P1xel7 folds
khamssssa folds
abran10 collected 3280 from pot
*** SUMMARY ***
Total pot 3280 | No rake
Seat 5: abran10 won 3280


Winamax Poker - Tournament "MYSTERY KO" buyIn: 1.80€ + 0.20€ level: 8 - HandId: #3104311471450882133-113-1703102460 - Holdem no limit (80/350/700) - 2023/12/20 20:01:00 UTC
Table: 'MYSTERY KO(722778838)#0084' 6-max (real money) Seat #3 is the button
Seat 1: Breizhou94 (19780)
Seat 2: pechaur27000 (58448)
Seat 3: P1xel7 (26770)
Seat 4: khamssssa (5700)
Seat 5: abran10 (43161)
Seat 6: hikarisan (10196)
*** ANTE/BLINDS ***
khamssssa posts ante 80
abran10 posts ante 80
Breizhou94 posts ante 80
pechaur27000 posts ante 80
P1xel7 posts ante 80
hikarisan posts ante 80
khamssssa posts small blind 350
abran10 posts big blind 700
Dealt to P1xel7 [9s 2h]
*** PRE-FLOP *** 
hikarisan folds
Breizhou94 folds
pechaur27000 calls 700
P1xel7 folds
khamssssa folds
abran10 checks
*** FLOP *** [Qc 9c Tc]
abran10 checks
pechaur27000 bets 700
abran10 folds
pechaur27000 collected 2930 from pot
*** SUMMARY ***
Total pot 2930 | No rake
Board: [Qc 9c Tc]
Seat 2: pechaur27000 won 2930


Winamax Poker - Tournament "MYSTERY KO" buyIn: 1.80€ + 0.20€ level: 8 - HandId: #3104311471450882133-114-1703102537 - Holdem no limit (80/350/700) - 2023/12/20 20:02:17 UTC
Table: 'MYSTERY KO(722778838)#0084' 6-max (real money) Seat #4 is the button
Seat 1: Breizhou94 (19700)
Seat 2: pechaur27000 (59898)
Seat 3: P1xel7 (26690)
Seat 4: khamssssa (5270)
Seat 5: abran10 (42381)
Seat 6: hikarisan (10116)
*** ANTE/BLINDS ***
abran10 posts ante 80
hikarisan posts ante 80
Breizhou94 posts ante 80
pechaur27000 posts ante 80
P1xel7 posts ante 80
khamssssa posts ante 80
abran10 posts small blind 350
hikarisan posts big blind 700
Dealt to P1xel7 [4c Tc]
*** PRE-FLOP *** 
Breizhou94 folds
pechaur27000 calls 700
P1xel7 folds
khamssssa folds
abran10 folds
hikarisan checks
*** FLOP *** [4s 7c Jc]
hikarisan checks
pechaur27000 bets 700
hikarisan folds
pechaur27000 collected 2930 from pot
*** SUMMARY ***
Total pot 2930 | No rake
Board: [4s 7c Jc]
Seat 2: pechaur27000 won 2930


Winamax Poker - Tournament "MYSTERY KO" buyIn: 1.80€ + 0.20€ level: 8 - HandId: #3104311471450882133-115-1703102564 - Holdem no limit (80/350/700) - 2023/12/20 20:02:44 UTC
Table: 'MYSTERY KO(722778838)#0084' 6-max (real money) Seat #5 is the button
Seat 1: Breizhou94 (19620)
Seat 2: pechaur27000 (61348)
Seat 3: P1xel7 (26610)
Seat 4: khamssssa (5190)
Seat 5: abran10 (41951)
Seat 6: hikarisan (9336)
*** ANTE/BLINDS ***
hikarisan posts ante 80
Breizhou94 posts ante 80
pechaur27000 posts ante 80
P1xel7 posts ante 80
khamssssa posts ante 80
abran10 posts ante 80
hikarisan posts small blind 350
Breizhou94 posts big blind 700
Dealt to P1xel7 [5s 6h]
*** PRE-FLOP *** 
pechaur27000 calls 700
P1xel7 folds
khamssssa folds
abran10 folds
hikarisan folds
Breizhou94 checks
*** FLOP *** [7s 6c 4s]
Breizhou94 checks
pechaur27000 checks
*** TURN *** [7s 6c 4s][7h]
Breizhou94 checks
pechaur27000 bets 2230
Breizhou94 calls 2230
*** RIVER *** [7s 6c 4s 7h][As]
Breizhou94 checks
pechaur27000 checks
*** SHOW DOWN ***
Breizhou94 shows [Jc 4d] (Two pairs : 7 and 4)
pechaur27000 shows [5c 5h] (Two pairs : 7 and 5)
pechaur27000 collected 6690 from pot
*** SUMMARY ***
Total pot 6690 | No rake
Board: [7s 6c 4s 7h As]
Seat 1: Breizhou94 (big blind) showed [Jc 4d] and lost with Two pairs : 7 and 4
Seat 2: pechaur27000 showed [5c 5h] and won 6690 with Two pairs : 7 and 5


Winamax Poker - Tournament "MYSTERY KO" buyIn: 1.80€ + 0.20€ level: 8 - HandId: #3104311471450882133-116-1703102616 - Holdem no limit (80/350/700) - 2023/12/20 20:03:36 UTC
Table: 'MYSTERY KO(722778838)#0084' 6-max (real money) Seat #6 is the button
Seat 1: Breizhou94 (16610)
Seat 2: pechaur27000 (65028)
Seat 3: P1xel7 (26530)
Seat 4: khamssssa (5110)
Seat 5: abran10 (41871)
Seat 6: hikarisan (8906)
*** ANTE/BLINDS ***
Breizhou94 posts ante 80
pechaur27000 posts ante 80
P1xel7 posts ante 80
khamssssa posts ante 80
abran10 posts ante 80
hikarisan posts ante 80
Breizhou94 posts small blind 350
pechaur27000 posts big blind 700
Dealt to P1xel7 [4d Th]
*** PRE-FLOP *** 
P1xel7 folds
khamssssa folds
abran10 folds
hikarisan folds
Breizhou94 calls 350
pechaur27000 checks
*** FLOP *** [Tc 6d Qs]
Breizhou94 checks
pechaur27000 checks
*** TURN *** [Tc 6d Qs][8s]
Breizhou94 checks
pechaur27000 checks
*** RIVER *** [Tc 6d Qs 8s][Jh]
Breizhou94 checks
pechaur27000 checks
*** SHOW DOWN ***
pechaur27000 shows [5d 2c] (High card : Queen)
Breizhou94 shows [Kh 8h] (One pair : 8)
Breizhou94 collected 1880 from pot
*** SUMMARY ***
Total pot 1880 | No rake
Board: [Tc 6d Qs 8s Jh]
Seat 1: Breizhou94 (small blind) showed [Kh 8h] and won 1880 with One pair : 8
Seat 2: pechaur27000 (big blind) showed [5d 2c] and lost with High card : Queen


Winamax Poker - Tournament "MYSTERY KO" buyIn: 1.80€ + 0.20€ level: 8 - HandId: #3104311471450882133-117-1703102648 - Holdem no limit (80/350/700) - 2023/12/20 20:04:08 UTC
Table: 'MYSTERY KO(722778838)#0084' 6-max (real money) Seat #1 is the button
Seat 1: Breizhou94 (17710)
Seat 2: pechaur27000 (64248)
Seat 3: P1xel7 (26450)
Seat 4: khamssssa (5030)
Seat 5: abran10 (41791)
Seat 6: hikarisan (8826)
*** ANTE/BLINDS ***
pechaur27000 posts ante 80
P1xel7 posts ante 80
Breizhou94 posts ante 80
khamssssa posts ante 80
abran10 posts ante 80
hikarisan posts ante 80
pechaur27000 posts small blind 350
P1xel7 posts big blind 700
Dealt to P1xel7 [6s 8s]
*** PRE-FLOP *** 
khamssssa folds
abran10 raises 1050 to 1750
hikarisan folds
Breizhou94 folds
pechaur27000 folds
P1xel7 calls 1050
*** FLOP *** [Jh 4c 7d]
P1xel7 checks
abran10 bets 2815
P1xel7 calls 2815
*** TURN *** [Jh 4c 7d][Qc]
P1xel7 checks
abran10 bets 6474
P1xel7 folds
abran10 collected 16434 from pot
*** SUMMARY ***
Total pot 16434 | No rake
Board: [Jh 4c 7d Qc]
Seat 5: abran10 won 16434


Winamax Poker - Tournament "MYSTERY KO" buyIn: 1.80€ + 0.20€ level: 8 - HandId: #3104311471450882133-118-1703102697 - Holdem no limit (80/350/700) - 2023/12/20 20:04:57 UTC
Table: 'MYSTERY KO(722778838)#0084' 6-max (real money) Seat #2 is the button
Seat 1: Breizhou94 (17630)
Seat 2: pechaur27000 (63818)
Seat 3: P1xel7 (21805)
Seat 4: khamssssa (4950)
Seat 5: abran10 (47106)
Seat 6: hikarisan (8746)
*** ANTE/BLINDS ***
P1xel7 posts ante 80
khamssssa posts ante 80
Breizhou94 posts ante 80
pechaur27000 posts ante 80
abran10 posts ante 80
hikarisan posts ante 80
P1xel7 posts small blind 350
khamssssa posts big blind 700
Dealt to P1xel7 [Ks 3d]
*** PRE-FLOP *** 
abran10 raises 700 to 1400
hikarisan folds
Breizhou94 folds
pechaur27000 folds
P1xel7 folds
khamssssa folds
abran10 collected 2930 from pot
*** SUMMARY ***
Total pot 2930 | No rake
Seat 5: abran10 won 2930


Winamax Poker - Tournament "MYSTERY KO" buyIn: 1.80€ + 0.20€ level: 8 - HandId: #3104311471450882133-119-1703102731 - Holdem no limit (80/350/700) - 2023/12/20 20:05:31 UTC
Table: 'MYSTERY KO(722778838)#0084' 6-max (real money) Seat #3 is the button
Seat 1: Breizhou94 (17550)
Seat 2: pechaur27000 (63738)
Seat 3: P1xel7 (21375)
Seat 4: khamssssa (4170)
Seat 5: abran10 (48556)
Seat 6: hikarisan (8666)
*** ANTE/BLINDS ***
khamssssa posts ante 80
abran10 posts ante 80
Breizhou94 posts ante 80
pechaur27000 posts ante 80
P1xel7 posts ante 80
hikarisan posts ante 80
khamssssa posts small blind 350
abran10 posts big blind 700
Dealt to P1xel7 [4c 5s]
*** PRE-FLOP *** 
hikarisan folds
Breizhou94 folds
pechaur27000 calls 700
P1xel7 folds
khamssssa folds
abran10 checks
*** FLOP *** [2d 3h Tc]
abran10 checks
pechaur27000 checks
*** TURN *** [2d 3h Tc][2h]
abran10 bets 781
pechaur27000 folds
abran10 collected 3011 from pot
*** SUMMARY ***
Total pot 3011 | No rake
Board: [2d 3h Tc 2h]
Seat 5: abran10 (big blind) won 3011


Winamax Poker - Tournament "MYSTERY KO" buyIn: 1.80€ + 0.20€ level: 9 - HandId: #3104311471450882133-120-1703102784 - Holdem no limit (100/400/800) - 2023/12/20 20:06:24 UTC
Table: 'MYSTERY KO(722778838)#0084' 6-max (real money) Seat #4 is the button
Seat 1: Breizhou94 (17470)
Seat 2: pechaur27000 (62958)
Seat 3: P1xel7 (21295)
Seat 4: khamssssa (3740)
Seat 5: abran10 (50006)
Seat 6: hikarisan (8586)
*** ANTE/BLINDS ***
abran10 posts ante 100
hikarisan posts ante 100
Breizhou94 posts ante 100
pechaur27000 posts ante 100
P1xel7 posts ante 100
khamssssa posts ante 100
abran10 posts small blind 400
hikarisan posts big blind 800
Dealt to P1xel7 [Ac 6c]
*** PRE-FLOP *** 
Breizhou94 folds
pechaur27000 folds
P1xel7 raises 800 to 1600
khamssssa folds
abran10 folds
hikarisan raises 6886 to 8486 and is all-in
P1xel7 calls 6886
*** FLOP *** [9h Ts 6d]
*** TURN *** [9h Ts 6d][7c]
*** RIVER *** [9h Ts 6d 7c][Js]
*** SHOW DOWN ***
P1xel7 shows [Ac 6c] (One pair : 6)
hikarisan shows [As 6s] (One pair : 6)
hikarisan collected 8986 from pot
P1xel7 collected 8986 from pot
*** SUMMARY ***
Total pot 17972 | No rake
Board: [9h Ts 6d 7c Js]
Seat 3: P1xel7 showed [Ac 6c] and won 8986 with One pair : 6
Seat 6: hikarisan (big blind) showed [As 6s] and won 8986 with One pair : 6


Winamax Poker - Tournament "MYSTERY KO" buyIn: 1.80€ + 0.20€ level: 9 - HandId: #3104311471450882133-121-1703102816 - Holdem no limit (100/400/800) - 2023/12/20 20:06:56 UTC
Table: 'MYSTERY KO(722778838)#0084' 6-max (real money) Seat #5 is the button
Seat 1: Breizhou94 (17370)
Seat 2: pechaur27000 (62858)
Seat 3: P1xel7 (21695)
Seat 4: khamssssa (3640)
Seat 5: abran10 (49506)
Seat 6: hikarisan (8986)
*** ANTE/BLINDS ***
hikarisan posts ante 100
Breizhou94 posts ante 100
pechaur27000 posts ante 100
P1xel7 posts ante 100
khamssssa posts ante 100
abran10 posts ante 100
hikarisan posts small blind 400
Breizhou94 posts big blind 800
Dealt to P1xel7 [3d Ah]
*** PRE-FLOP *** 
pechaur27000 folds
P1xel7 folds
khamssssa folds
abran10 folds
hikarisan calls 400
Breizhou94 checks
*** FLOP *** [4h Ks 8s]
hikarisan checks
Breizhou94 checks
*** TURN *** [4h Ks 8s][9s]
hikarisan bets 1100
Breizhou94 folds
hikarisan collected 3300 from pot
*** SUMMARY ***
Total pot 3300 | No rake
Board: [4h Ks 8s 9s]
Seat 6: hikarisan (small blind) won 3300


Winamax Poker - Tournament "MYSTERY KO" buyIn: 1.80€ + 0.20€ level: 9 - HandId: #3104311471450882133-122-1703102858 - Holdem no limit (100/400/800) - 2023/12/20 20:07:38 UTC
Table: 'MYSTERY KO(722778838)#0084' 6-max (real money) Seat #6 is the button
Seat 1: Breizhou94 (16470)
Seat 2: pechaur27000 (62758)
Seat 3: P1xel7 (21595)
Seat 4: khamssssa (3540)
Seat 5: abran10 (49406)
Seat 6: hikarisan (10286)
*** ANTE/BLINDS ***
Breizhou94 posts ante 100
pechaur27000 posts ante 100
P1xel7 posts ante 100
khamssssa posts ante 100
abran10 posts ante 100
hikarisan posts ante 100
Breizhou94 posts small blind 400
pechaur27000 posts big blind 800
Dealt to P1xel7 [As 4s]
*** PRE-FLOP *** 
P1xel7 folds
khamssssa folds
abran10 raises 800 to 1600
hikarisan folds
Breizhou94 calls 1200
pechaur27000 calls 800
*** FLOP *** [6s Qh 2s]
Breizhou94 checks
pechaur27000 checks
abran10 bets 3510
Breizhou94 folds
pechaur27000 raises 57548 to 61058 and is all-in
abran10 folds
pechaur27000 collected 69968 from pot
*** SUMMARY ***
Total pot 69968 | No rake
Board: [6s Qh 2s]
Seat 2: pechaur27000 (big blind) won 69968


Winamax Poker - Tournament "MYSTERY KO" buyIn: 1.80€ + 0.20€ level: 9 - HandId: #3104311471450882133-123-1703102936 - Holdem no limit (100/400/800) - 2023/12/20 20:08:56 UTC
Table: 'MYSTERY KO(722778838)#0084' 6-max (real money) Seat #1 is the button
Seat 1: Breizhou94 (14770)
Seat 2: pechaur27000 (69968)
Seat 3: P1xel7 (21495)
Seat 4: khamssssa (3440)
Seat 5: abran10 (44196)
Seat 6: hikarisan (10186)
*** ANTE/BLINDS ***
pechaur27000 posts ante 100
P1xel7 posts ante 100
Breizhou94 posts ante 100
khamssssa posts ante 100
abran10 posts ante 100
hikarisan posts ante 100
pechaur27000 posts small blind 400
P1xel7 posts big blind 800
Dealt to P1xel7 [Kd 8s]
*** PRE-FLOP *** 
khamssssa folds
abran10 folds
hikarisan raises 9286 to 10086 and is all-in
Breizhou94 folds
pechaur27000 calls 9686
P1xel7 folds
*** FLOP *** [Qc Ad 2s]
*** TURN *** [Qc Ad 2s][6c]
*** RIVER *** [Qc Ad 2s 6c][Jc]
*** SHOW DOWN ***
hikarisan shows [8h Ac] (One pair : Aces)
pechaur27000 shows [Js Jh] (Trips of Jacks)
pechaur27000 collected 21572 from pot
*** SUMMARY ***
Total pot 21572 | No rake
Board: [Qc Ad 2s 6c Jc]
Seat 2: pechaur27000 (small blind) showed [Js Jh] and won 21572 with Trips of Jacks
Seat 6: hikarisan showed [8h Ac] and lost with One pair : Aces


Winamax Poker - Tournament "MYSTERY KO" buyIn: 1.80€ + 0.20€ level: 9 - HandId: #3104311471450882133-124-1703102975 - Holdem no limit (100/400/800) - 2023/12/20 20:09:35 UTC
Table: 'MYSTERY KO(722778838)#0084' 6-max (real money) Seat #2 is the button
Seat 1: Breizhou94 (14670)
Seat 2: pechaur27000 (81354)
Seat 3: P1xel7 (20595)
Seat 4: khamssssa (3340)
Seat 5: abran10 (44096)
*** ANTE/BLINDS ***
P1xel7 posts ante 100
khamssssa posts ante 100
Breizhou94 posts ante 100
pechaur27000 posts ante 100
abran10 posts ante 100
P1xel7 posts small blind 400
khamssssa posts big blind 800
Dealt to P1xel7 [6d Js]
*** PRE-FLOP *** 
abran10 folds
Breizhou94 folds
pechaur27000 folds
P1xel7 raises 800 to 1600
khamssssa folds
P1xel7 collected 2900 from pot
*** SUMMARY ***
Total pot 2900 | No rake
Seat 3: P1xel7 (small blind) won 2900


Winamax Poker - Tournament "MYSTERY KO" buyIn: 1.80€ + 0.20€ level: 9 - HandId: #3104311471450882133-125-1703102992 - Holdem no limit (100/400/800) - 2023/12/20 20:09:52 UTC
Table: 'MYSTERY KO(722778838)#0084' 6-max (real money) Seat #3 is the button
Seat 1: Breizhou94 (14570)
Seat 2: pechaur27000 (81254)
Seat 3: P1xel7 (21795)
Seat 4: khamssssa (2440)
Seat 5: abran10 (43996)
*** ANTE/BLINDS ***
khamssssa posts ante 100
abran10 posts ante 100
Breizhou94 posts ante 100
pechaur27000 posts ante 100
P1xel7 posts ante 100
khamssssa posts small blind 400
abran10 posts big blind 800
Dealt to P1xel7 [7c Qd]
*** PRE-FLOP *** 
Breizhou94 folds
pechaur27000 folds
P1xel7 folds
khamssssa folds
abran10 collected 1700 from pot
*** SUMMARY ***
Total pot 1700 | No rake
Seat 5: abran10 (big blind) won 1700


Winamax Poker - Tournament "MYSTERY KO" buyIn: 1.80€ + 0.20€ level: 9 - HandId: #3104311471450882133-126-1703103004 - Holdem no limit (100/400/800) - 2023/12/20 20:10:04 UTC
Table: 'MYSTERY KO(722778838)#0084' 6-max (real money) Seat #4 is the button
Seat 1: Breizhou94 (14470)
Seat 2: pechaur27000 (81154)
Seat 3: P1xel7 (21695)
Seat 4: khamssssa (1940)
Seat 5: abran10 (44796)
*** ANTE/BLINDS ***
abran10 posts ante 100
Breizhou94 posts ante 100
pechaur27000 posts ante 100
P1xel7 posts ante 100
khamssssa posts ante 100
abran10 posts small blind 400
Breizhou94 posts big blind 800
Dealt to P1xel7 [8d Qh]
*** PRE-FLOP *** 
pechaur27000 folds
P1xel7 folds
khamssssa folds
abran10 raises 1200 to 2000
Breizhou94 folds
abran10 collected 3300 from pot
*** SUMMARY ***
Total pot 3300 | No rake
Seat 5: abran10 (small blind) won 3300


Winamax Poker - Tournament "MYSTERY KO" buyIn: 1.80€ + 0.20€ level: 9 - HandId: #3104311471450882133-127-1703103050 - Holdem no limit (100/400/800) - 2023/12/20 20:10:50 UTC
Table: 'MYSTERY KO(722778838)#0084' 6-max (real money) Seat #5 is the button
Seat 1: Breizhou94 (13570)
Seat 2: pechaur27000 (81054)
Seat 3: P1xel7 (21595)
Seat 4: khamssssa (1840)
Seat 5: abran10 (45996)
*** ANTE/BLINDS ***
Breizhou94 posts ante 100
pechaur27000 posts ante 100
P1xel7 posts ante 100
khamssssa posts ante 100
abran10 posts ante 100
Breizhou94 posts small blind 400
pechaur27000 posts big blind 800
Dealt to P1xel7 [6d Ah]
*** PRE-FLOP *** 
P1xel7 folds
khamssssa folds
abran10 folds
Breizhou94 calls 400
pechaur27000 checks
*** FLOP *** [2d 4c Kd]
Breizhou94 checks
pechaur27000 checks
*** TURN *** [2d 4c Kd][Jd]
Breizhou94 checks
pechaur27000 checks
*** RIVER *** [2d 4c Kd Jd][Th]
Breizhou94 checks
pechaur27000 checks
*** SHOW DOWN ***
pechaur27000 shows [7h Qc] (High card : King)
Breizhou94 shows [5s 2s] (One pair : 2)
Breizhou94 collected 2100 from pot
*** SUMMARY ***
Total pot 2100 | No rake
Board: [2d 4c Kd Jd Th]
Seat 1: Breizhou94 (small blind) showed [5s 2s] and won 2100 with One pair : 2
Seat 2: pechaur27000 (big blind) showed [7h Qc] and lost with High card : King


Winamax Poker - Tournament "MYSTERY KO" buyIn: 1.80€ + 0.20€ level: 9 - HandId: #3104311471450882133-128-1703103101 - Holdem no limit (100/400/800) - 2023/12/20 20:11:41 UTC
Table: 'MYSTERY KO(722778838)#0084' 6-max (real money) Seat #1 is the button
Seat 1: Breizhou94 (14770)
Seat 2: pechaur27000 (80154)
Seat 3: P1xel7 (21495)
Seat 4: khamssssa (1740)
Seat 5: abran10 (45896)
*** ANTE/BLINDS ***
pechaur27000 posts ante 100
P1xel7 posts ante 100
Breizhou94 posts ante 100
khamssssa posts ante 100
abran10 posts ante 100
pechaur27000 posts small blind 400
P1xel7 posts big blind 800
Dealt to P1xel7 [Js Qc]
*** PRE-FLOP *** 
khamssssa folds
abran10 folds
Breizhou94 folds
pechaur27000 folds
P1xel7 collected 1700 from pot
*** SUMMARY ***
Total pot 1700 | No rake
Seat 3: P1xel7 (big blind) won 1700


Winamax Poker - Tournament "MYSTERY KO" buyIn: 1.80€ + 0.20€ level: 9 - HandId: #3104311471450882133-129-1703103112 - Holdem no limit (100/400/800) - 2023/12/20 20:11:52 UTC
Table: 'MYSTERY KO(722778838)#0084' 6-max (real money) Seat #2 is the button
Seat 1: Breizhou94 (14670)
Seat 2: pechaur27000 (79654)
Seat 3: P1xel7 (22295)
Seat 4: khamssssa (1640)
Seat 5: abran10 (45796)
Seat 6: michto2000 (20000)
*** ANTE/BLINDS ***
P1xel7 posts ante 100
khamssssa posts ante 100
Breizhou94 posts ante 100
pechaur27000 posts ante 100
abran10 posts ante 100
michto2000 posts ante 100
P1xel7 posts small blind 400
khamssssa posts big blind 800
Dealt to P1xel7 [2s Qs]
*** PRE-FLOP *** 
abran10 folds
michto2000 calls 800
Breizhou94 folds
pechaur27000 folds
P1xel7 folds
khamssssa checks
*** FLOP *** [Ad Jh Ks]
khamssssa checks
michto2000 bets 1690
khamssssa folds
michto2000 collected 4290 from pot
*** SUMMARY ***
Total pot 4290 | No rake
Board: [Ad Jh Ks]
Seat 6: michto2000 won 4290


Winamax Poker - Tournament "MYSTERY KO" buyIn: 1.80€ + 0.20€ level: 9 - HandId: #3104311471450882133-130-1703103151 - Holdem no limit (100/400/800) - 2023/12/20 20:12:31 UTC
Table: 'MYSTERY KO(722778838)#0084' 6-max (real money) Seat #3 is the button
Seat 1: Breizhou94 (14570)
Seat 2: pechaur27000 (79554)
Seat 3: P1xel7 (21795)
Seat 4: khamssssa (740)
Seat 5: abran10 (45696)
Seat 6: michto2000 (21700)
*** ANTE/BLINDS ***
khamssssa posts ante 100
abran10 posts ante 100
Breizhou94 posts ante 100
pechaur27000 posts ante 100
P1xel7 posts ante 100
michto2000 posts ante 100
khamssssa posts small blind 400
abran10 posts big blind 800
Dealt to P1xel7 [7c As]
*** PRE-FLOP *** 
michto2000 folds
Breizhou94 folds
pechaur27000 folds
P1xel7 raises 800 to 1600
khamssssa folds
abran10 folds
P1xel7 collected 3400 from pot
*** SUMMARY ***
Total pot 3400 | No rake
Seat 3: P1xel7 (button) won 3400


Winamax Poker - Tournament "MYSTERY KO" buyIn: 1.80€ + 0.20€ level: 9 - HandId: #3104311471450882133-131-1703103180 - Holdem no limit (100/400/800) - 2023/12/20 20:13:00 UTC
Table: 'MYSTERY KO(722778838)#0084' 6-max (real money) Seat #4 is the button
Seat 1: Breizhou94 (14470)
Seat 2: pechaur27000 (79454)
Seat 3: P1xel7 (23495)
Seat 4: khamssssa (240)
Seat 5: abran10 (44796)
Seat 6: michto2000 (21600)
*** ANTE/BLINDS ***
abran10 posts ante 100
michto2000 posts ante 100
Breizhou94 posts ante 100
pechaur27000 posts ante 100
P1xel7 posts ante 100
khamssssa posts ante 100
abran10 posts small blind 400
michto2000 posts big blind 800
Dealt to P1xel7 [3d 8h]
*** PRE-FLOP *** 
Breizhou94 folds
pechaur27000 folds
P1xel7 folds
khamssssa folds
abran10 raises 1200 to 2000
michto2000 calls 1200
*** FLOP *** [2h Jd 6h]
abran10 bets 2990
michto2000 calls 2990
*** TURN *** [2h Jd 6h][Ts]
abran10 bets 6877
michto2000 folds
abran10 collected 17457 from pot
*** SUMMARY ***
Total pot 17457 | No rake
Board: [2h Jd 6h Ts]
Seat 5: abran10 (small blind) won 17457


Winamax Poker - Tournament "MYSTERY KO" buyIn: 1.80€ + 0.20€ level: 10 - HandId: #3104311471450882133-132-1703103238 - Holdem no limit (120/500/1000) - 2023/12/20 20:13:58 UTC
Table: 'MYSTERY KO(722778838)#0084' 6-max (real money) Seat #5 is the button
Seat 1: Breizhou94 (14370)
Seat 2: pechaur27000 (79354)
Seat 3: P1xel7 (23395)
Seat 4: khamssssa (140)
Seat 5: abran10 (50286)
Seat 6: michto2000 (16510)
*** ANTE/BLINDS ***
michto2000 posts ante 120
Breizhou94 posts ante 120
pechaur27000 posts ante 120
P1xel7 posts ante 120
khamssssa posts ante 120
abran10 posts ante 120
michto2000 posts small blind 500
Breizhou94 posts big blind 1000
Dealt to P1xel7 [8c Kc]
*** PRE-FLOP *** 
pechaur27000 calls 1000
P1xel7 folds
khamssssa folds
abran10 folds
michto2000 calls 500
Breizhou94 checks
*** FLOP *** [Qd 4d 5s]
michto2000 bets 15390 and is all-in
Breizhou94 folds
pechaur27000 folds
michto2000 collected 19110 from pot
*** SUMMARY ***
Total pot 19110 | No rake
Board: [Qd 4d 5s]
Seat 6: michto2000 (small blind) won 19110


Winamax Poker - Tournament "MYSTERY KO" buyIn: 1.80€ + 0.20€ level: 10 - HandId: #3104311471450882143-94-1703103314 - Holdem no limit (120/500/1000) - 2023/12/20 20:15:14 UTC
Table: 'MYSTERY KO(722778838)#0094' 6-max (real money) Seat #1 is the button
Seat 1: SMITH&FUNKY (125075)
Seat 2: LesNuLs13&59 (51839)
Seat 3: nessnaila (28474)
Seat 4: ospahuer (13795)
Seat 5: -Bounty- (19880)
Seat 6: P1xel7 (23275)
*** ANTE/BLINDS ***
LesNuLs13&59 posts ante 120
nessnaila posts ante 120
SMITH&FUNKY posts ante 120
ospahuer posts ante 120
-Bounty- posts ante 120
P1xel7 posts ante 120
LesNuLs13&59 posts small blind 500
nessnaila posts big blind 1000
Dealt to P1xel7 [Jh 9h]
*** PRE-FLOP *** 
ospahuer folds
-Bounty- folds
P1xel7 raises 1200 to 2200
SMITH&FUNKY folds
LesNuLs13&59 folds
nessnaila calls 1200
*** FLOP *** [6s 8s 2d]
nessnaila bets 1000
P1xel7 folds
nessnaila collected 6620 from pot
*** SUMMARY ***
Total pot 6620 | No rake
Board: [6s 8s 2d]
Seat 3: nessnaila (big blind) won 6620


Winamax Poker - Tournament "MYSTERY KO" buyIn: 1.80€ + 0.20€ level: 10 - HandId: #3104311471450882143-95-1703103355 - Holdem no limit (120/500/1000) - 2023/12/20 20:15:55 UTC
Table: 'MYSTERY KO(722778838)#0094' 6-max (real money) Seat #2 is the button
Seat 1: SMITH&FUNKY (124955)
Seat 2: LesNuLs13&59 (51219)
Seat 3: nessnaila (31774)
Seat 4: ospahuer (13675)
Seat 5: -Bounty- (19760)
Seat 6: P1xel7 (20955)
*** ANTE/BLINDS ***
nessnaila posts ante 120
ospahuer posts ante 120
SMITH&FUNKY posts ante 120
LesNuLs13&59 posts ante 120
-Bounty- posts ante 120
P1xel7 posts ante 120
nessnaila posts small blind 500
ospahuer posts big blind 1000
Dealt to P1xel7 [4d Js]
*** PRE-FLOP *** 
-Bounty- folds
P1xel7 folds
SMITH&FUNKY folds
LesNuLs13&59 folds
nessnaila folds
ospahuer collected 2220 from pot
*** SUMMARY ***
Total pot 2220 | No rake
Seat 4: ospahuer (big blind) won 2220


Winamax Poker - Tournament "MYSTERY KO" buyIn: 1.80€ + 0.20€ level: 10 - HandId: #3104311471450882143-96-1703103369 - Holdem no limit (120/500/1000) - 2023/12/20 20:16:09 UTC
Table: 'MYSTERY KO(722778838)#0094' 6-max (real money) Seat #3 is the button
Seat 1: SMITH&FUNKY (124835)
Seat 2: LesNuLs13&59 (51099)
Seat 3: nessnaila (31154)
Seat 4: ospahuer (14775)
Seat 5: -Bounty- (19640)
Seat 6: P1xel7 (20835)
*** ANTE/BLINDS ***
ospahuer posts ante 120
-Bounty- posts ante 120
SMITH&FUNKY posts ante 120
LesNuLs13&59 posts ante 120
nessnaila posts ante 120
P1xel7 posts ante 120
ospahuer posts small blind 500
-Bounty- posts big blind 1000
Dealt to P1xel7 [Kd 7d]
*** PRE-FLOP *** 
P1xel7 folds
SMITH&FUNKY folds
LesNuLs13&59 raises 1000 to 2000
nessnaila folds
ospahuer folds
-Bounty- folds
LesNuLs13&59 collected 4220 from pot
*** SUMMARY ***
Total pot 4220 | No rake
Seat 2: LesNuLs13&59 won 4220


Winamax Poker - Tournament "MYSTERY KO" buyIn: 1.80€ + 0.20€ level: 10 - HandId: #3104311471450882143-97-1703103411 - Holdem no limit (120/500/1000) - 2023/12/20 20:16:51 UTC
Table: 'MYSTERY KO(722778838)#0094' 6-max (real money) Seat #4 is the button
Seat 1: SMITH&FUNKY (124715)
Seat 2: LesNuLs13&59 (53199)
Seat 3: nessnaila (31034)
Seat 4: ospahuer (14155)
Seat 5: -Bounty- (18520)
Seat 6: P1xel7 (20715)
*** ANTE/BLINDS ***
-Bounty- posts ante 120
P1xel7 posts ante 120
SMITH&FUNKY posts ante 120
LesNuLs13&59 posts ante 120
nessnaila posts ante 120
ospahuer posts ante 120
-Bounty- posts small blind 500
P1xel7 posts big blind 1000
Dealt to P1xel7 [5c 5h]
*** PRE-FLOP *** 
SMITH&FUNKY folds
LesNuLs13&59 folds
nessnaila folds
ospahuer folds
-Bounty- raises 17400 to 18400 and is all-in
P1xel7 folds
-Bounty- collected 20120 from pot
*** SUMMARY ***
Total pot 20120 | No rake
Seat 5: -Bounty- (small blind) won 20120


Winamax Poker - Tournament "MYSTERY KO" buyIn: 1.80€ + 0.20€ level: 10 - HandId: #3104311471450882143-98-1703103460 - Holdem no limit (120/500/1000) - 2023/12/20 20:17:40 UTC
Table: 'MYSTERY KO(722778838)#0094' 6-max (real money) Seat #5 is the button
Seat 1: SMITH&FUNKY (124595)
Seat 2: LesNuLs13&59 (53079)
Seat 3: nessnaila (30914)
Seat 4: ospahuer (14035)
Seat 5: -Bounty- (20120)
Seat 6: P1xel7 (19595)
*** ANTE/BLINDS ***
P1xel7 posts ante 120
SMITH&FUNKY posts ante 120
LesNuLs13&59 posts ante 120
nessnaila posts ante 120
ospahuer posts ante 120
-Bounty- posts ante 120
P1xel7 posts small blind 500
SMITH&FUNKY posts big blind 1000
Dealt to P1xel7 [3h Js]
*** PRE-FLOP *** 
LesNuLs13&59 calls 1000
nessnaila folds
ospahuer folds
-Bounty- folds
P1xel7 folds
SMITH&FUNKY checks
*** FLOP *** [Ts Kd 3c]
SMITH&FUNKY checks
LesNuLs13&59 bets 1500
SMITH&FUNKY calls 1500
*** TURN *** [Ts Kd 3c][3s]
SMITH&FUNKY checks
LesNuLs13&59 checks
*** RIVER *** [Ts Kd 3c 3s][5h]
SMITH&FUNKY checks
LesNuLs13&59 checks
*** SHOW DOWN ***
SMITH&FUNKY shows [2h Td] (Two pairs : Tens and 3)
LesNuLs13&59 shows [Th 9h] (Two pairs : Tens and 3)
LesNuLs13&59 collected 3110 from pot
SMITH&FUNKY collected 3110 from pot
*** SUMMARY ***
Total pot 6220 | No rake
Board: [Ts Kd 3c 3s 5h]
Seat 1: SMITH&FUNKY (big blind) showed [2h Td] and won 3110 with Two pairs : Tens and 3
Seat 2: LesNuLs13&59 showed [Th 9h] and won 3110 with Two pairs : Tens and 3


Winamax Poker - Tournament "MYSTERY KO" buyIn: 1.80€ + 0.20€ level: 10 - HandId: #3104311471450882143-99-1703103504 - Holdem no limit (120/500/1000) - 2023/12/20 20:18:24 UTC
Table: 'MYSTERY KO(722778838)#0094' 6-max (real money) Seat #6 is the button
Seat 1: SMITH&FUNKY (125085)
Seat 2: LesNuLs13&59 (53569)
Seat 3: nessnaila (30794)
Seat 4: ospahuer (13915)
Seat 5: -Bounty- (20000)
Seat 6: P1xel7 (18975)
*** ANTE/BLINDS ***
SMITH&FUNKY posts ante 120
LesNuLs13&59 posts ante 120
nessnaila posts ante 120
ospahuer posts ante 120
-Bounty- posts ante 120
P1xel7 posts ante 120
SMITH&FUNKY posts small blind 500
LesNuLs13&59 posts big blind 1000
Dealt to P1xel7 [9h 2d]
*** PRE-FLOP *** 
nessnaila calls 1000
ospahuer raises 1000 to 2000
-Bounty- folds
P1xel7 folds
SMITH&FUNKY calls 1500
LesNuLs13&59 folds
nessnaila raises 28674 to 30674 and is all-in
ospahuer calls 11795 and is all-in
SMITH&FUNKY folds
*** FLOP *** [Jd 7c 3c]
*** TURN *** [Jd 7c 3c][6c]
*** RIVER *** [Jd 7c 3c 6c][3s]
*** SHOW DOWN ***
ospahuer shows [Ad 7h] (Two pairs : 7 and 3)
nessnaila shows [Ac Kc] (Flush Ace high)
nessnaila collected 48189 from pot
*** SUMMARY ***
Total pot 48189 | No rake
Board: [Jd 7c 3c 6c 3s]
Seat 3: nessnaila showed [Ac Kc] and won 48189 with Flush Ace high
Seat 4: ospahuer showed [Ad 7h] and lost with Two pairs : 7 and 3


Winamax Poker - Tournament "MYSTERY KO" buyIn: 1.80€ + 0.20€ level: 10 - HandId: #3104311471450882143-100-1703103550 - Holdem no limit (120/500/1000) - 2023/12/20 20:19:10 UTC
Table: 'MYSTERY KO(722778838)#0094' 6-max (real money) Seat #1 is the button
Seat 1: SMITH&FUNKY (122965)
Seat 2: LesNuLs13&59 (52449)
Seat 3: nessnaila (48189)
Seat 5: -Bounty- (19880)
Seat 6: P1xel7 (18855)
*** ANTE/BLINDS ***
LesNuLs13&59 posts ante 120
nessnaila posts ante 120
SMITH&FUNKY posts ante 120
-Bounty- posts ante 120
P1xel7 posts ante 120
LesNuLs13&59 posts small blind 500
nessnaila posts big blind 1000
Dealt to P1xel7 [9d 4h]
*** PRE-FLOP *** 
-Bounty- folds
P1xel7 folds
SMITH&FUNKY folds
LesNuLs13&59 folds
nessnaila collected 2100 from pot
*** SUMMARY ***
Total pot 2100 | No rake
Seat 3: nessnaila (big blind) won 2100


Winamax Poker - Tournament "MYSTERY KO" buyIn: 1.80€ + 0.20€ level: 10 - HandId: #3104311471450882143-101-1703103565 - Holdem no limit (120/500/1000) - 2023/12/20 20:19:25 UTC
Table: 'MYSTERY KO(722778838)#0094' 6-max (real money) Seat #2 is the button
Seat 1: SMITH&FUNKY (122845)
Seat 2: LesNuLs13&59 (51829)
Seat 3: nessnaila (49169)
Seat 5: -Bounty- (19760)
Seat 6: P1xel7 (18735)
*** ANTE/BLINDS ***
nessnaila posts ante 120
-Bounty- posts ante 120
SMITH&FUNKY posts ante 120
LesNuLs13&59 posts ante 120
P1xel7 posts ante 120
nessnaila posts small blind 500
-Bounty- posts big blind 1000
Dealt to P1xel7 [3s Ac]
*** PRE-FLOP *** 
P1xel7 folds
SMITH&FUNKY folds
LesNuLs13&59 raises 1500 to 2500
nessnaila folds
-Bounty- folds
LesNuLs13&59 collected 4600 from pot
*** SUMMARY ***
Total pot 4600 | No rake
Seat 2: LesNuLs13&59 (button) won 4600


Winamax Poker - Tournament "MYSTERY KO" buyIn: 1.80€ + 0.20€ level: 10 - HandId: #3104311471450882143-102-1703103583 - Holdem no limit (120/500/1000) - 2023/12/20 20:19:43 UTC
Table: 'MYSTERY KO(722778838)#0094' 6-max (real money) Seat #3 is the button
Seat 1: SMITH&FUNKY (122725)
Seat 2: LesNuLs13&59 (53809)
Seat 3: nessnaila (48549)
Seat 5: -Bounty- (18640)
Seat 6: P1xel7 (18615)
*** ANTE/BLINDS ***
-Bounty- posts ante 120
P1xel7 posts ante 120
SMITH&FUNKY posts ante 120
LesNuLs13&59 posts ante 120
nessnaila posts ante 120
-Bounty- posts small blind 500
P1xel7 posts big blind 1000
Dealt to P1xel7 [6s Js]
*** PRE-FLOP *** 
SMITH&FUNKY calls 1000
LesNuLs13&59 folds
nessnaila folds
-Bounty- calls 500
P1xel7 checks
*** FLOP *** [9h 6c 4c]
-Bounty- checks
P1xel7 checks
SMITH&FUNKY checks
*** TURN *** [9h 6c 4c][2h]
-Bounty- bets 2340
P1xel7 calls 2340
SMITH&FUNKY folds
*** RIVER *** [9h 6c 4c 2h][Ts]
-Bounty- checks
P1xel7 bets 6624
-Bounty- calls 6624
*** SHOW DOWN ***
P1xel7 shows [6s Js] (One pair : 6)
-Bounty- shows [8c Tc] (One pair : Tens)
-Bounty- collected 21528 from pot
*** SUMMARY ***
Total pot 21528 | No rake
Board: [9h 6c 4c 2h Ts]
Seat 5: -Bounty- (small blind) showed [8c Tc] and won 21528 with One pair : Tens
Seat 6: P1xel7 (big blind) showed [6s Js] and lost with One pair : 6


Winamax Poker - Tournament "MYSTERY KO" buyIn: 1.80€ + 0.20€ level: 11 - HandId: #3104311471450882143-103-1703103676 - Holdem no limit (140/600/1200) - 2023/12/20 20:21:16 UTC
Table: 'MYSTERY KO(722778838)#0094' 6-max (real money) Seat #5 is the button
Seat 1: SMITH&FUNKY (121605)
Seat 2: LesNuLs13&59 (53689)
Seat 3: nessnaila (48429)
Seat 4: Memepasmal (31680)
Seat 5: -Bounty- (30084)
Seat 6: P1xel7 (8531)
*** ANTE/BLINDS ***
P1xel7 posts ante 140
SMITH&FUNKY posts ante 140
LesNuLs13&59 posts ante 140
nessnaila posts ante 140
Memepasmal posts ante 140
-Bounty- posts ante 140
P1xel7 posts small blind 600
SMITH&FUNKY posts big blind 1200
Dealt to P1xel7 [2h 6h]
*** PRE-FLOP *** 
LesNuLs13&59 folds
nessnaila folds
Memepasmal folds
-Bounty- folds
P1xel7 folds
SMITH&FUNKY collected 2640 from pot
*** SUMMARY ***
Total pot 2640 | No rake
Seat 1: SMITH&FUNKY (big blind) won 2640


Winamax Poker - Tournament "MYSTERY KO" buyIn: 1.80€ + 0.20€ level: 11 - HandId: #3104311471450882143-104-1703103685 - Holdem no limit (140/600/1200) - 2023/12/20 20:21:25 UTC
Table: 'MYSTERY KO(722778838)#0094' 6-max (real money) Seat #6 is the button
Seat 1: SMITH&FUNKY (122905)
Seat 2: LesNuLs13&59 (53549)
Seat 3: nessnaila (48289)
Seat 4: Memepasmal (31540)
Seat 5: -Bounty- (29944)
Seat 6: P1xel7 (7791)
*** ANTE/BLINDS ***
SMITH&FUNKY posts ante 140
LesNuLs13&59 posts ante 140
nessnaila posts ante 140
Memepasmal posts ante 140
-Bounty- posts ante 140
P1xel7 posts ante 140
SMITH&FUNKY posts small blind 600
LesNuLs13&59 posts big blind 1200
Dealt to P1xel7 [4c Js]
*** PRE-FLOP *** 
nessnaila folds
Memepasmal raises 1500 to 2700
-Bounty- folds
P1xel7 folds
SMITH&FUNKY folds
LesNuLs13&59 folds
Memepasmal collected 5340 from pot
*** SUMMARY ***
Total pot 5340 | No rake
Seat 4: Memepasmal won 5340


Winamax Poker - Tournament "MYSTERY KO" buyIn: 1.80€ + 0.20€ level: 11 - HandId: #3104311471450882143-105-1703103719 - Holdem no limit (140/600/1200) - 2023/12/20 20:21:59 UTC
Table: 'MYSTERY KO(722778838)#0094' 6-max (real money) Seat #1 is the button
Seat 1: SMITH&FUNKY (122165)
Seat 2: LesNuLs13&59 (52209)
Seat 3: nessnaila (48149)
Seat 4: Memepasmal (34040)
Seat 5: -Bounty- (29804)
Seat 6: P1xel7 (7651)
*** ANTE/BLINDS ***
LesNuLs13&59 posts ante 140
nessnaila posts ante 140
SMITH&FUNKY posts ante 140
Memepasmal posts ante 140
-Bounty- posts ante 140
P1xel7 posts ante 140
LesNuLs13&59 posts small blind 600
nessnaila posts big blind 1200
Dealt to P1xel7 [6d 3c]
*** PRE-FLOP *** 
Memepasmal folds
-Bounty- raises 1200 to 2400
P1xel7 folds
SMITH&FUNKY folds
LesNuLs13&59 folds
nessnaila calls 1200
*** FLOP *** [2h 5s 3s]
nessnaila checks
-Bounty- checks
*** TURN *** [2h 5s 3s][4c]
nessnaila checks
-Bounty- bets 3120
nessnaila folds
-Bounty- collected 9360 from pot
*** SUMMARY ***
Total pot 9360 | No rake
Board: [2h 5s 3s 4c]
Seat 5: -Bounty- won 9360


Winamax Poker - Tournament "MYSTERY KO" buyIn: 1.80€ + 0.20€ level: 11 - HandId: #3104311471450882143-106-1703103785 - Holdem no limit (140/600/1200) - 2023/12/20 20:23:05 UTC
Table: 'MYSTERY KO(722778838)#0094' 6-max (real money) Seat #2 is the button
Seat 1: SMITH&FUNKY (122025)
Seat 2: LesNuLs13&59 (51469)
Seat 3: nessnaila (45609)
Seat 4: Memepasmal (33900)
Seat 5: -Bounty- (33504)
Seat 6: P1xel7 (7511)
*** ANTE/BLINDS ***
nessnaila posts ante 140
Memepasmal posts ante 140
SMITH&FUNKY posts ante 140
LesNuLs13&59 posts ante 140
-Bounty- posts ante 140
P1xel7 posts ante 140
nessnaila posts small blind 600
Memepasmal posts big blind 1200
Dealt to P1xel7 [Ac 4h]
*** PRE-FLOP *** 
-Bounty- folds
P1xel7 folds
SMITH&FUNKY folds
LesNuLs13&59 raises 1200 to 2400
nessnaila folds
Memepasmal calls 1200
*** FLOP *** [6d 5s Kh]
Memepasmal checks
LesNuLs13&59 checks
*** TURN *** [6d 5s Kh][Qc]
Memepasmal bets 2184
LesNuLs13&59 folds
Memepasmal collected 8424 from pot
*** SUMMARY ***
Total pot 8424 | No rake
Board: [6d 5s Kh Qc]
Seat 4: Memepasmal (big blind) won 8424


Winamax Poker - Tournament "MYSTERY KO" buyIn: 1.80€ + 0.20€ level: 11 - HandId: #3104311471450882143-107-1703103822 - Holdem no limit (140/600/1200) - 2023/12/20 20:23:42 UTC
Table: 'MYSTERY KO(722778838)#0094' 6-max (real money) Seat #3 is the button
Seat 1: SMITH&FUNKY (121885)
Seat 2: LesNuLs13&59 (48929)
Seat 3: nessnaila (44869)
Seat 4: Memepasmal (37600)
Seat 5: -Bounty- (33364)
Seat 6: P1xel7 (7371)
*** ANTE/BLINDS ***
Memepasmal posts ante 140
-Bounty- posts ante 140
SMITH&FUNKY posts ante 140
LesNuLs13&59 posts ante 140
nessnaila posts ante 140
P1xel7 posts ante 140
Memepasmal posts small blind 600
-Bounty- posts big blind 1200
Dealt to P1xel7 [7h Td]
*** PRE-FLOP *** 
P1xel7 folds
SMITH&FUNKY folds
LesNuLs13&59 folds
nessnaila folds
Memepasmal calls 600
-Bounty- checks
*** FLOP *** [3s Qc As]
Memepasmal bets 2106
-Bounty- calls 2106
*** TURN *** [3s Qc As][8h]
Memepasmal bets 4844
-Bounty- calls 4844
*** RIVER *** [3s Qc As 8h][6h]
Memepasmal bets 29310 and is all-in
-Bounty- calls 25074 and is all-in
*** SHOW DOWN ***
Memepasmal shows [Jd 9s] (High card : Ace)
-Bounty- shows [6d Qh] (Two pairs : Queens and 6)
-Bounty- collected 67288 from main pot
Memepasmal collected 4236 from side pot 1
*** SUMMARY ***
Total pot 71524 | No rake
Board: [3s Qc As 8h 6h]
Seat 4: Memepasmal (small blind) showed [Jd 9s] and won 4236 with High card : Ace
Seat 5: -Bounty- (big blind) showed [6d Qh] and won 67288 with Two pairs : Queens and 6


Winamax Poker - Tournament "MYSTERY KO" buyIn: 1.80€ + 0.20€ level: 11 - HandId: #3104311471450882143-108-1703103946 - Holdem no limit (140/600/1200) - 2023/12/20 20:25:46 UTC
Table: 'MYSTERY KO(722778838)#0094' 6-max (real money) Seat #4 is the button
Seat 1: SMITH&FUNKY (121745)
Seat 2: LesNuLs13&59 (48789)
Seat 3: nessnaila (44729)
Seat 4: Memepasmal (4236)
Seat 5: -Bounty- (67288)
Seat 6: P1xel7 (7231)
*** ANTE/BLINDS ***
-Bounty- posts ante 140
P1xel7 posts ante 140
SMITH&FUNKY posts ante 140
LesNuLs13&59 posts ante 140
nessnaila posts ante 140
Memepasmal posts ante 140
-Bounty- posts small blind 600
P1xel7 posts big blind 1200
Dealt to P1xel7 [9d 3s]
*** PRE-FLOP *** 
SMITH&FUNKY folds
LesNuLs13&59 folds
nessnaila folds
Memepasmal folds
-Bounty- raises 65948 to 67148 and is all-in
P1xel7 folds
-Bounty- collected 69188 from pot
*** SUMMARY ***
Total pot 69188 | No rake
Seat 5: -Bounty- (small blind) won 69188


Winamax Poker - Tournament "MYSTERY KO" buyIn: 1.80€ + 0.20€ level: 11 - HandId: #3104311471450882143-109-1703103970 - Holdem no limit (140/600/1200) - 2023/12/20 20:26:10 UTC
Table: 'MYSTERY KO(722778838)#0094' 6-max (real money) Seat #5 is the button
Seat 1: SMITH&FUNKY (121605)
Seat 2: LesNuLs13&59 (48649)
Seat 3: nessnaila (44589)
Seat 4: Memepasmal (4096)
Seat 5: -Bounty- (69188)
Seat 6: P1xel7 (5891)
*** ANTE/BLINDS ***
P1xel7 posts ante 140
SMITH&FUNKY posts ante 140
LesNuLs13&59 posts ante 140
nessnaila posts ante 140
Memepasmal posts ante 140
-Bounty- posts ante 140
P1xel7 posts small blind 600
SMITH&FUNKY posts big blind 1200
Dealt to P1xel7 [Qh Kd]
*** PRE-FLOP *** 
LesNuLs13&59 folds
nessnaila folds
Memepasmal raises 2756 to 3956 and is all-in
-Bounty- calls 3956
P1xel7 raises 1795 to 5751 and is all-in
SMITH&FUNKY calls 4551
-Bounty- calls 1795
*** FLOP *** [2c 3c 9h]
SMITH&FUNKY checks
-Bounty- checks
*** TURN *** [2c 3c 9h][Qd]
SMITH&FUNKY checks
-Bounty- bets 11025
SMITH&FUNKY folds
*** RIVER *** [2c 3c 9h Qd][Js]
*** SHOW DOWN ***
P1xel7 shows [Qh Kd] (One pair : Queens)
Memepasmal shows [Th Kh] (Straight King high)
-Bounty- shows [Jc Qc] (Two pairs : Queens and Jacks)
-Bounty- collected 16410 from side pot 1
Memepasmal collected 16664 from main pot
*** SUMMARY ***
Total pot 33074 | No rake
Board: [2c 3c 9h Qd Js]
Seat 4: Memepasmal showed [Th Kh] and won 16664 with Straight King high
Seat 5: -Bounty- (button) showed [Jc Qc] and won 16410 with Two pairs : Queens and Jacks
Seat 6: P1xel7 (small blind) showed [Qh Kd] and lost with One pair : Queens


